DATE,HOUR,DAY_NAME,SEASON_NAME,WEATHER_ID,TIME_OF_DAY,TOTAL_RENTALS,CASUAL_USERS,REGISTERED_USERS
2011-01-01,0,Saturday,Spring,1,Early Morning,16,3,13
2011-01-01,1,Saturday,Spring,1,Early Morning,40,8,32
2011-01-01,2,Saturday,Spring,1,Early Morning,32,5,27
2011-01-01,3,Saturday,Spring,1,Early Morning,13,3,10
2011-01-01,4,Saturday,Spring,1,Early Morning,1,0,1
2011-01-01,5,Saturday,Spring,2,Early Morning,1,0,1
2011-01-01,6,Saturday,Spring,1,Morning Rush,2,2,0
2011-01-01,7,Saturday,Spring,1,Morning Rush,3,1,2
2011-01-01,8,Saturday,Spring,1,Morning Rush,8,1,7
2011-01-01,9,Saturday,Spring,1,Morning Rush,14,8,6
2011-01-01,10,Saturday,Spring,1,Mid-Day,36,12,24
2011-01-01,11,Saturday,Spring,1,Mid-Day,56,26,30
2011-01-01,12,Saturday,Spring,1,Mid-Day,84,29,55
2011-01-01,13,Saturday,Spring,2,Mid-Day,94,47,47
2011-01-01,14,Saturday,Spring,2,Mid-Day,106,35,71
2011-01-01,15,Saturday,Spring,2,Mid-Day,110,40,70
2011-01-01,16,Saturday,Spring,2,Evening Rush,93,41,52
2011-01-01,17,Saturday,Spring,2,Evening Rush,67,15,52
2011-01-01,18,Saturday,Spring,3,Evening Rush,35,9,26
2011-01-01,19,Saturday,Spring,3,Evening Rush,37,6,31
2011-01-01,20,Saturday,Spring,2,Night,36,11,25
2011-01-01,21,Saturday,Spring,2,Night,34,3,31
2011-01-01,22,Saturday,Spring,2,Night,28,11,17
2011-01-01,23,Saturday,Spring,2,Night,39,15,24
2011-01-02,0,Sunday,Spring,2,Early Morning,17,4,13
2011-01-02,1,Sunday,Spring,2,Early Morning,17,1,16
2011-01-02,2,Sunday,Spring,2,Early Morning,9,1,8
2011-01-02,3,Sunday,Spring,2,Early Morning,6,2,4
2011-01-02,4,Sunday,Spring,2,Early Morning,3,2,1
2011-01-02,6,Sunday,Spring,3,Morning Rush,2,0,2
2011-01-02,7,Sunday,Spring,2,Morning Rush,1,0,1
2011-01-02,8,Sunday,Spring,3,Morning Rush,8,0,8
2011-01-02,9,Sunday,Spring,2,Morning Rush,20,1,19
2011-01-02,10,Sunday,Spring,2,Mid-Day,53,7,46
2011-01-02,11,Sunday,Spring,2,Mid-Day,70,16,54
2011-01-02,12,Sunday,Spring,2,Mid-Day,93,20,73
2011-01-02,13,Sunday,Spring,2,Mid-Day,75,11,64
2011-01-02,14,Sunday,Spring,3,Mid-Day,59,4,55
2011-01-02,15,Sunday,Spring,3,Mid-Day,74,19,55
2011-01-02,16,Sunday,Spring,3,Evening Rush,76,9,67
2011-01-02,17,Sunday,Spring,1,Evening Rush,65,7,58
2011-01-02,18,Sunday,Spring,2,Evening Rush,53,10,43
2011-01-02,19,Sunday,Spring,1,Evening Rush,30,1,29
2011-01-02,20,Sunday,Spring,1,Night,22,5,17
2011-01-02,21,Sunday,Spring,1,Night,31,11,20
2011-01-02,22,Sunday,Spring,1,Night,9,0,9
2011-01-02,23,Sunday,Spring,1,Night,8,0,8
2011-01-03,0,Monday,Spring,1,Early Morning,5,0,5
2011-01-03,1,Monday,Spring,1,Early Morning,2,0,2
2011-01-03,4,Monday,Spring,1,Early Morning,1,0,1
2011-01-03,5,Monday,Spring,1,Early Morning,3,0,3
2011-01-03,6,Monday,Spring,1,Morning Rush,30,0,30
2011-01-03,7,Monday,Spring,1,Morning Rush,64,1,63
2011-01-03,8,Monday,Spring,1,Morning Rush,154,1,153
2011-01-03,9,Monday,Spring,1,Morning Rush,88,7,81
2011-01-03,10,Monday,Spring,1,Mid-Day,44,11,33
2011-01-03,11,Monday,Spring,1,Mid-Day,51,10,41
2011-01-03,12,Monday,Spring,1,Mid-Day,61,13,48
2011-01-03,13,Monday,Spring,1,Mid-Day,61,8,53
2011-01-03,14,Monday,Spring,1,Mid-Day,77,11,66
2011-01-03,15,Monday,Spring,1,Mid-Day,72,14,58
2011-01-03,16,Monday,Spring,1,Evening Rush,76,9,67
2011-01-03,17,Monday,Spring,1,Evening Rush,157,11,146
2011-01-03,18,Monday,Spring,1,Evening Rush,157,9,148
2011-01-03,19,Monday,Spring,1,Evening Rush,110,8,102
2011-01-03,20,Monday,Spring,1,Night,52,3,49
2011-01-03,21,Monday,Spring,1,Night,52,3,49
2011-01-03,22,Monday,Spring,1,Night,20,0,20
2011-01-03,23,Monday,Spring,1,Night,12,1,11
2011-01-04,0,Tuesday,Spring,1,Early Morning,5,0,5
2011-01-04,1,Tuesday,Spring,1,Early Morning,2,0,2
2011-01-04,2,Tuesday,Spring,1,Early Morning,1,0,1
2011-01-04,4,Tuesday,Spring,1,Early Morning,2,0,2
2011-01-04,5,Tuesday,Spring,1,Early Morning,4,0,4
2011-01-04,6,Tuesday,Spring,1,Morning Rush,36,0,36
2011-01-04,7,Tuesday,Spring,1,Morning Rush,94,2,92
2011-01-04,8,Tuesday,Spring,1,Morning Rush,179,2,177
2011-01-04,9,Tuesday,Spring,1,Morning Rush,100,2,98
2011-01-04,10,Tuesday,Spring,2,Mid-Day,42,5,37
2011-01-04,11,Tuesday,Spring,1,Mid-Day,57,7,50
2011-01-04,12,Tuesday,Spring,1,Mid-Day,78,12,66
2011-01-04,13,Tuesday,Spring,1,Mid-Day,97,18,79
2011-01-04,14,Tuesday,Spring,1,Mid-Day,63,9,54
2011-01-04,15,Tuesday,Spring,1,Mid-Day,65,17,48
2011-01-04,16,Tuesday,Spring,1,Evening Rush,83,15,68
2011-01-04,17,Tuesday,Spring,1,Evening Rush,212,10,202
2011-01-04,18,Tuesday,Spring,1,Evening Rush,182,3,179
2011-01-04,19,Tuesday,Spring,1,Evening Rush,112,2,110
2011-01-04,20,Tuesday,Spring,1,Night,54,1,53
2011-01-04,21,Tuesday,Spring,1,Night,48,0,48
2011-01-04,22,Tuesday,Spring,1,Night,35,1,34
2011-01-04,23,Tuesday,Spring,1,Night,11,2,9
2011-01-05,0,Wednesday,Spring,1,Early Morning,6,0,6
2011-01-05,1,Wednesday,Spring,1,Early Morning,6,0,6
2011-01-05,2,Wednesday,Spring,1,Early Morning,2,0,2
2011-01-05,4,Wednesday,Spring,1,Early Morning,2,0,2
2011-01-05,5,Wednesday,Spring,1,Early Morning,3,0,3
2011-01-05,6,Wednesday,Spring,1,Morning Rush,33,0,33
2011-01-05,7,Wednesday,Spring,1,Morning Rush,88,1,87
2011-01-05,8,Wednesday,Spring,1,Morning Rush,195,3,192
2011-01-05,9,Wednesday,Spring,1,Morning Rush,115,6,109
2011-01-05,10,Wednesday,Spring,1,Mid-Day,57,4,53
2011-01-05,11,Wednesday,Spring,1,Mid-Day,46,12,34
2011-01-05,12,Wednesday,Spring,1,Mid-Day,79,5,74
2011-01-05,13,Wednesday,Spring,1,Mid-Day,71,6,65
2011-01-05,14,Wednesday,Spring,1,Mid-Day,62,10,52
2011-01-05,15,Wednesday,Spring,1,Mid-Day,62,7,55
2011-01-05,16,Wednesday,Spring,1,Evening Rush,89,4,85
2011-01-05,17,Wednesday,Spring,1,Evening Rush,190,4,186
2011-01-05,18,Wednesday,Spring,1,Evening Rush,169,3,166
2011-01-05,19,Wednesday,Spring,1,Evening Rush,132,5,127
2011-01-05,20,Wednesday,Spring,1,Night,89,7,82
2011-01-05,21,Wednesday,Spring,1,Night,43,3,40
2011-01-05,22,Wednesday,Spring,1,Night,42,1,41
2011-01-05,23,Wednesday,Spring,1,Night,19,1,18
2011-01-06,0,Thursday,Spring,1,Early Morning,11,0,11
2011-01-06,1,Thursday,Spring,1,Early Morning,4,0,4
2011-01-06,2,Thursday,Spring,1,Early Morning,2,0,2
2011-01-06,4,Thursday,Spring,2,Early Morning,1,0,1
2011-01-06,5,Thursday,Spring,2,Early Morning,4,0,4
2011-01-06,6,Thursday,Spring,2,Morning Rush,36,0,36
2011-01-06,7,Thursday,Spring,2,Morning Rush,95,0,95
2011-01-06,8,Thursday,Spring,1,Morning Rush,219,3,216
2011-01-06,9,Thursday,Spring,2,Morning Rush,122,6,116
2011-01-06,10,Thursday,Spring,1,Mid-Day,45,3,42
2011-01-06,11,Thursday,Spring,1,Mid-Day,59,2,57
2011-01-06,12,Thursday,Spring,1,Mid-Day,84,6,78
2011-01-06,13,Thursday,Spring,1,Mid-Day,67,12,55
2011-01-06,14,Thursday,Spring,1,Mid-Day,70,11,59
2011-01-06,15,Thursday,Spring,1,Mid-Day,62,8,54
2011-01-06,16,Thursday,Spring,1,Evening Rush,86,12,74
2011-01-06,17,Thursday,Spring,1,Evening Rush,172,9,163
2011-01-06,18,Thursday,Spring,1,Evening Rush,163,5,158
2011-01-06,19,Thursday,Spring,1,Evening Rush,112,3,109
2011-01-06,20,Thursday,Spring,1,Night,69,3,66
2011-01-06,21,Thursday,Spring,2,Night,48,0,48
2011-01-06,22,Thursday,Spring,2,Night,52,1,51
2011-01-06,23,Thursday,Spring,2,Night,23,4,19
2011-01-07,0,Friday,Spring,2,Early Morning,17,4,13
2011-01-07,1,Friday,Spring,2,Early Morning,7,2,5
2011-01-07,2,Friday,Spring,2,Early Morning,1,0,1
2011-01-07,4,Friday,Spring,2,Early Morning,1,0,1
2011-01-07,5,Friday,Spring,3,Early Morning,5,0,5
2011-01-07,6,Friday,Spring,2,Morning Rush,34,8,26
2011-01-07,7,Friday,Spring,1,Morning Rush,84,8,76
2011-01-07,8,Friday,Spring,1,Morning Rush,210,20,190
2011-01-07,9,Friday,Spring,1,Morning Rush,134,9,125
2011-01-07,10,Friday,Spring,1,Mid-Day,63,16,47
2011-01-07,11,Friday,Spring,2,Mid-Day,67,19,48
2011-01-07,12,Friday,Spring,2,Mid-Day,59,9,50
2011-01-07,13,Friday,Spring,2,Mid-Day,73,9,64
2011-01-07,14,Friday,Spring,2,Mid-Day,50,7,43
2011-01-07,15,Friday,Spring,2,Mid-Day,72,9,63
2011-01-07,16,Friday,Spring,2,Evening Rush,87,5,82
2011-01-07,17,Friday,Spring,2,Evening Rush,187,9,178
2011-01-07,18,Friday,Spring,1,Evening Rush,123,7,116
2011-01-07,19,Friday,Spring,1,Evening Rush,95,3,92
2011-01-07,20,Friday,Spring,1,Night,51,1,50
2011-01-07,21,Friday,Spring,1,Night,39,0,39
2011-01-07,22,Friday,Spring,2,Night,36,2,34
2011-01-07,23,Friday,Spring,2,Night,15,1,14
2011-01-08,0,Saturday,Spring,2,Early Morning,25,1,24
2011-01-08,1,Saturday,Spring,2,Early Morning,16,1,15
2011-01-08,2,Saturday,Spring,2,Early Morning,16,3,13
2011-01-08,3,Saturday,Spring,3,Early Morning,7,0,7
2011-01-08,4,Saturday,Spring,3,Early Morning,1,0,1
2011-01-08,5,Saturday,Spring,2,Early Morning,5,0,5
2011-01-08,6,Saturday,Spring,2,Morning Rush,2,0,2
2011-01-08,7,Saturday,Spring,2,Morning Rush,9,1,8
2011-01-08,8,Saturday,Spring,3,Morning Rush,15,0,15
2011-01-08,9,Saturday,Spring,3,Morning Rush,20,0,20
2011-01-08,10,Saturday,Spring,2,Mid-Day,61,5,56
2011-01-08,11,Saturday,Spring,2,Mid-Day,62,2,60
2011-01-08,12,Saturday,Spring,2,Mid-Day,98,8,90
2011-01-08,13,Saturday,Spring,1,Mid-Day,102,7,95
2011-01-08,14,Saturday,Spring,1,Mid-Day,95,12,83
2011-01-08,15,Saturday,Spring,1,Mid-Day,74,5,69
2011-01-08,16,Saturday,Spring,1,Evening Rush,76,8,68
2011-01-08,17,Saturday,Spring,1,Evening Rush,69,5,64
2011-01-08,18,Saturday,Spring,1,Evening Rush,55,3,52
2011-01-08,19,Saturday,Spring,1,Evening Rush,30,4,26
2011-01-08,20,Saturday,Spring,1,Night,28,0,28
2011-01-08,21,Saturday,Spring,1,Night,37,2,35
2011-01-08,22,Saturday,Spring,1,Night,34,1,33
2011-01-08,23,Saturday,Spring,1,Night,22,0,22
2011-01-09,0,Sunday,Spring,1,Early Morning,25,1,24
2011-01-09,1,Sunday,Spring,1,Early Morning,12,0,12
2011-01-09,2,Sunday,Spring,1,Early Morning,11,0,11
2011-01-09,3,Sunday,Spring,1,Early Morning,4,0,4
2011-01-09,4,Sunday,Spring,1,Early Morning,1,0,1
2011-01-09,5,Sunday,Spring,1,Early Morning,1,0,1
2011-01-09,6,Sunday,Spring,1,Morning Rush,1,0,1
2011-01-09,7,Sunday,Spring,1,Morning Rush,6,1,5
2011-01-09,8,Sunday,Spring,1,Morning Rush,10,0,10
2011-01-09,9,Sunday,Spring,1,Morning Rush,19,0,19
2011-01-09,10,Sunday,Spring,1,Mid-Day,49,0,49
2011-01-09,11,Sunday,Spring,1,Mid-Day,49,2,47
2011-01-09,12,Sunday,Spring,1,Mid-Day,83,4,79
2011-01-09,13,Sunday,Spring,1,Mid-Day,75,6,69
2011-01-09,14,Sunday,Spring,1,Mid-Day,72,8,64
2011-01-09,15,Sunday,Spring,1,Mid-Day,82,5,77
2011-01-09,16,Sunday,Spring,1,Evening Rush,92,13,79
2011-01-09,17,Sunday,Spring,1,Evening Rush,62,3,59
2011-01-09,18,Sunday,Spring,1,Evening Rush,48,4,44
2011-01-09,19,Sunday,Spring,1,Evening Rush,41,1,40
2011-01-09,20,Sunday,Spring,1,Night,38,0,38
2011-01-09,21,Sunday,Spring,1,Night,20,1,19
2011-01-09,22,Sunday,Spring,1,Night,15,5,10
2011-01-09,23,Sunday,Spring,1,Night,6,0,6
2011-01-10,0,Monday,Spring,1,Early Morning,5,2,3
2011-01-10,1,Monday,Spring,1,Early Morning,1,1,0
2011-01-10,2,Monday,Spring,1,Early Morning,3,0,3
2011-01-10,3,Monday,Spring,1,Early Morning,1,0,1
2011-01-10,4,Monday,Spring,1,Early Morning,3,1,2
2011-01-10,5,Monday,Spring,1,Early Morning,3,0,3
2011-01-10,6,Monday,Spring,1,Morning Rush,31,0,31
2011-01-10,7,Monday,Spring,1,Morning Rush,77,2,75
2011-01-10,8,Monday,Spring,2,Morning Rush,188,4,184
2011-01-10,9,Monday,Spring,2,Morning Rush,94,2,92
2011-01-10,10,Monday,Spring,2,Mid-Day,31,0,31
2011-01-10,11,Monday,Spring,2,Mid-Day,30,2,28
2011-01-10,12,Monday,Spring,2,Mid-Day,52,5,47
2011-01-10,13,Monday,Spring,2,Mid-Day,54,4,50
2011-01-10,14,Monday,Spring,2,Mid-Day,47,0,47
2011-01-10,15,Monday,Spring,2,Mid-Day,45,2,43
2011-01-10,16,Monday,Spring,1,Evening Rush,74,4,70
2011-01-10,17,Monday,Spring,1,Evening Rush,178,4,174
2011-01-10,18,Monday,Spring,1,Evening Rush,155,1,154
2011-01-10,19,Monday,Spring,1,Evening Rush,95,3,92
2011-01-10,20,Monday,Spring,1,Night,74,1,73
2011-01-10,21,Monday,Spring,1,Night,38,1,37
2011-01-10,22,Monday,Spring,1,Night,24,2,22
2011-01-10,23,Monday,Spring,1,Night,18,0,18
2011-01-11,0,Tuesday,Spring,1,Early Morning,12,2,10
2011-01-11,1,Tuesday,Spring,1,Early Morning,3,0,3
2011-01-11,2,Tuesday,Spring,2,Early Morning,3,0,3
2011-01-11,5,Tuesday,Spring,2,Early Morning,6,0,6
2011-01-11,6,Tuesday,Spring,2,Morning Rush,27,0,27
2011-01-11,7,Tuesday,Spring,2,Morning Rush,99,2,97
2011-01-11,8,Tuesday,Spring,2,Morning Rush,217,3,214
2011-01-11,9,Tuesday,Spring,2,Morning Rush,130,3,127
2011-01-11,10,Tuesday,Spring,2,Mid-Day,54,3,51
2011-01-11,11,Tuesday,Spring,2,Mid-Day,35,4,31
2011-01-11,12,Tuesday,Spring,2,Mid-Day,57,2,55
2011-01-11,13,Tuesday,Spring,2,Mid-Day,52,6,46
2011-01-11,14,Tuesday,Spring,2,Mid-Day,63,3,60
2011-01-11,15,Tuesday,Spring,2,Mid-Day,47,2,45
2011-01-11,16,Tuesday,Spring,2,Evening Rush,76,4,72
2011-01-11,17,Tuesday,Spring,2,Evening Rush,136,6,130
2011-01-11,18,Tuesday,Spring,3,Evening Rush,95,1,94
2011-01-11,19,Tuesday,Spring,3,Evening Rush,51,0,51
2011-01-11,20,Tuesday,Spring,3,Night,32,0,32
2011-01-11,21,Tuesday,Spring,3,Night,20,0,20
2011-01-11,22,Tuesday,Spring,3,Night,29,1,28
2011-01-11,23,Tuesday,Spring,3,Night,19,1,18
2011-01-12,0,Wednesday,Spring,2,Early Morning,7,0,7
2011-01-12,1,Wednesday,Spring,2,Early Morning,6,0,6
2011-01-12,2,Wednesday,Spring,1,Early Morning,1,0,1
2011-01-12,5,Wednesday,Spring,1,Early Morning,5,0,5
2011-01-12,6,Wednesday,Spring,1,Morning Rush,16,0,16
2011-01-12,7,Wednesday,Spring,1,Morning Rush,54,0,54
2011-01-12,8,Wednesday,Spring,1,Morning Rush,128,3,125
2011-01-12,9,Wednesday,Spring,1,Morning Rush,81,3,78
2011-01-12,10,Wednesday,Spring,1,Mid-Day,39,0,39
2011-01-12,11,Wednesday,Spring,1,Mid-Day,35,3,32
2011-01-12,12,Wednesday,Spring,1,Mid-Day,55,3,52
2011-01-12,13,Wednesday,Spring,1,Mid-Day,49,0,49
2011-01-12,14,Wednesday,Spring,1,Mid-Day,44,0,44
2011-01-12,15,Wednesday,Spring,1,Mid-Day,49,1,48
2011-01-12,16,Wednesday,Spring,1,Evening Rush,68,5,63
2011-01-12,17,Wednesday,Spring,1,Evening Rush,139,0,139
2011-01-12,18,Wednesday,Spring,1,Evening Rush,137,2,135
2011-01-12,19,Wednesday,Spring,1,Evening Rush,83,1,82
2011-01-12,20,Wednesday,Spring,1,Night,56,2,54
2011-01-12,21,Wednesday,Spring,1,Night,57,0,57
2011-01-12,22,Wednesday,Spring,1,Night,33,1,32
2011-01-12,23,Wednesday,Spring,1,Night,20,1,19
2011-01-13,0,Thursday,Spring,1,Early Morning,7,1,6
2011-01-13,1,Thursday,Spring,1,Early Morning,2,0,2
2011-01-13,2,Thursday,Spring,1,Early Morning,2,0,2
2011-01-13,3,Thursday,Spring,1,Early Morning,3,0,3
2011-01-13,4,Thursday,Spring,1,Early Morning,4,0,4
2011-01-13,5,Thursday,Spring,1,Early Morning,3,0,3
2011-01-13,6,Thursday,Spring,1,Morning Rush,28,0,28
2011-01-13,7,Thursday,Spring,1,Morning Rush,72,0,72
2011-01-13,8,Thursday,Spring,1,Morning Rush,202,5,197
2011-01-13,9,Thursday,Spring,1,Morning Rush,139,2,137
2011-01-13,10,Thursday,Spring,2,Mid-Day,38,2,36
2011-01-13,11,Thursday,Spring,2,Mid-Day,37,4,33
2011-01-13,12,Thursday,Spring,1,Mid-Day,52,3,49
2011-01-13,13,Thursday,Spring,1,Mid-Day,83,2,81
2011-01-13,14,Thursday,Spring,1,Mid-Day,42,3,39
2011-01-13,15,Thursday,Spring,1,Mid-Day,60,5,55
2011-01-13,16,Thursday,Spring,1,Evening Rush,78,2,76
2011-01-13,17,Thursday,Spring,1,Evening Rush,162,4,158
2011-01-13,18,Thursday,Spring,1,Evening Rush,144,3,141
2011-01-13,19,Thursday,Spring,1,Evening Rush,99,1,98
2011-01-13,20,Thursday,Spring,1,Night,64,0,64
2011-01-13,21,Thursday,Spring,1,Night,40,0,40
2011-01-13,22,Thursday,Spring,1,Night,30,0,30
2011-01-13,23,Thursday,Spring,1,Night,15,1,14
2011-01-14,0,Friday,Spring,1,Early Morning,14,0,14
2011-01-14,1,Friday,Spring,1,Early Morning,5,0,5
2011-01-14,2,Friday,Spring,1,Early Morning,1,0,1
2011-01-14,3,Friday,Spring,1,Early Morning,1,0,1
2011-01-14,5,Friday,Spring,1,Early Morning,8,0,8
2011-01-14,6,Friday,Spring,1,Morning Rush,17,0,17
2011-01-14,7,Friday,Spring,1,Morning Rush,70,0,70
2011-01-14,8,Friday,Spring,1,Morning Rush,158,2,156
2011-01-14,9,Friday,Spring,1,Morning Rush,117,0,117
2011-01-14,10,Friday,Spring,1,Mid-Day,44,4,40
2011-01-14,11,Friday,Spring,1,Mid-Day,53,6,47
2011-01-14,12,Friday,Spring,1,Mid-Day,61,2,59
2011-01-14,13,Friday,Spring,1,Mid-Day,77,4,73
2011-01-14,14,Friday,Spring,1,Mid-Day,64,5,59
2011-01-14,15,Friday,Spring,1,Mid-Day,68,9,59
2011-01-14,16,Friday,Spring,1,Evening Rush,90,3,87
2011-01-14,17,Friday,Spring,1,Evening Rush,159,4,155
2011-01-14,18,Friday,Spring,1,Evening Rush,139,5,134
2011-01-14,19,Friday,Spring,1,Evening Rush,92,3,89
2011-01-14,20,Friday,Spring,1,Night,68,0,68
2011-01-14,21,Friday,Spring,1,Night,52,4,48
2011-01-14,22,Friday,Spring,2,Night,36,2,34
2011-01-14,23,Friday,Spring,2,Night,27,1,26
2011-01-15,0,Saturday,Spring,1,Early Morning,28,3,25
2011-01-15,1,Saturday,Spring,2,Early Morning,20,2,18
2011-01-15,2,Saturday,Spring,2,Early Morning,12,0,12
2011-01-15,3,Saturday,Spring,2,Early Morning,8,1,7
2011-01-15,4,Saturday,Spring,2,Early Morning,5,0,5
2011-01-15,5,Saturday,Spring,1,Early Morning,1,0,1
2011-01-15,6,Saturday,Spring,1,Morning Rush,3,1,2
2011-01-15,7,Saturday,Spring,1,Morning Rush,10,1,9
2011-01-15,8,Saturday,Spring,1,Morning Rush,23,1,22
2011-01-15,9,Saturday,Spring,1,Morning Rush,33,2,31
2011-01-15,10,Saturday,Spring,1,Mid-Day,59,2,57
2011-01-15,11,Saturday,Spring,1,Mid-Day,72,18,54
2011-01-15,12,Saturday,Spring,1,Mid-Day,89,15,74
2011-01-15,13,Saturday,Spring,1,Mid-Day,101,21,80
2011-01-15,14,Saturday,Spring,1,Mid-Day,118,26,92
2011-01-15,15,Saturday,Spring,2,Mid-Day,129,21,108
2011-01-15,16,Saturday,Spring,2,Evening Rush,128,33,95
2011-01-15,17,Saturday,Spring,2,Evening Rush,83,29,54
2011-01-15,18,Saturday,Spring,2,Evening Rush,84,15,69
2011-01-15,19,Saturday,Spring,2,Evening Rush,74,14,60
2011-01-15,20,Saturday,Spring,2,Night,41,6,35
2011-01-15,21,Saturday,Spring,2,Night,57,6,51
2011-01-15,22,Saturday,Spring,2,Night,26,0,26
2011-01-15,23,Saturday,Spring,1,Night,44,5,39
2011-01-16,0,Sunday,Spring,1,Early Morning,39,6,33
2011-01-16,1,Sunday,Spring,1,Early Morning,23,4,19
2011-01-16,2,Sunday,Spring,1,Early Morning,16,3,13
2011-01-16,3,Sunday,Spring,1,Early Morning,15,9,6
2011-01-16,4,Sunday,Spring,1,Early Morning,1,0,1
2011-01-16,5,Sunday,Spring,2,Early Morning,2,1,1
2011-01-16,6,Sunday,Spring,2,Morning Rush,1,0,1
2011-01-16,7,Sunday,Spring,2,Morning Rush,3,0,3
2011-01-16,8,Sunday,Spring,1,Morning Rush,18,0,18
2011-01-16,9,Sunday,Spring,1,Morning Rush,32,3,29
2011-01-16,10,Sunday,Spring,1,Mid-Day,79,8,71
2011-01-16,11,Sunday,Spring,1,Mid-Day,93,23,70
2011-01-16,12,Sunday,Spring,1,Mid-Day,104,29,75
2011-01-16,13,Sunday,Spring,1,Mid-Day,118,23,95
2011-01-16,14,Sunday,Spring,1,Mid-Day,91,22,69
2011-01-16,15,Sunday,Spring,1,Mid-Day,113,35,78
2011-01-16,16,Sunday,Spring,1,Evening Rush,99,22,77
2011-01-16,17,Sunday,Spring,1,Evening Rush,105,23,82
2011-01-16,18,Sunday,Spring,1,Evening Rush,67,11,56
2011-01-16,19,Sunday,Spring,1,Evening Rush,61,14,47
2011-01-16,20,Sunday,Spring,1,Night,57,7,50
2011-01-16,21,Sunday,Spring,1,Night,28,6,22
2011-01-16,22,Sunday,Spring,2,Night,21,2,19
2011-01-16,23,Sunday,Spring,2,Night,18,0,18
2011-01-17,0,Monday,Spring,2,Early Morning,17,1,16
2011-01-17,1,Monday,Spring,2,Early Morning,16,1,15
2011-01-17,2,Monday,Spring,2,Early Morning,8,0,8
2011-01-17,3,Monday,Spring,2,Early Morning,2,0,2
2011-01-17,4,Monday,Spring,2,Early Morning,3,1,2
2011-01-17,5,Monday,Spring,2,Early Morning,1,0,1
2011-01-17,6,Monday,Spring,2,Morning Rush,5,0,5
2011-01-17,7,Monday,Spring,2,Morning Rush,13,4,9
2011-01-17,8,Monday,Spring,2,Morning Rush,33,3,30
2011-01-17,9,Monday,Spring,2,Morning Rush,47,8,39
2011-01-17,10,Monday,Spring,2,Mid-Day,57,7,50
2011-01-17,11,Monday,Spring,2,Mid-Day,64,9,55
2011-01-17,12,Monday,Spring,2,Mid-Day,80,10,70
2011-01-17,13,Monday,Spring,2,Mid-Day,93,13,80
2011-01-17,14,Monday,Spring,2,Mid-Day,86,12,74
2011-01-17,15,Monday,Spring,2,Mid-Day,93,21,72
2011-01-17,16,Monday,Spring,2,Evening Rush,82,6,76
2011-01-17,17,Monday,Spring,1,Evening Rush,71,4,67
2011-01-17,18,Monday,Spring,2,Evening Rush,92,7,85
2011-01-17,19,Monday,Spring,3,Evening Rush,60,2,58
2011-01-17,20,Monday,Spring,3,Night,33,4,29
2011-01-17,21,Monday,Spring,3,Night,27,3,24
2011-01-17,22,Monday,Spring,3,Night,13,0,13
2011-01-17,23,Monday,Spring,3,Night,4,1,3
2011-01-18,12,Tuesday,Spring,2,Mid-Day,3,0,3
2011-01-18,13,Tuesday,Spring,2,Mid-Day,22,0,22
2011-01-18,14,Tuesday,Spring,2,Mid-Day,28,2,26
2011-01-18,15,Tuesday,Spring,2,Mid-Day,35,3,32
2011-01-18,16,Tuesday,Spring,2,Evening Rush,61,0,61
2011-01-18,17,Tuesday,Spring,2,Evening Rush,125,1,124
2011-01-18,18,Tuesday,Spring,2,Evening Rush,133,1,132
2011-01-18,19,Tuesday,Spring,2,Evening Rush,99,1,98
2011-01-18,20,Tuesday,Spring,2,Night,83,0,83
2011-01-18,21,Tuesday,Spring,2,Night,41,0,41
2011-01-18,22,Tuesday,Spring,2,Night,33,0,33
2011-01-18,23,Tuesday,Spring,2,Night,20,1,19
2011-01-19,0,Wednesday,Spring,2,Early Morning,3,0,3
2011-01-19,1,Wednesday,Spring,3,Early Morning,7,1,6
2011-01-19,2,Wednesday,Spring,3,Early Morning,3,0,3
2011-01-19,4,Wednesday,Spring,3,Early Morning,2,1,1
2011-01-19,5,Wednesday,Spring,2,Early Morning,7,0,7
2011-01-19,6,Wednesday,Spring,2,Morning Rush,32,0,32
2011-01-19,7,Wednesday,Spring,2,Morning Rush,90,1,89
2011-01-19,8,Wednesday,Spring,2,Morning Rush,197,1,196
2011-01-19,9,Wednesday,Spring,2,Morning Rush,109,2,107
2011-01-19,10,Wednesday,Spring,2,Mid-Day,47,1,46
2011-01-19,11,Wednesday,Spring,2,Mid-Day,52,5,47
2011-01-19,12,Wednesday,Spring,2,Mid-Day,70,5,65
2011-01-19,13,Wednesday,Spring,1,Mid-Day,78,11,67
2011-01-19,14,Wednesday,Spring,1,Mid-Day,75,7,68
2011-01-19,15,Wednesday,Spring,1,Mid-Day,82,4,78
2011-01-19,16,Wednesday,Spring,1,Evening Rush,104,10,94
2011-01-19,17,Wednesday,Spring,1,Evening Rush,197,7,190
2011-01-19,18,Wednesday,Spring,1,Evening Rush,161,5,156
2011-01-19,19,Wednesday,Spring,1,Evening Rush,112,4,108
2011-01-19,20,Wednesday,Spring,1,Night,76,2,74
2011-01-19,21,Wednesday,Spring,1,Night,59,4,55
2011-01-19,22,Wednesday,Spring,1,Night,59,6,53
2011-01-19,23,Wednesday,Spring,1,Night,28,1,27
2011-01-20,0,Thursday,Spring,1,Early Morning,13,5,8
2011-01-20,1,Thursday,Spring,1,Early Morning,5,2,3
2011-01-20,2,Thursday,Spring,1,Early Morning,2,0,2
2011-01-20,3,Thursday,Spring,1,Early Morning,1,0,1
2011-01-20,4,Thursday,Spring,1,Early Morning,1,0,1
2011-01-20,5,Thursday,Spring,1,Early Morning,6,0,6
2011-01-20,6,Thursday,Spring,1,Morning Rush,35,0,35
2011-01-20,7,Thursday,Spring,1,Morning Rush,101,1,100
2011-01-20,8,Thursday,Spring,1,Morning Rush,249,2,247
2011-01-20,9,Thursday,Spring,2,Morning Rush,143,3,140
2011-01-20,10,Thursday,Spring,1,Mid-Day,57,1,56
2011-01-20,11,Thursday,Spring,2,Mid-Day,68,5,63
2011-01-20,12,Thursday,Spring,2,Mid-Day,84,7,77
2011-01-20,13,Thursday,Spring,2,Mid-Day,98,12,86
2011-01-20,14,Thursday,Spring,2,Mid-Day,81,6,75
2011-01-20,15,Thursday,Spring,2,Mid-Day,70,8,62
2011-01-20,16,Thursday,Spring,2,Evening Rush,91,8,83
2011-01-20,17,Thursday,Spring,2,Evening Rush,215,8,207
2011-01-20,18,Thursday,Spring,2,Evening Rush,185,1,184
2011-01-20,19,Thursday,Spring,1,Evening Rush,152,6,146
2011-01-20,20,Thursday,Spring,2,Night,126,2,124
2011-01-20,21,Thursday,Spring,2,Night,57,3,54
2011-01-20,22,Thursday,Spring,2,Night,56,0,56
2011-01-20,23,Thursday,Spring,2,Night,31,3,28
2011-01-21,0,Friday,Spring,2,Early Morning,21,1,20
2011-01-21,1,Friday,Spring,2,Early Morning,6,0,6
2011-01-21,2,Friday,Spring,3,Early Morning,2,0,2
2011-01-21,3,Friday,Spring,3,Early Morning,1,0,1
2011-01-21,4,Friday,Spring,2,Early Morning,1,0,1
2011-01-21,5,Friday,Spring,1,Early Morning,5,1,4
2011-01-21,6,Friday,Spring,1,Morning Rush,27,0,27
2011-01-21,7,Friday,Spring,1,Morning Rush,68,2,66
2011-01-21,8,Friday,Spring,1,Morning Rush,217,7,210
2011-01-21,9,Friday,Spring,1,Morning Rush,166,7,159
2011-01-21,10,Friday,Spring,1,Mid-Day,63,6,57
2011-01-21,11,Friday,Spring,1,Mid-Day,59,6,53
2011-01-21,12,Friday,Spring,1,Mid-Day,78,11,67
2011-01-21,13,Friday,Spring,1,Mid-Day,73,8,65
2011-01-21,14,Friday,Spring,1,Mid-Day,62,6,56
2011-01-21,15,Friday,Spring,1,Mid-Day,65,4,61
2011-01-21,16,Friday,Spring,1,Evening Rush,97,0,97
2011-01-21,17,Friday,Spring,1,Evening Rush,161,10,151
2011-01-21,18,Friday,Spring,1,Evening Rush,120,1,119
2011-01-21,19,Friday,Spring,1,Evening Rush,96,3,93
2011-01-21,20,Friday,Spring,1,Night,53,1,52
2011-01-21,21,Friday,Spring,1,Night,41,0,41
2011-01-21,22,Friday,Spring,1,Night,34,1,33
2011-01-21,23,Friday,Spring,1,Night,27,0,27
2011-01-22,0,Saturday,Spring,1,Early Morning,13,0,13
2011-01-22,1,Saturday,Spring,2,Early Morning,12,3,9
2011-01-22,2,Saturday,Spring,2,Early Morning,11,0,11
2011-01-22,3,Saturday,Spring,2,Early Morning,7,1,6
2011-01-22,4,Saturday,Spring,2,Early Morning,3,0,3
2011-01-22,6,Saturday,Spring,2,Morning Rush,2,0,2
2011-01-22,7,Saturday,Spring,1,Morning Rush,8,0,8
2011-01-22,8,Saturday,Spring,1,Morning Rush,27,1,26
2011-01-22,9,Saturday,Spring,1,Morning Rush,40,3,37
2011-01-22,10,Saturday,Spring,2,Mid-Day,53,3,50
2011-01-22,11,Saturday,Spring,2,Mid-Day,63,4,59
2011-01-22,12,Saturday,Spring,2,Mid-Day,70,10,60
2011-01-22,13,Saturday,Spring,1,Mid-Day,84,12,72
2011-01-22,14,Saturday,Spring,1,Mid-Day,75,11,64
2011-01-22,15,Saturday,Spring,1,Mid-Day,103,10,93
2011-01-22,16,Saturday,Spring,1,Evening Rush,83,11,72
2011-01-22,17,Saturday,Spring,1,Evening Rush,67,8,59
2011-01-22,18,Saturday,Spring,1,Evening Rush,54,0,54
2011-01-22,19,Saturday,Spring,1,Evening Rush,59,6,53
2011-01-22,20,Saturday,Spring,1,Night,45,1,44
2011-01-22,21,Saturday,Spring,1,Night,39,0,39
2011-01-22,22,Saturday,Spring,1,Night,30,7,23
2011-01-22,23,Saturday,Spring,1,Night,33,2,31
2011-01-23,0,Sunday,Spring,1,Early Morning,22,2,20
2011-01-23,1,Sunday,Spring,1,Early Morning,13,1,12
2011-01-23,2,Sunday,Spring,1,Early Morning,18,3,15
2011-01-23,3,Sunday,Spring,1,Early Morning,5,1,4
2011-01-23,5,Sunday,Spring,2,Early Morning,3,0,3
2011-01-23,6,Sunday,Spring,2,Morning Rush,1,0,1
2011-01-23,7,Sunday,Spring,1,Morning Rush,2,1,1
2011-01-23,8,Sunday,Spring,1,Morning Rush,19,2,17
2011-01-23,9,Sunday,Spring,1,Morning Rush,28,3,25
2011-01-23,10,Sunday,Spring,1,Mid-Day,58,7,51
2011-01-23,11,Sunday,Spring,1,Mid-Day,99,22,77
2011-01-23,12,Sunday,Spring,1,Mid-Day,116,24,92
2011-01-23,13,Sunday,Spring,1,Mid-Day,87,12,75
2011-01-23,14,Sunday,Spring,1,Mid-Day,110,17,93
2011-01-23,15,Sunday,Spring,1,Mid-Day,77,13,64
2011-01-23,16,Sunday,Spring,1,Evening Rush,65,9,56
2011-01-23,17,Sunday,Spring,1,Evening Rush,55,5,50
2011-01-23,18,Sunday,Spring,1,Evening Rush,49,5,44
2011-01-23,19,Sunday,Spring,1,Evening Rush,50,5,45
2011-01-23,20,Sunday,Spring,1,Night,35,4,31
2011-01-23,21,Sunday,Spring,1,Night,25,5,20
2011-01-23,22,Sunday,Spring,1,Night,28,5,23
2011-01-23,23,Sunday,Spring,1,Night,21,4,17
2011-01-24,0,Monday,Spring,1,Early Morning,7,0,7
2011-01-24,1,Monday,Spring,1,Early Morning,1,0,1
2011-01-24,3,Monday,Spring,1,Early Morning,1,0,1
2011-01-24,4,Monday,Spring,1,Early Morning,1,0,1
2011-01-24,5,Monday,Spring,1,Early Morning,5,0,5
2011-01-24,6,Monday,Spring,1,Morning Rush,15,0,15
2011-01-24,7,Monday,Spring,1,Morning Rush,84,5,79
2011-01-24,8,Monday,Spring,1,Morning Rush,177,6,171
2011-01-24,9,Monday,Spring,1,Morning Rush,102,4,98
2011-01-24,10,Monday,Spring,1,Mid-Day,40,6,34
2011-01-24,11,Monday,Spring,1,Mid-Day,46,3,43
2011-01-24,12,Monday,Spring,2,Mid-Day,63,11,52
2011-01-24,13,Monday,Spring,2,Mid-Day,60,6,54
2011-01-24,14,Monday,Spring,2,Mid-Day,45,2,43
2011-01-24,15,Monday,Spring,1,Mid-Day,57,7,50
2011-01-24,16,Monday,Spring,1,Evening Rush,70,4,66
2011-01-24,17,Monday,Spring,1,Evening Rush,184,6,178
2011-01-24,18,Monday,Spring,1,Evening Rush,153,8,145
2011-01-24,19,Monday,Spring,1,Evening Rush,106,5,101
2011-01-24,20,Monday,Spring,1,Night,81,1,80
2011-01-24,21,Monday,Spring,1,Night,59,6,53
2011-01-24,22,Monday,Spring,2,Night,35,3,32
2011-01-24,23,Monday,Spring,2,Night,24,3,21
2011-01-25,0,Tuesday,Spring,2,Early Morning,9,3,6
2011-01-25,1,Tuesday,Spring,2,Early Morning,5,0,5
2011-01-25,2,Tuesday,Spring,1,Early Morning,2,0,2
2011-01-25,4,Tuesday,Spring,1,Early Morning,1,0,1
2011-01-25,5,Tuesday,Spring,1,Early Morning,9,0,9
2011-01-25,6,Tuesday,Spring,1,Morning Rush,36,1,35
2011-01-25,7,Tuesday,Spring,1,Morning Rush,108,5,103
2011-01-25,8,Tuesday,Spring,2,Morning Rush,238,5,233
2011-01-25,9,Tuesday,Spring,2,Morning Rush,144,10,134
2011-01-25,10,Tuesday,Spring,2,Mid-Day,55,6,49
2011-01-25,11,Tuesday,Spring,2,Mid-Day,61,6,55
2011-01-25,12,Tuesday,Spring,2,Mid-Day,106,21,85
2011-01-25,13,Tuesday,Spring,2,Mid-Day,93,21,72
2011-01-25,14,Tuesday,Spring,2,Mid-Day,68,11,57
2011-01-25,15,Tuesday,Spring,2,Mid-Day,84,21,63
2011-01-25,16,Tuesday,Spring,2,Evening Rush,116,14,102
2011-01-25,17,Tuesday,Spring,1,Evening Rush,222,14,208
2011-01-25,18,Tuesday,Spring,2,Evening Rush,225,7,218
2011-01-25,19,Tuesday,Spring,2,Evening Rush,146,13,133
2011-01-25,20,Tuesday,Spring,1,Night,119,16,103
2011-01-25,21,Tuesday,Spring,1,Night,45,5,40
2011-01-25,22,Tuesday,Spring,1,Night,53,4,49
2011-01-25,23,Tuesday,Spring,2,Night,40,3,37
2011-01-26,0,Wednesday,Spring,2,Early Morning,17,3,14
2011-01-26,1,Wednesday,Spring,2,Early Morning,5,0,5
2011-01-26,2,Wednesday,Spring,3,Early Morning,10,3,7
2011-01-26,5,Wednesday,Spring,3,Early Morning,1,0,1
2011-01-26,6,Wednesday,Spring,3,Morning Rush,8,0,8
2011-01-26,7,Wednesday,Spring,3,Morning Rush,30,1,29
2011-01-26,8,Wednesday,Spring,3,Morning Rush,72,3,69
2011-01-26,9,Wednesday,Spring,3,Morning Rush,58,3,55
2011-01-26,10,Wednesday,Spring,3,Mid-Day,28,2,26
2011-01-26,11,Wednesday,Spring,3,Mid-Day,41,6,35
2011-01-26,12,Wednesday,Spring,3,Mid-Day,48,7,41
2011-01-26,13,Wednesday,Spring,3,Mid-Day,47,4,43
2011-01-26,14,Wednesday,Spring,3,Mid-Day,36,0,36
2011-01-26,15,Wednesday,Spring,3,Mid-Day,43,1,42
2011-01-26,16,Wednesday,Spring,4,Evening Rush,36,1,35
2011-01-26,17,Wednesday,Spring,3,Evening Rush,26,0,26
2011-01-27,16,Thursday,Spring,1,Evening Rush,24,1,23
2011-01-27,17,Thursday,Spring,1,Evening Rush,84,2,82
2011-01-27,18,Thursday,Spring,1,Evening Rush,104,3,101
2011-01-27,19,Thursday,Spring,1,Evening Rush,79,3,76
2011-01-27,20,Thursday,Spring,1,Night,59,4,55
2011-01-27,21,Thursday,Spring,1,Night,38,2,36
2011-01-27,22,Thursday,Spring,1,Night,27,0,27
2011-01-27,23,Thursday,Spring,1,Night,16,0,16
2011-01-28,0,Friday,Spring,2,Early Morning,9,0,9
2011-01-28,1,Friday,Spring,2,Early Morning,3,1,2
2011-01-28,2,Friday,Spring,2,Early Morning,2,0,2
2011-01-28,3,Friday,Spring,2,Early Morning,1,1,0
2011-01-28,5,Friday,Spring,2,Early Morning,4,0,4
2011-01-28,6,Friday,Spring,2,Morning Rush,16,0,16
2011-01-28,7,Friday,Spring,2,Morning Rush,60,2,58
2011-01-28,8,Friday,Spring,2,Morning Rush,157,2,155
2011-01-28,9,Friday,Spring,3,Morning Rush,101,6,95
2011-01-28,10,Friday,Spring,3,Mid-Day,49,0,49
2011-01-28,11,Friday,Spring,3,Mid-Day,30,0,30
2011-01-28,12,Friday,Spring,3,Mid-Day,29,1,28
2011-01-28,13,Friday,Spring,3,Mid-Day,31,0,31
2011-01-28,14,Friday,Spring,3,Mid-Day,38,2,36
2011-01-28,15,Friday,Spring,2,Mid-Day,41,1,40
2011-01-28,16,Friday,Spring,1,Evening Rush,80,10,70
2011-01-28,17,Friday,Spring,1,Evening Rush,149,2,147
2011-01-28,18,Friday,Spring,1,Evening Rush,109,2,107
2011-01-28,19,Friday,Spring,2,Evening Rush,89,5,84
2011-01-28,20,Friday,Spring,2,Night,62,1,61
2011-01-28,21,Friday,Spring,2,Night,58,1,57
2011-01-28,22,Friday,Spring,1,Night,26,0,26
2011-01-28,23,Friday,Spring,1,Night,23,1,22
2011-01-29,0,Saturday,Spring,1,Early Morning,28,2,26
2011-01-29,1,Saturday,Spring,1,Early Morning,20,0,20
2011-01-29,2,Saturday,Spring,1,Early Morning,15,0,15
2011-01-29,3,Saturday,Spring,1,Early Morning,8,3,5
2011-01-29,4,Saturday,Spring,1,Early Morning,3,1,2
2011-01-29,6,Saturday,Spring,1,Morning Rush,2,0,2
2011-01-29,7,Saturday,Spring,1,Morning Rush,5,1,4
2011-01-29,8,Saturday,Spring,1,Morning Rush,34,3,31
2011-01-29,9,Saturday,Spring,1,Morning Rush,34,0,34
2011-01-29,10,Saturday,Spring,2,Mid-Day,55,4,51
2011-01-29,11,Saturday,Spring,2,Mid-Day,64,4,60
2011-01-29,12,Saturday,Spring,2,Mid-Day,78,12,66
2011-01-29,13,Saturday,Spring,2,Mid-Day,65,9,56
2011-01-29,14,Saturday,Spring,2,Mid-Day,99,10,89
2011-01-29,15,Saturday,Spring,1,Mid-Day,120,22,98
2011-01-29,16,Saturday,Spring,1,Evening Rush,107,19,88
2011-01-29,17,Saturday,Spring,1,Evening Rush,91,9,82
2011-01-29,18,Saturday,Spring,1,Evening Rush,68,9,59
2011-01-29,19,Saturday,Spring,2,Evening Rush,58,6,52
2011-01-29,20,Saturday,Spring,1,Night,43,1,42
2011-01-29,21,Saturday,Spring,1,Night,36,1,35
2011-01-29,22,Saturday,Spring,1,Night,32,4,28
2011-01-29,23,Saturday,Spring,1,Night,33,3,30
2011-01-30,0,Sunday,Spring,1,Early Morning,33,0,33
2011-01-30,1,Sunday,Spring,1,Early Morning,29,7,22
2011-01-30,2,Sunday,Spring,1,Early Morning,11,1,10
2011-01-30,3,Sunday,Spring,1,Early Morning,8,1,7
2011-01-30,4,Sunday,Spring,1,Early Morning,1,0,1
2011-01-30,5,Sunday,Spring,1,Early Morning,3,0,3
2011-01-30,7,Sunday,Spring,1,Morning Rush,3,0,3
2011-01-30,8,Sunday,Spring,2,Morning Rush,12,1,11
2011-01-30,9,Sunday,Spring,2,Morning Rush,38,4,34
2011-01-30,10,Sunday,Spring,2,Mid-Day,64,7,57
2011-01-30,11,Sunday,Spring,1,Mid-Day,59,9,50
2011-01-30,12,Sunday,Spring,1,Mid-Day,97,10,87
2011-01-30,13,Sunday,Spring,1,Mid-Day,84,13,71
2011-01-30,14,Sunday,Spring,1,Mid-Day,122,18,104
2011-01-30,15,Sunday,Spring,1,Mid-Day,109,14,95
2011-01-30,16,Sunday,Spring,1,Evening Rush,123,19,104
2011-01-30,17,Sunday,Spring,1,Evening Rush,77,6,71
2011-01-30,18,Sunday,Spring,1,Evening Rush,65,8,57
2011-01-30,19,Sunday,Spring,1,Evening Rush,55,9,46
2011-01-30,20,Sunday,Spring,2,Night,33,3,30
2011-01-30,21,Sunday,Spring,2,Night,28,3,25
2011-01-30,22,Sunday,Spring,2,Night,21,2,19
2011-01-30,23,Sunday,Spring,2,Night,21,5,16
2011-01-31,0,Monday,Spring,2,Early Morning,7,1,6
2011-01-31,1,Monday,Spring,1,Early Morning,7,2,5
2011-01-31,2,Monday,Spring,1,Early Morning,1,0,1
2011-01-31,3,Monday,Spring,1,Early Morning,2,0,2
2011-01-31,4,Monday,Spring,1,Early Morning,2,0,2
2011-01-31,5,Monday,Spring,1,Early Morning,8,0,8
2011-01-31,6,Monday,Spring,1,Morning Rush,37,0,37
2011-01-31,7,Monday,Spring,2,Morning Rush,72,1,71
2011-01-31,8,Monday,Spring,2,Morning Rush,185,3,182
2011-01-31,9,Monday,Spring,2,Morning Rush,112,0,112
2011-01-31,10,Monday,Spring,2,Mid-Day,69,1,68
2011-01-31,11,Monday,Spring,2,Mid-Day,48,2,46
2011-01-31,12,Monday,Spring,2,Mid-Day,68,6,62
2011-01-31,13,Monday,Spring,2,Mid-Day,54,2,52
2011-01-31,14,Monday,Spring,2,Mid-Day,86,1,85
2011-01-31,15,Monday,Spring,2,Mid-Day,44,3,41
2011-01-31,16,Monday,Spring,2,Evening Rush,86,3,83
2011-01-31,17,Monday,Spring,2,Evening Rush,161,6,155
2011-01-31,18,Monday,Spring,2,Evening Rush,156,3,153
2011-01-31,19,Monday,Spring,1,Evening Rush,111,3,108
2011-01-31,20,Monday,Spring,3,Night,78,0,78
2011-01-31,21,Monday,Spring,3,Night,56,3,53
2011-01-31,22,Monday,Spring,2,Night,34,0,34
2011-01-31,23,Monday,Spring,2,Night,17,2,15
2011-02-01,0,Tuesday,Spring,2,Early Morning,8,2,6
2011-02-01,1,Tuesday,Spring,2,Early Morning,3,0,3
2011-02-01,2,Tuesday,Spring,2,Early Morning,2,0,2
2011-02-01,3,Tuesday,Spring,2,Early Morning,2,0,2
2011-02-01,5,Tuesday,Spring,3,Early Morning,3,0,3
2011-02-01,6,Tuesday,Spring,3,Morning Rush,22,0,22
2011-02-01,7,Tuesday,Spring,3,Morning Rush,52,0,52
2011-02-01,8,Tuesday,Spring,3,Morning Rush,135,3,132
2011-02-01,9,Tuesday,Spring,2,Morning Rush,116,2,114
2011-02-01,10,Tuesday,Spring,2,Mid-Day,47,0,47
2011-02-01,11,Tuesday,Spring,2,Mid-Day,51,2,49
2011-02-01,12,Tuesday,Spring,2,Mid-Day,55,2,53
2011-02-01,13,Tuesday,Spring,2,Mid-Day,52,3,49
2011-02-01,14,Tuesday,Spring,2,Mid-Day,54,5,49
2011-02-01,15,Tuesday,Spring,2,Mid-Day,52,7,45
2011-02-01,16,Tuesday,Spring,2,Evening Rush,64,3,61
2011-02-01,17,Tuesday,Spring,2,Evening Rush,176,4,172
2011-02-01,18,Tuesday,Spring,2,Evening Rush,168,3,165
2011-02-01,19,Tuesday,Spring,2,Evening Rush,108,3,105
2011-02-01,20,Tuesday,Spring,2,Night,74,5,69
2011-02-01,21,Tuesday,Spring,2,Night,64,0,64
2011-02-01,22,Tuesday,Spring,2,Night,36,2,34
2011-02-01,23,Tuesday,Spring,3,Night,16,1,15
2011-02-02,0,Wednesday,Spring,3,Early Morning,2,0,2
2011-02-02,1,Wednesday,Spring,3,Early Morning,3,0,3
2011-02-02,2,Wednesday,Spring,3,Early Morning,4,4,0
2011-02-02,3,Wednesday,Spring,3,Early Morning,1,0,1
2011-02-02,4,Wednesday,Spring,3,Early Morning,1,0,1
2011-02-02,5,Wednesday,Spring,3,Early Morning,3,0,3
2011-02-02,6,Wednesday,Spring,3,Morning Rush,18,1,17
2011-02-02,7,Wednesday,Spring,3,Morning Rush,49,1,48
2011-02-02,8,Wednesday,Spring,3,Morning Rush,155,1,154
2011-02-02,9,Wednesday,Spring,2,Morning Rush,123,4,119
2011-02-02,10,Wednesday,Spring,2,Mid-Day,61,2,59
2011-02-02,11,Wednesday,Spring,2,Mid-Day,52,5,47
2011-02-02,12,Wednesday,Spring,2,Mid-Day,64,3,61
2011-02-02,13,Wednesday,Spring,1,Mid-Day,75,1,74
2011-02-02,14,Wednesday,Spring,1,Mid-Day,63,2,61
2011-02-02,15,Wednesday,Spring,1,Mid-Day,76,10,66
2011-02-02,16,Wednesday,Spring,1,Evening Rush,103,8,95
2011-02-02,17,Wednesday,Spring,1,Evening Rush,190,7,183
2011-02-02,18,Wednesday,Spring,1,Evening Rush,182,7,175
2011-02-02,19,Wednesday,Spring,1,Evening Rush,91,3,88
2011-02-02,20,Wednesday,Spring,1,Night,75,4,71
2011-02-02,21,Wednesday,Spring,1,Night,63,1,62
2011-02-02,22,Wednesday,Spring,1,Night,40,5,35
2011-02-02,23,Wednesday,Spring,1,Night,32,3,29
2011-02-03,0,Thursday,Spring,1,Early Morning,12,1,11
2011-02-03,1,Thursday,Spring,1,Early Morning,5,0,5
2011-02-03,2,Thursday,Spring,1,Early Morning,2,0,2
2011-02-03,3,Thursday,Spring,1,Early Morning,1,0,1
2011-02-03,5,Thursday,Spring,1,Early Morning,2,0,2
2011-02-03,6,Thursday,Spring,1,Morning Rush,39,0,39
2011-02-03,7,Thursday,Spring,1,Morning Rush,87,1,86
2011-02-03,8,Thursday,Spring,1,Morning Rush,188,4,184
2011-02-03,9,Thursday,Spring,1,Morning Rush,133,6,127
2011-02-03,10,Thursday,Spring,1,Mid-Day,52,2,50
2011-02-03,11,Thursday,Spring,1,Mid-Day,64,9,55
2011-02-03,12,Thursday,Spring,1,Mid-Day,69,2,67
2011-02-03,13,Thursday,Spring,1,Mid-Day,51,4,47
2011-02-03,14,Thursday,Spring,1,Mid-Day,47,4,43
2011-02-03,15,Thursday,Spring,1,Mid-Day,60,4,56
2011-02-03,16,Thursday,Spring,1,Evening Rush,78,5,73
2011-02-03,17,Thursday,Spring,1,Evening Rush,175,5,170
2011-02-03,18,Thursday,Spring,1,Evening Rush,147,2,145
2011-02-03,19,Thursday,Spring,1,Evening Rush,96,4,92
2011-02-03,20,Thursday,Spring,1,Night,109,1,108
2011-02-03,21,Thursday,Spring,1,Night,54,1,53
2011-02-03,22,Thursday,Spring,1,Night,41,2,39
2011-02-03,23,Thursday,Spring,1,Night,38,4,34
2011-02-04,0,Friday,Spring,2,Early Morning,13,3,10
2011-02-04,1,Friday,Spring,2,Early Morning,7,0,7
2011-02-04,2,Friday,Spring,2,Early Morning,1,0,1
2011-02-04,3,Friday,Spring,2,Early Morning,1,0,1
2011-02-04,5,Friday,Spring,2,Early Morning,7,0,7
2011-02-04,6,Friday,Spring,2,Morning Rush,28,2,26
2011-02-04,7,Friday,Spring,1,Morning Rush,87,0,87
2011-02-04,8,Friday,Spring,1,Morning Rush,220,3,217
2011-02-04,9,Friday,Spring,2,Morning Rush,127,3,124
2011-02-04,10,Friday,Spring,2,Mid-Day,51,5,46
2011-02-04,11,Friday,Spring,1,Mid-Day,64,3,61
2011-02-04,12,Friday,Spring,2,Mid-Day,86,8,78
2011-02-04,13,Friday,Spring,2,Mid-Day,82,9,73
2011-02-04,14,Friday,Spring,2,Mid-Day,91,15,76
2011-02-04,15,Friday,Spring,2,Mid-Day,90,9,81
2011-02-04,16,Friday,Spring,2,Evening Rush,99,8,91
2011-02-04,17,Friday,Spring,2,Evening Rush,205,10,195
2011-02-04,18,Friday,Spring,2,Evening Rush,155,3,152
2011-02-04,19,Friday,Spring,2,Evening Rush,103,1,102
2011-02-04,20,Friday,Spring,2,Night,71,2,69
2011-02-04,21,Friday,Spring,2,Night,43,2,41
2011-02-04,22,Friday,Spring,2,Night,46,1,45
2011-02-04,23,Friday,Spring,2,Night,31,1,30
2011-02-05,0,Saturday,Spring,2,Early Morning,39,3,36
2011-02-05,1,Saturday,Spring,2,Early Morning,18,1,17
2011-02-05,2,Saturday,Spring,2,Early Morning,17,5,12
2011-02-05,3,Saturday,Spring,2,Early Morning,11,1,10
2011-02-05,4,Saturday,Spring,3,Early Morning,8,0,8
2011-02-05,5,Saturday,Spring,3,Early Morning,9,0,9
2011-02-05,6,Saturday,Spring,3,Morning Rush,4,0,4
2011-02-05,7,Saturday,Spring,3,Morning Rush,4,0,4
2011-02-05,8,Saturday,Spring,3,Morning Rush,10,0,10
2011-02-05,9,Saturday,Spring,3,Morning Rush,20,3,17
2011-02-05,10,Saturday,Spring,3,Mid-Day,34,3,31
2011-02-05,11,Saturday,Spring,3,Mid-Day,47,1,46
2011-02-05,12,Saturday,Spring,3,Mid-Day,52,10,42
2011-02-05,13,Saturday,Spring,3,Mid-Day,72,10,62
2011-02-05,14,Saturday,Spring,3,Mid-Day,55,5,50
2011-02-05,15,Saturday,Spring,3,Mid-Day,60,11,49
2011-02-05,16,Saturday,Spring,3,Evening Rush,71,8,63
2011-02-05,17,Saturday,Spring,2,Evening Rush,78,14,64
2011-02-05,18,Saturday,Spring,2,Evening Rush,83,2,81
2011-02-05,19,Saturday,Spring,2,Evening Rush,84,6,78
2011-02-05,20,Saturday,Spring,1,Night,69,5,64
2011-02-05,21,Saturday,Spring,1,Night,56,3,53
2011-02-05,22,Saturday,Spring,1,Night,45,2,43
2011-02-05,23,Saturday,Spring,1,Night,59,7,52
2011-02-06,0,Sunday,Spring,1,Early Morning,39,2,37
2011-02-06,1,Sunday,Spring,1,Early Morning,44,4,40
2011-02-06,2,Sunday,Spring,1,Early Morning,20,0,20
2011-02-06,3,Sunday,Spring,1,Early Morning,13,3,10
2011-02-06,4,Sunday,Spring,1,Early Morning,2,0,2
2011-02-06,5,Sunday,Spring,1,Early Morning,1,0,1
2011-02-06,6,Sunday,Spring,1,Morning Rush,1,0,1
2011-02-06,7,Sunday,Spring,1,Morning Rush,8,0,8
2011-02-06,8,Sunday,Spring,1,Morning Rush,23,2,21
2011-02-06,9,Sunday,Spring,1,Morning Rush,45,7,38
2011-02-06,10,Sunday,Spring,1,Mid-Day,89,15,74
2011-02-06,11,Sunday,Spring,1,Mid-Day,117,28,89
2011-02-06,12,Sunday,Spring,1,Mid-Day,174,48,126
2011-02-06,13,Sunday,Spring,1,Mid-Day,182,47,135
2011-02-06,14,Sunday,Spring,1,Mid-Day,161,47,114
2011-02-06,15,Sunday,Spring,1,Mid-Day,182,52,130
2011-02-06,16,Sunday,Spring,1,Evening Rush,157,42,115
2011-02-06,17,Sunday,Spring,1,Evening Rush,121,24,97
2011-02-06,18,Sunday,Spring,1,Evening Rush,78,13,65
2011-02-06,19,Sunday,Spring,1,Evening Rush,21,1,20
2011-02-06,20,Sunday,Spring,1,Night,26,5,21
2011-02-06,21,Sunday,Spring,1,Night,27,5,22
2011-02-06,22,Sunday,Spring,1,Night,62,5,57
2011-02-06,23,Sunday,Spring,1,Night,30,4,26
2011-02-07,0,Monday,Spring,1,Early Morning,15,1,14
2011-02-07,1,Monday,Spring,1,Early Morning,5,1,4
2011-02-07,2,Monday,Spring,1,Early Morning,3,0,3
2011-02-07,3,Monday,Spring,1,Early Morning,1,0,1
2011-02-07,4,Monday,Spring,1,Early Morning,2,1,1
2011-02-07,5,Monday,Spring,1,Early Morning,10,1,9
2011-02-07,6,Monday,Spring,1,Morning Rush,30,1,29
2011-02-07,7,Monday,Spring,1,Morning Rush,95,6,89
2011-02-07,8,Monday,Spring,2,Morning Rush,230,7,223
2011-02-07,9,Monday,Spring,1,Morning Rush,118,3,115
2011-02-07,10,Monday,Spring,1,Mid-Day,55,6,49
2011-02-07,11,Monday,Spring,1,Mid-Day,47,11,36
2011-02-07,12,Monday,Spring,2,Mid-Day,66,7,59
2011-02-07,13,Monday,Spring,2,Mid-Day,64,10,54
2011-02-07,14,Monday,Spring,2,Mid-Day,60,8,52
2011-02-07,15,Monday,Spring,2,Mid-Day,50,4,46
2011-02-07,16,Monday,Spring,2,Evening Rush,114,16,98
2011-02-07,17,Monday,Spring,2,Evening Rush,216,9,207
2011-02-07,18,Monday,Spring,2,Evening Rush,175,5,170
2011-02-07,19,Monday,Spring,2,Evening Rush,128,5,123
2011-02-07,20,Monday,Spring,2,Night,88,6,82
2011-02-07,21,Monday,Spring,1,Night,78,3,75
2011-02-07,22,Monday,Spring,1,Night,37,3,34
2011-02-07,23,Monday,Spring,2,Night,25,6,19
2011-02-08,0,Tuesday,Spring,2,Early Morning,10,4,6
2011-02-08,1,Tuesday,Spring,2,Early Morning,4,0,4
2011-02-08,2,Tuesday,Spring,2,Early Morning,2,1,1
2011-02-08,3,Tuesday,Spring,3,Early Morning,1,0,1
2011-02-08,4,Tuesday,Spring,1,Early Morning,3,0,3
2011-02-08,5,Tuesday,Spring,1,Early Morning,2,0,2
2011-02-08,6,Tuesday,Spring,1,Morning Rush,39,0,39
2011-02-08,7,Tuesday,Spring,1,Morning Rush,100,3,97
2011-02-08,8,Tuesday,Spring,1,Morning Rush,243,7,236
2011-02-08,9,Tuesday,Spring,1,Morning Rush,135,7,128
2011-02-08,10,Tuesday,Spring,1,Mid-Day,48,4,44
2011-02-08,11,Tuesday,Spring,1,Mid-Day,50,1,49
2011-02-08,12,Tuesday,Spring,1,Mid-Day,65,2,63
2011-02-08,13,Tuesday,Spring,2,Mid-Day,50,2,48
2011-02-08,14,Tuesday,Spring,1,Mid-Day,64,3,61
2011-02-08,15,Tuesday,Spring,1,Mid-Day,51,6,45
2011-02-08,16,Tuesday,Spring,1,Evening Rush,83,4,79
2011-02-08,17,Tuesday,Spring,1,Evening Rush,176,4,172
2011-02-08,18,Tuesday,Spring,1,Evening Rush,152,1,151
2011-02-08,19,Tuesday,Spring,1,Evening Rush,101,1,100
2011-02-08,20,Tuesday,Spring,1,Night,56,3,53
2011-02-08,21,Tuesday,Spring,1,Night,54,8,46
2011-02-08,22,Tuesday,Spring,1,Night,29,0,29
2011-02-08,23,Tuesday,Spring,1,Night,12,3,9
2011-02-09,0,Wednesday,Spring,1,Early Morning,17,0,17
2011-02-09,1,Wednesday,Spring,1,Early Morning,7,0,7
2011-02-09,2,Wednesday,Spring,1,Early Morning,3,1,2
2011-02-09,3,Wednesday,Spring,1,Early Morning,2,0,2
2011-02-09,5,Wednesday,Spring,1,Early Morning,7,0,7
2011-02-09,6,Wednesday,Spring,1,Morning Rush,43,0,43
2011-02-09,7,Wednesday,Spring,1,Morning Rush,99,4,95
2011-02-09,8,Wednesday,Spring,1,Morning Rush,199,1,198
2011-02-09,9,Wednesday,Spring,1,Morning Rush,123,4,119
2011-02-09,10,Wednesday,Spring,1,Mid-Day,59,8,51
2011-02-09,11,Wednesday,Spring,2,Mid-Day,41,1,40
2011-02-09,12,Wednesday,Spring,2,Mid-Day,61,4,57
2011-02-09,13,Wednesday,Spring,1,Mid-Day,69,2,67
2011-02-09,14,Wednesday,Spring,1,Mid-Day,58,2,56
2011-02-09,15,Wednesday,Spring,2,Mid-Day,64,3,61
2011-02-09,16,Wednesday,Spring,2,Evening Rush,79,7,72
2011-02-09,17,Wednesday,Spring,2,Evening Rush,166,9,157
2011-02-09,18,Wednesday,Spring,2,Evening Rush,170,2,168
2011-02-09,19,Wednesday,Spring,3,Evening Rush,88,1,87
2011-02-09,20,Wednesday,Spring,3,Night,84,0,84
2011-02-09,21,Wednesday,Spring,2,Night,83,0,83
2011-02-09,22,Wednesday,Spring,3,Night,46,4,42
2011-02-09,23,Wednesday,Spring,3,Night,37,0,37
2011-02-10,0,Thursday,Spring,3,Early Morning,16,0,16
2011-02-10,1,Thursday,Spring,3,Early Morning,7,0,7
2011-02-10,2,Thursday,Spring,3,Early Morning,3,0,3
2011-02-10,4,Thursday,Spring,2,Early Morning,1,0,1
2011-02-10,5,Thursday,Spring,2,Early Morning,6,0,6
2011-02-10,6,Thursday,Spring,2,Morning Rush,26,0,26
2011-02-10,7,Thursday,Spring,1,Morning Rush,99,0,99
2011-02-10,8,Thursday,Spring,1,Morning Rush,178,5,173
2011-02-10,9,Thursday,Spring,1,Morning Rush,122,1,121
2011-02-10,10,Thursday,Spring,1,Mid-Day,35,1,34
2011-02-10,11,Thursday,Spring,1,Mid-Day,45,1,44
2011-02-10,12,Thursday,Spring,1,Mid-Day,69,4,65
2011-02-10,13,Thursday,Spring,1,Mid-Day,62,3,59
2011-02-10,14,Thursday,Spring,1,Mid-Day,48,6,42
2011-02-10,15,Thursday,Spring,1,Mid-Day,50,0,50
2011-02-10,16,Thursday,Spring,1,Evening Rush,80,4,76
2011-02-10,17,Thursday,Spring,1,Evening Rush,165,6,159
2011-02-10,18,Thursday,Spring,1,Evening Rush,160,3,157
2011-02-10,19,Thursday,Spring,1,Evening Rush,112,2,110
2011-02-10,20,Thursday,Spring,1,Night,97,4,93
2011-02-10,21,Thursday,Spring,1,Night,72,2,70
2011-02-10,22,Thursday,Spring,1,Night,51,4,47
2011-02-10,23,Thursday,Spring,1,Night,34,1,33
2011-02-11,0,Friday,Spring,1,Early Morning,14,2,12
2011-02-11,1,Friday,Spring,1,Early Morning,7,1,6
2011-02-11,2,Friday,Spring,1,Early Morning,3,0,3
2011-02-11,5,Friday,Spring,1,Early Morning,4,0,4
2011-02-11,6,Friday,Spring,1,Morning Rush,24,1,23
2011-02-11,7,Friday,Spring,1,Morning Rush,74,1,73
2011-02-11,8,Friday,Spring,1,Morning Rush,216,4,212
2011-02-11,9,Friday,Spring,1,Morning Rush,140,8,132
2011-02-11,10,Friday,Spring,1,Mid-Day,44,5,39
2011-02-11,11,Friday,Spring,1,Mid-Day,64,12,52
2011-02-11,12,Friday,Spring,1,Mid-Day,71,7,64
2011-02-11,13,Friday,Spring,1,Mid-Day,110,21,89
2011-02-11,14,Friday,Spring,1,Mid-Day,84,17,67
2011-02-11,15,Friday,Spring,1,Mid-Day,74,12,62
2011-02-11,16,Friday,Spring,1,Evening Rush,125,14,111
2011-02-11,17,Friday,Spring,1,Evening Rush,211,18,193
2011-02-11,18,Friday,Spring,1,Evening Rush,174,9,165
2011-02-11,19,Friday,Spring,1,Evening Rush,101,7,94
2011-02-11,20,Friday,Spring,1,Night,63,2,61
2011-02-11,21,Friday,Spring,1,Night,47,1,46
2011-02-11,22,Friday,Spring,1,Night,43,2,41
2011-02-11,23,Friday,Spring,1,Night,53,5,48
2011-02-12,0,Saturday,Spring,1,Early Morning,30,3,27
2011-02-12,1,Saturday,Spring,1,Early Morning,24,2,22
2011-02-12,2,Saturday,Spring,1,Early Morning,15,2,13
2011-02-12,3,Saturday,Spring,1,Early Morning,10,3,7
2011-02-12,4,Saturday,Spring,1,Early Morning,4,0,4
2011-02-12,5,Saturday,Spring,1,Early Morning,1,0,1
2011-02-12,6,Saturday,Spring,1,Morning Rush,2,1,1
2011-02-12,7,Saturday,Spring,1,Morning Rush,11,2,9
2011-02-12,8,Saturday,Spring,1,Morning Rush,30,2,28
2011-02-12,9,Saturday,Spring,1,Morning Rush,43,5,38
2011-02-12,10,Saturday,Spring,1,Mid-Day,84,13,71
2011-02-12,11,Saturday,Spring,1,Mid-Day,114,30,84
2011-02-12,12,Saturday,Spring,1,Mid-Day,120,27,93
2011-02-12,13,Saturday,Spring,1,Mid-Day,135,32,103
2011-02-12,14,Saturday,Spring,1,Mid-Day,120,30,90
2011-02-12,15,Saturday,Spring,1,Mid-Day,174,47,127
2011-02-12,16,Saturday,Spring,1,Evening Rush,145,42,103
2011-02-12,17,Saturday,Spring,1,Evening Rush,137,24,113
2011-02-12,18,Saturday,Spring,1,Evening Rush,64,4,60
2011-02-12,19,Saturday,Spring,1,Evening Rush,41,2,39
2011-02-12,20,Saturday,Spring,1,Night,40,1,39
2011-02-12,21,Saturday,Spring,1,Night,51,9,42
2011-02-12,22,Saturday,Spring,1,Night,45,6,39
2011-02-12,23,Saturday,Spring,1,Night,32,1,31
2011-02-13,0,Sunday,Spring,1,Early Morning,39,5,34
2011-02-13,1,Sunday,Spring,1,Early Morning,24,1,23
2011-02-13,2,Sunday,Spring,2,Early Morning,20,1,19
2011-02-13,3,Sunday,Spring,2,Early Morning,12,4,8
2011-02-13,4,Sunday,Spring,2,Early Morning,2,0,2
2011-02-13,6,Sunday,Spring,2,Morning Rush,5,2,3
2011-02-13,7,Sunday,Spring,2,Morning Rush,3,0,3
2011-02-13,8,Sunday,Spring,2,Morning Rush,12,1,11
2011-02-13,9,Sunday,Spring,2,Morning Rush,47,12,35
2011-02-13,10,Sunday,Spring,1,Mid-Day,105,19,86
2011-02-13,11,Sunday,Spring,1,Mid-Day,112,26,86
2011-02-13,12,Sunday,Spring,1,Mid-Day,152,58,94
2011-02-13,13,Sunday,Spring,1,Mid-Day,154,62,92
2011-02-13,14,Sunday,Spring,2,Mid-Day,161,51,110
2011-02-13,15,Sunday,Spring,2,Mid-Day,162,40,122
2011-02-13,16,Sunday,Spring,2,Evening Rush,134,28,106
2011-02-13,17,Sunday,Spring,1,Evening Rush,125,30,95
2011-02-13,18,Sunday,Spring,1,Evening Rush,95,17,78
2011-02-13,19,Sunday,Spring,1,Evening Rush,61,11,50
2011-02-13,20,Sunday,Spring,1,Night,47,15,32
2011-02-13,21,Sunday,Spring,1,Night,51,6,45
2011-02-13,22,Sunday,Spring,1,Night,36,5,31
2011-02-13,23,Sunday,Spring,1,Night,30,3,27
2011-02-14,0,Monday,Spring,1,Early Morning,11,3,8
2011-02-14,1,Monday,Spring,1,Early Morning,7,1,6
2011-02-14,2,Monday,Spring,1,Early Morning,2,0,2
2011-02-14,3,Monday,Spring,1,Early Morning,2,1,1
2011-02-14,4,Monday,Spring,1,Early Morning,2,0,2
2011-02-14,5,Monday,Spring,1,Early Morning,3,0,3
2011-02-14,6,Monday,Spring,1,Morning Rush,26,1,25
2011-02-14,7,Monday,Spring,1,Morning Rush,98,2,96
2011-02-14,8,Monday,Spring,1,Morning Rush,256,7,249
2011-02-14,9,Monday,Spring,1,Morning Rush,130,8,122
2011-02-14,10,Monday,Spring,1,Mid-Day,55,9,46
2011-02-14,11,Monday,Spring,1,Mid-Day,53,10,43
2011-02-14,12,Monday,Spring,1,Mid-Day,126,27,99
2011-02-14,13,Monday,Spring,1,Mid-Day,120,27,93
2011-02-14,14,Monday,Spring,1,Mid-Day,90,14,76
2011-02-14,15,Monday,Spring,1,Mid-Day,90,19,71
2011-02-14,16,Monday,Spring,1,Evening Rush,118,16,102
2011-02-14,17,Monday,Spring,1,Evening Rush,243,25,218
2011-02-14,18,Monday,Spring,1,Evening Rush,205,11,194
2011-02-14,19,Monday,Spring,1,Evening Rush,98,12,86
2011-02-14,20,Monday,Spring,1,Night,70,5,65
2011-02-14,21,Monday,Spring,1,Night,43,8,35
2011-02-14,22,Monday,Spring,1,Night,45,1,44
2011-02-14,23,Monday,Spring,1,Night,20,1,19
2011-02-15,0,Tuesday,Spring,1,Early Morning,19,7,12
2011-02-15,1,Tuesday,Spring,1,Early Morning,5,0,5
2011-02-15,2,Tuesday,Spring,1,Early Morning,3,1,2
2011-02-15,4,Tuesday,Spring,1,Early Morning,1,0,1
2011-02-15,5,Tuesday,Spring,1,Early Morning,4,0,4
2011-02-15,6,Tuesday,Spring,1,Morning Rush,30,0,30
2011-02-15,7,Tuesday,Spring,1,Morning Rush,105,2,103
2011-02-15,8,Tuesday,Spring,1,Morning Rush,223,10,213
2011-02-15,9,Tuesday,Spring,1,Morning Rush,110,2,108
2011-02-15,10,Tuesday,Spring,1,Mid-Day,52,5,47
2011-02-15,11,Tuesday,Spring,1,Mid-Day,57,11,46
2011-02-15,12,Tuesday,Spring,1,Mid-Day,71,6,65
2011-02-15,13,Tuesday,Spring,1,Mid-Day,82,14,68
2011-02-15,14,Tuesday,Spring,1,Mid-Day,79,10,69
2011-02-15,15,Tuesday,Spring,1,Mid-Day,85,11,74
2011-02-15,16,Tuesday,Spring,1,Evening Rush,98,21,77
2011-02-15,17,Tuesday,Spring,1,Evening Rush,206,15,191
2011-02-15,18,Tuesday,Spring,1,Evening Rush,212,14,198
2011-02-15,19,Tuesday,Spring,1,Evening Rush,145,3,142
2011-02-15,20,Tuesday,Spring,1,Night,101,3,98
2011-02-15,21,Tuesday,Spring,1,Night,66,5,61
2011-02-15,22,Tuesday,Spring,1,Night,41,0,41
2011-02-15,23,Tuesday,Spring,2,Night,20,0,20
2011-02-16,0,Wednesday,Spring,1,Early Morning,15,0,15
2011-02-16,1,Wednesday,Spring,1,Early Morning,9,0,9
2011-02-16,3,Wednesday,Spring,2,Early Morning,1,0,1
2011-02-16,4,Wednesday,Spring,1,Early Morning,1,0,1
2011-02-16,5,Wednesday,Spring,1,Early Morning,5,0,5
2011-02-16,6,Wednesday,Spring,1,Morning Rush,33,1,32
2011-02-16,7,Wednesday,Spring,2,Morning Rush,108,5,103
2011-02-16,8,Wednesday,Spring,2,Morning Rush,230,6,224
2011-02-16,9,Wednesday,Spring,1,Morning Rush,124,2,122
2011-02-16,10,Wednesday,Spring,1,Mid-Day,69,14,55
2011-02-16,11,Wednesday,Spring,1,Mid-Day,66,7,59
2011-02-16,12,Wednesday,Spring,1,Mid-Day,86,14,72
2011-02-16,13,Wednesday,Spring,1,Mid-Day,93,13,80
2011-02-16,14,Wednesday,Spring,1,Mid-Day,82,17,65
2011-02-16,15,Wednesday,Spring,1,Mid-Day,117,35,82
2011-02-16,16,Wednesday,Spring,1,Evening Rush,122,26,96
2011-02-16,17,Wednesday,Spring,1,Evening Rush,255,11,244
2011-02-16,18,Wednesday,Spring,1,Evening Rush,222,20,202
2011-02-16,19,Wednesday,Spring,1,Evening Rush,161,18,143
2011-02-16,20,Wednesday,Spring,1,Night,118,10,108
2011-02-16,21,Wednesday,Spring,1,Night,92,5,87
2011-02-16,22,Wednesday,Spring,1,Night,73,12,61
2011-02-16,23,Wednesday,Spring,1,Night,33,2,31
2011-02-17,0,Thursday,Spring,1,Early Morning,17,1,16
2011-02-17,1,Thursday,Spring,1,Early Morning,6,0,6
2011-02-17,2,Thursday,Spring,2,Early Morning,6,2,4
2011-02-17,3,Thursday,Spring,1,Early Morning,4,3,1
2011-02-17,4,Thursday,Spring,1,Early Morning,4,3,1
2011-02-17,5,Thursday,Spring,1,Early Morning,12,1,11
2011-02-17,6,Thursday,Spring,1,Morning Rush,47,3,44
2011-02-17,7,Thursday,Spring,1,Morning Rush,126,7,119
2011-02-17,8,Thursday,Spring,1,Morning Rush,285,18,267
2011-02-17,9,Thursday,Spring,1,Morning Rush,179,16,163
2011-02-17,10,Thursday,Spring,1,Mid-Day,88,18,70
2011-02-17,11,Thursday,Spring,2,Mid-Day,90,19,71
2011-02-17,12,Thursday,Spring,1,Mid-Day,101,15,86
2011-02-17,13,Thursday,Spring,1,Mid-Day,123,15,108
2011-02-17,14,Thursday,Spring,1,Mid-Day,81,26,55
2011-02-17,15,Thursday,Spring,1,Mid-Day,106,15,91
2011-02-17,16,Thursday,Spring,2,Evening Rush,146,29,117
2011-02-17,17,Thursday,Spring,2,Evening Rush,274,18,256
2011-02-17,18,Thursday,Spring,2,Evening Rush,222,11,211
2011-02-17,19,Thursday,Spring,1,Evening Rush,175,14,161
2011-02-17,20,Thursday,Spring,1,Night,139,8,131
2011-02-17,21,Thursday,Spring,1,Night,124,5,119
2011-02-17,22,Thursday,Spring,1,Night,76,8,68
2011-02-17,23,Thursday,Spring,1,Night,44,4,40
2011-02-18,0,Friday,Spring,1,Early Morning,32,12,20
2011-02-18,1,Friday,Spring,1,Early Morning,8,1,7
2011-02-18,2,Friday,Spring,1,Early Morning,7,2,5
2011-02-18,3,Friday,Spring,1,Early Morning,8,2,6
2011-02-18,4,Friday,Spring,1,Early Morning,1,0,1
2011-02-18,5,Friday,Spring,2,Early Morning,7,1,6
2011-02-18,6,Friday,Spring,2,Morning Rush,50,2,48
2011-02-18,7,Friday,Spring,2,Morning Rush,116,8,108
2011-02-18,8,Friday,Spring,2,Morning Rush,272,26,246
2011-02-18,9,Friday,Spring,2,Morning Rush,169,15,154
2011-02-18,10,Friday,Spring,2,Mid-Day,95,17,78
2011-02-18,11,Friday,Spring,1,Mid-Day,113,31,82
2011-02-18,12,Friday,Spring,1,Mid-Day,185,59,126
2011-02-18,13,Friday,Spring,1,Mid-Day,176,45,131
2011-02-18,14,Friday,Spring,1,Mid-Day,191,73,118
2011-02-18,15,Friday,Spring,1,Mid-Day,172,55,117
2011-02-18,16,Friday,Spring,1,Evening Rush,232,68,164
2011-02-18,17,Friday,Spring,1,Evening Rush,327,52,275
2011-02-18,18,Friday,Spring,1,Evening Rush,224,29,195
2011-02-18,19,Friday,Spring,1,Evening Rush,162,16,146
2011-02-18,20,Friday,Spring,1,Night,124,19,105
2011-02-18,21,Friday,Spring,1,Night,72,11,61
2011-02-18,22,Friday,Spring,1,Night,107,19,88
2011-02-18,23,Friday,Spring,1,Night,77,16,61
2011-02-19,0,Saturday,Spring,1,Early Morning,29,6,23
2011-02-19,1,Saturday,Spring,1,Early Morning,31,10,21
2011-02-19,2,Saturday,Spring,1,Early Morning,17,3,14
2011-02-19,3,Saturday,Spring,1,Early Morning,7,0,7
2011-02-19,4,Saturday,Spring,1,Early Morning,3,0,3
2011-02-19,5,Saturday,Spring,1,Early Morning,3,0,3
2011-02-19,6,Saturday,Spring,1,Morning Rush,6,3,3
2011-02-19,7,Saturday,Spring,1,Morning Rush,22,6,16
2011-02-19,8,Saturday,Spring,1,Morning Rush,45,9,36
2011-02-19,9,Saturday,Spring,1,Morning Rush,55,18,37
2011-02-19,10,Saturday,Spring,1,Mid-Day,106,34,72
2011-02-19,11,Saturday,Spring,1,Mid-Day,123,47,76
2011-02-19,12,Saturday,Spring,1,Mid-Day,119,38,81
2011-02-19,13,Saturday,Spring,1,Mid-Day,155,52,103
2011-02-19,14,Saturday,Spring,1,Mid-Day,196,102,94
2011-02-19,15,Saturday,Spring,1,Mid-Day,171,84,87
2011-02-19,16,Saturday,Spring,1,Evening Rush,120,39,81
2011-02-19,17,Saturday,Spring,1,Evening Rush,127,36,91
2011-02-19,18,Saturday,Spring,1,Evening Rush,88,21,67
2011-02-19,19,Saturday,Spring,1,Evening Rush,59,5,54
2011-02-19,20,Saturday,Spring,1,Night,47,9,38
2011-02-19,21,Saturday,Spring,1,Night,33,4,29
2011-02-19,22,Saturday,Spring,1,Night,44,2,42
2011-02-19,23,Saturday,Spring,1,Night,29,4,25
2011-02-20,0,Sunday,Spring,1,Early Morning,17,3,14
2011-02-20,1,Sunday,Spring,1,Early Morning,16,5,11
2011-02-20,2,Sunday,Spring,1,Early Morning,17,0,17
2011-02-20,3,Sunday,Spring,1,Early Morning,18,9,9
2011-02-20,4,Sunday,Spring,1,Early Morning,1,0,1
2011-02-20,6,Sunday,Spring,1,Morning Rush,2,1,1
2011-02-20,7,Sunday,Spring,1,Morning Rush,2,0,2
2011-02-20,8,Sunday,Spring,1,Morning Rush,24,2,22
2011-02-20,9,Sunday,Spring,1,Morning Rush,55,7,48
2011-02-20,10,Sunday,Spring,2,Mid-Day,104,34,70
2011-02-20,11,Sunday,Spring,2,Mid-Day,161,72,89
2011-02-20,12,Sunday,Spring,1,Mid-Day,182,62,120
2011-02-20,13,Sunday,Spring,1,Mid-Day,198,76,122
2011-02-20,14,Sunday,Spring,1,Mid-Day,212,108,104
2011-02-20,15,Sunday,Spring,1,Mid-Day,168,66,102
2011-02-20,16,Sunday,Spring,1,Evening Rush,147,59,88
2011-02-20,17,Sunday,Spring,1,Evening Rush,146,60,86
2011-02-20,18,Sunday,Spring,2,Evening Rush,101,30,71
2011-02-20,19,Sunday,Spring,2,Evening Rush,42,3,39
2011-02-20,20,Sunday,Spring,2,Night,42,12,30
2011-02-20,21,Sunday,Spring,2,Night,56,17,39
2011-02-20,22,Sunday,Spring,2,Night,47,4,43
2011-02-20,23,Sunday,Spring,2,Night,54,9,45
2011-02-21,0,Monday,Spring,2,Early Morning,37,7,30
2011-02-21,1,Monday,Spring,2,Early Morning,13,2,11
2011-02-21,2,Monday,Spring,2,Early Morning,4,1,3
2011-02-21,3,Monday,Spring,2,Early Morning,5,2,3
2011-02-21,4,Monday,Spring,1,Early Morning,1,1,0
2011-02-21,5,Monday,Spring,2,Early Morning,3,1,2
2011-02-21,6,Monday,Spring,2,Morning Rush,8,2,6
2011-02-21,7,Monday,Spring,2,Morning Rush,19,3,16
2011-02-21,8,Monday,Spring,2,Morning Rush,63,7,56
2011-02-21,9,Monday,Spring,2,Morning Rush,57,11,46
2011-02-21,10,Monday,Spring,2,Mid-Day,81,29,52
2011-02-21,11,Monday,Spring,2,Mid-Day,90,20,70
2011-02-21,12,Monday,Spring,2,Mid-Day,93,26,67
2011-02-21,13,Monday,Spring,3,Mid-Day,103,28,75
2011-02-21,14,Monday,Spring,2,Mid-Day,116,15,101
2011-02-21,15,Monday,Spring,2,Mid-Day,87,11,76
2011-02-21,16,Monday,Spring,3,Evening Rush,56,8,48
2011-02-21,17,Monday,Spring,2,Evening Rush,80,18,62
2011-02-21,18,Monday,Spring,2,Evening Rush,66,2,64
2011-02-21,19,Monday,Spring,2,Evening Rush,49,0,49
2011-02-21,20,Monday,Spring,3,Night,29,0,29
2011-02-21,21,Monday,Spring,3,Night,34,1,33
2011-02-21,22,Monday,Spring,3,Night,11,0,11
2011-02-21,23,Monday,Spring,3,Night,2,0,2
2011-02-22,6,Tuesday,Spring,2,Morning Rush,7,0,7
2011-02-22,7,Tuesday,Spring,2,Morning Rush,40,0,40
2011-02-22,8,Tuesday,Spring,2,Morning Rush,114,7,107
2011-02-22,9,Tuesday,Spring,2,Morning Rush,106,5,101
2011-02-22,10,Tuesday,Spring,1,Mid-Day,44,0,44
2011-02-22,11,Tuesday,Spring,1,Mid-Day,50,7,43
2011-02-22,12,Tuesday,Spring,1,Mid-Day,55,7,48
2011-02-22,13,Tuesday,Spring,1,Mid-Day,55,3,52
2011-02-22,14,Tuesday,Spring,1,Mid-Day,58,9,49
2011-02-22,15,Tuesday,Spring,1,Mid-Day,69,2,67
2011-02-22,16,Tuesday,Spring,1,Evening Rush,86,7,79
2011-02-22,17,Tuesday,Spring,1,Evening Rush,196,8,188
2011-02-22,18,Tuesday,Spring,1,Evening Rush,167,6,161
2011-02-22,19,Tuesday,Spring,1,Evening Rush,118,4,114
2011-02-22,20,Tuesday,Spring,1,Night,105,3,102
2011-02-22,21,Tuesday,Spring,1,Night,82,2,80
2011-02-22,22,Tuesday,Spring,1,Night,77,1,76
2011-02-22,23,Tuesday,Spring,1,Night,21,3,18
2011-02-23,0,Wednesday,Spring,1,Early Morning,6,0,6
2011-02-23,1,Wednesday,Spring,1,Early Morning,4,0,4
2011-02-23,2,Wednesday,Spring,1,Early Morning,1,0,1
2011-02-23,3,Wednesday,Spring,1,Early Morning,2,0,2
2011-02-23,5,Wednesday,Spring,1,Early Morning,8,0,8
2011-02-23,6,Wednesday,Spring,1,Morning Rush,36,0,36
2011-02-23,7,Wednesday,Spring,1,Morning Rush,96,2,94
2011-02-23,8,Wednesday,Spring,1,Morning Rush,235,8,227
2011-02-23,9,Wednesday,Spring,1,Morning Rush,139,9,130
2011-02-23,10,Wednesday,Spring,1,Mid-Day,51,4,47
2011-02-23,11,Wednesday,Spring,1,Mid-Day,69,16,53
2011-02-23,12,Wednesday,Spring,1,Mid-Day,67,11,56
2011-02-23,13,Wednesday,Spring,1,Mid-Day,87,9,78
2011-02-23,14,Wednesday,Spring,1,Mid-Day,78,17,61
2011-02-23,15,Wednesday,Spring,1,Mid-Day,72,18,54
2011-02-23,16,Wednesday,Spring,1,Evening Rush,94,15,79
2011-02-23,17,Wednesday,Spring,1,Evening Rush,222,15,207
2011-02-23,18,Wednesday,Spring,1,Evening Rush,209,3,206
2011-02-23,19,Wednesday,Spring,1,Evening Rush,141,6,135
2011-02-23,20,Wednesday,Spring,1,Night,109,2,107
2011-02-23,21,Wednesday,Spring,1,Night,91,2,89
2011-02-23,22,Wednesday,Spring,1,Night,61,1,60
2011-02-23,23,Wednesday,Spring,1,Night,39,1,38
2011-02-24,0,Thursday,Spring,1,Early Morning,11,0,11
2011-02-24,1,Thursday,Spring,1,Early Morning,7,0,7
2011-02-24,2,Thursday,Spring,1,Early Morning,4,0,4
2011-02-24,3,Thursday,Spring,1,Early Morning,2,0,2
2011-02-24,5,Thursday,Spring,1,Early Morning,4,1,3
2011-02-24,6,Thursday,Spring,1,Morning Rush,58,0,58
2011-02-24,7,Thursday,Spring,1,Morning Rush,104,0,104
2011-02-24,8,Thursday,Spring,1,Morning Rush,252,8,244
2011-02-24,9,Thursday,Spring,2,Morning Rush,137,4,133
2011-02-24,10,Thursday,Spring,2,Mid-Day,57,8,49
2011-02-24,11,Thursday,Spring,2,Mid-Day,79,8,71
2011-02-24,12,Thursday,Spring,2,Mid-Day,95,10,85
2011-02-24,13,Thursday,Spring,2,Mid-Day,88,16,72
2011-02-24,14,Thursday,Spring,2,Mid-Day,69,2,67
2011-02-24,15,Thursday,Spring,3,Mid-Day,63,5,58
2011-02-24,16,Thursday,Spring,3,Evening Rush,71,4,67
2011-02-24,17,Thursday,Spring,3,Evening Rush,177,9,168
2011-02-24,18,Thursday,Spring,2,Evening Rush,137,5,132
2011-02-24,19,Thursday,Spring,3,Evening Rush,115,3,112
2011-02-24,20,Thursday,Spring,2,Night,89,2,87
2011-02-24,21,Thursday,Spring,2,Night,83,7,76
2011-02-24,22,Thursday,Spring,3,Night,55,5,50
2011-02-24,23,Thursday,Spring,2,Night,50,3,47
2011-02-25,0,Friday,Spring,3,Early Morning,9,1,8
2011-02-25,1,Friday,Spring,2,Early Morning,10,1,9
2011-02-25,2,Friday,Spring,2,Early Morning,3,0,3
2011-02-25,3,Friday,Spring,2,Early Morning,2,1,1
2011-02-25,5,Friday,Spring,2,Early Morning,6,1,5
2011-02-25,6,Friday,Spring,3,Morning Rush,11,0,11
2011-02-25,7,Friday,Spring,3,Morning Rush,35,1,34
2011-02-25,8,Friday,Spring,3,Morning Rush,73,3,70
2011-02-25,9,Friday,Spring,3,Morning Rush,114,3,111
2011-02-25,10,Friday,Spring,3,Mid-Day,49,7,42
2011-02-25,11,Friday,Spring,1,Mid-Day,59,9,50
2011-02-25,12,Friday,Spring,3,Mid-Day,115,20,95
2011-02-25,13,Friday,Spring,3,Mid-Day,83,6,77
2011-02-25,14,Friday,Spring,3,Mid-Day,85,14,71
2011-02-25,15,Friday,Spring,1,Mid-Day,55,5,50
2011-02-25,16,Friday,Spring,1,Evening Rush,102,11,91
2011-02-25,17,Friday,Spring,1,Evening Rush,189,8,181
2011-02-25,18,Friday,Spring,1,Evening Rush,157,7,150
2011-02-25,19,Friday,Spring,1,Evening Rush,90,4,86
2011-02-25,20,Friday,Spring,1,Night,62,2,60
2011-02-25,21,Friday,Spring,1,Night,63,7,56
2011-02-25,22,Friday,Spring,1,Night,50,7,43
2011-02-25,23,Friday,Spring,1,Night,39,2,37
2011-02-26,0,Saturday,Spring,1,Early Morning,28,3,25
2011-02-26,1,Saturday,Spring,1,Early Morning,27,2,25
2011-02-26,2,Saturday,Spring,1,Early Morning,12,3,9
2011-02-26,3,Saturday,Spring,1,Early Morning,8,1,7
2011-02-26,4,Saturday,Spring,2,Early Morning,2,1,1
2011-02-26,5,Saturday,Spring,2,Early Morning,10,1,9
2011-02-26,6,Saturday,Spring,1,Morning Rush,7,1,6
2011-02-26,7,Saturday,Spring,1,Morning Rush,22,1,21
2011-02-26,8,Saturday,Spring,2,Morning Rush,57,2,55
2011-02-26,9,Saturday,Spring,2,Morning Rush,74,9,65
2011-02-26,10,Saturday,Spring,2,Mid-Day,85,14,71
2011-02-26,11,Saturday,Spring,1,Mid-Day,126,26,100
2011-02-26,12,Saturday,Spring,2,Mid-Day,160,45,115
2011-02-26,13,Saturday,Spring,2,Mid-Day,174,38,136
2011-02-26,14,Saturday,Spring,2,Mid-Day,211,57,154
2011-02-26,15,Saturday,Spring,2,Mid-Day,165,40,125
2011-02-26,16,Saturday,Spring,1,Evening Rush,171,41,130
2011-02-26,17,Saturday,Spring,1,Evening Rush,183,53,130
2011-02-26,18,Saturday,Spring,1,Evening Rush,137,26,111
2011-02-26,19,Saturday,Spring,1,Evening Rush,94,30,64
2011-02-26,20,Saturday,Spring,1,Night,68,8,60
2011-02-26,21,Saturday,Spring,1,Night,68,9,59
2011-02-26,22,Saturday,Spring,1,Night,46,8,38
2011-02-26,23,Saturday,Spring,1,Night,34,5,29
2011-02-27,0,Sunday,Spring,1,Early Morning,34,8,26
2011-02-27,1,Sunday,Spring,1,Early Morning,37,7,30
2011-02-27,2,Sunday,Spring,1,Early Morning,22,2,20
2011-02-27,3,Sunday,Spring,1,Early Morning,11,3,8
2011-02-27,4,Sunday,Spring,1,Early Morning,2,0,2
2011-02-27,6,Sunday,Spring,1,Morning Rush,3,2,1
2011-02-27,7,Sunday,Spring,1,Morning Rush,14,6,8
2011-02-27,8,Sunday,Spring,1,Morning Rush,35,9,26
2011-02-27,9,Sunday,Spring,1,Morning Rush,59,17,42
2011-02-27,10,Sunday,Spring,1,Mid-Day,103,24,79
2011-02-27,11,Sunday,Spring,1,Mid-Day,125,33,92
2011-02-27,12,Sunday,Spring,1,Mid-Day,193,61,132
2011-02-27,13,Sunday,Spring,1,Mid-Day,259,90,169
2011-02-27,14,Sunday,Spring,1,Mid-Day,282,105,177
2011-02-27,15,Sunday,Spring,1,Mid-Day,261,98,163
2011-02-27,16,Sunday,Spring,1,Evening Rush,268,98,170
2011-02-27,17,Sunday,Spring,1,Evening Rush,187,66,121
2011-02-27,18,Sunday,Spring,1,Evening Rush,127,24,103
2011-02-27,19,Sunday,Spring,1,Evening Rush,102,16,86
2011-02-27,20,Sunday,Spring,1,Night,81,9,72
2011-02-27,21,Sunday,Spring,1,Night,69,8,61
2011-02-27,22,Sunday,Spring,2,Night,69,2,67
2011-02-27,23,Sunday,Spring,2,Night,59,6,53
2011-02-28,0,Monday,Spring,2,Early Morning,30,5,25
2011-02-28,1,Monday,Spring,3,Early Morning,8,1,7
2011-02-28,3,Monday,Spring,3,Early Morning,1,0,1
2011-02-28,5,Monday,Spring,2,Early Morning,5,1,4
2011-02-28,6,Monday,Spring,2,Morning Rush,28,1,27
2011-02-28,7,Monday,Spring,2,Morning Rush,92,2,90
2011-02-28,8,Monday,Spring,2,Morning Rush,255,13,242
2011-02-28,9,Monday,Spring,1,Morning Rush,142,15,127
2011-02-28,10,Monday,Spring,2,Mid-Day,92,13,79
2011-02-28,11,Monday,Spring,2,Mid-Day,87,13,74
2011-02-28,12,Monday,Spring,2,Mid-Day,36,0,36
2011-02-28,13,Monday,Spring,3,Mid-Day,32,1,31
2011-02-28,14,Monday,Spring,3,Mid-Day,25,1,24
2011-02-28,15,Monday,Spring,3,Mid-Day,35,0,35
2011-02-28,16,Monday,Spring,3,Evening Rush,42,2,40
2011-02-28,17,Monday,Spring,3,Evening Rush,79,2,77
2011-02-28,18,Monday,Spring,3,Evening Rush,131,4,127
2011-02-28,19,Monday,Spring,3,Evening Rush,80,1,79
2011-02-28,20,Monday,Spring,3,Night,45,0,45
2011-02-28,21,Monday,Spring,2,Night,80,2,78
2011-02-28,22,Monday,Spring,3,Night,76,4,72
2011-02-28,23,Monday,Spring,2,Night,45,0,45
2011-03-01,0,Tuesday,Spring,1,Early Morning,7,0,7
2011-03-01,1,Tuesday,Spring,1,Early Morning,3,0,3
2011-03-01,2,Tuesday,Spring,1,Early Morning,4,0,4
2011-03-01,3,Tuesday,Spring,1,Early Morning,2,0,2
2011-03-01,4,Tuesday,Spring,1,Early Morning,1,0,1
2011-03-01,5,Tuesday,Spring,1,Early Morning,2,1,1
2011-03-01,6,Tuesday,Spring,1,Morning Rush,46,0,46
2011-03-01,7,Tuesday,Spring,1,Morning Rush,107,2,105
2011-03-01,8,Tuesday,Spring,1,Morning Rush,214,10,204
2011-03-01,9,Tuesday,Spring,1,Morning Rush,124,8,116
2011-03-01,10,Tuesday,Spring,1,Mid-Day,68,13,55
2011-03-01,11,Tuesday,Spring,1,Mid-Day,56,8,48
2011-03-01,12,Tuesday,Spring,1,Mid-Day,86,6,80
2011-03-01,13,Tuesday,Spring,1,Mid-Day,78,13,65
2011-03-01,14,Tuesday,Spring,1,Mid-Day,79,18,61
2011-03-01,15,Tuesday,Spring,1,Mid-Day,64,7,57
2011-03-01,16,Tuesday,Spring,1,Evening Rush,102,10,92
2011-03-01,17,Tuesday,Spring,1,Evening Rush,242,12,230
2011-03-01,18,Tuesday,Spring,1,Evening Rush,224,10,214
2011-03-01,19,Tuesday,Spring,1,Evening Rush,119,4,115
2011-03-01,20,Tuesday,Spring,1,Night,88,2,86
2011-03-01,21,Tuesday,Spring,1,Night,63,8,55
2011-03-01,22,Tuesday,Spring,1,Night,47,3,44
2011-03-01,23,Tuesday,Spring,1,Night,25,2,23
2011-03-02,0,Wednesday,Spring,1,Early Morning,8,3,5
2011-03-02,1,Wednesday,Spring,1,Early Morning,4,0,4
2011-03-02,2,Wednesday,Spring,1,Early Morning,2,0,2
2011-03-02,3,Wednesday,Spring,1,Early Morning,4,3,1
2011-03-02,4,Wednesday,Spring,1,Early Morning,1,1,0
2011-03-02,5,Wednesday,Spring,1,Early Morning,5,0,5
2011-03-02,6,Wednesday,Spring,1,Morning Rush,40,1,39
2011-03-02,7,Wednesday,Spring,1,Morning Rush,110,2,108
2011-03-02,8,Wednesday,Spring,1,Morning Rush,256,13,243
2011-03-02,9,Wednesday,Spring,1,Morning Rush,148,7,141
2011-03-02,10,Wednesday,Spring,1,Mid-Day,76,11,65
2011-03-02,11,Wednesday,Spring,1,Mid-Day,73,8,65
2011-03-02,12,Wednesday,Spring,1,Mid-Day,82,20,62
2011-03-02,13,Wednesday,Spring,1,Mid-Day,125,35,90
2011-03-02,14,Wednesday,Spring,1,Mid-Day,96,21,75
2011-03-02,15,Wednesday,Spring,1,Mid-Day,110,19,91
2011-03-02,16,Wednesday,Spring,1,Evening Rush,139,27,112
2011-03-02,17,Wednesday,Spring,1,Evening Rush,268,30,238
2011-03-02,18,Wednesday,Spring,1,Evening Rush,201,8,193
2011-03-02,19,Wednesday,Spring,1,Evening Rush,150,6,144
2011-03-02,20,Wednesday,Spring,1,Night,95,9,86
2011-03-02,21,Wednesday,Spring,1,Night,71,3,68
2011-03-02,22,Wednesday,Spring,1,Night,48,4,44
2011-03-02,23,Wednesday,Spring,1,Night,22,0,22
2011-03-03,0,Thursday,Spring,1,Early Morning,13,3,10
2011-03-03,1,Thursday,Spring,1,Early Morning,1,0,1
2011-03-03,2,Thursday,Spring,1,Early Morning,3,1,2
2011-03-03,3,Thursday,Spring,1,Early Morning,1,0,1
2011-03-03,4,Thursday,Spring,1,Early Morning,1,0,1
2011-03-03,5,Thursday,Spring,1,Early Morning,8,1,7
2011-03-03,6,Thursday,Spring,1,Morning Rush,35,1,34
2011-03-03,7,Thursday,Spring,1,Morning Rush,111,1,110
2011-03-03,8,Thursday,Spring,1,Morning Rush,220,4,216
2011-03-03,9,Thursday,Spring,1,Morning Rush,145,10,135
2011-03-03,10,Thursday,Spring,1,Mid-Day,56,7,49
2011-03-03,11,Thursday,Spring,1,Mid-Day,50,10,40
2011-03-03,12,Thursday,Spring,1,Mid-Day,72,7,65
2011-03-03,13,Thursday,Spring,1,Mid-Day,80,13,67
2011-03-03,14,Thursday,Spring,1,Mid-Day,78,18,60
2011-03-03,15,Thursday,Spring,1,Mid-Day,68,6,62
2011-03-03,16,Thursday,Spring,1,Evening Rush,71,6,65
2011-03-03,17,Thursday,Spring,1,Evening Rush,202,17,185
2011-03-03,18,Thursday,Spring,1,Evening Rush,167,6,161
2011-03-03,19,Thursday,Spring,1,Evening Rush,106,5,101
2011-03-03,20,Thursday,Spring,1,Night,70,1,69
2011-03-03,21,Thursday,Spring,1,Night,51,3,48
2011-03-03,22,Thursday,Spring,1,Night,53,3,50
2011-03-03,23,Thursday,Spring,2,Night,23,0,23
2011-03-04,0,Friday,Spring,2,Early Morning,12,0,12
2011-03-04,1,Friday,Spring,2,Early Morning,4,0,4
2011-03-04,2,Friday,Spring,2,Early Morning,2,0,2
2011-03-04,3,Friday,Spring,2,Early Morning,1,0,1
2011-03-04,4,Friday,Spring,2,Early Morning,1,1,0
2011-03-04,5,Friday,Spring,2,Early Morning,7,0,7
2011-03-04,6,Friday,Spring,2,Morning Rush,29,1,28
2011-03-04,7,Friday,Spring,1,Morning Rush,83,0,83
2011-03-04,8,Friday,Spring,1,Morning Rush,228,6,222
2011-03-04,9,Friday,Spring,1,Morning Rush,150,12,138
2011-03-04,10,Friday,Spring,1,Mid-Day,66,10,56
2011-03-04,11,Friday,Spring,1,Mid-Day,89,16,73
2011-03-04,12,Friday,Spring,1,Mid-Day,97,10,87
2011-03-04,13,Friday,Spring,1,Mid-Day,87,13,74
2011-03-04,14,Friday,Spring,1,Mid-Day,95,30,65
2011-03-04,15,Friday,Spring,1,Mid-Day,106,31,75
2011-03-04,16,Friday,Spring,1,Evening Rush,118,17,101
2011-03-04,17,Friday,Spring,2,Evening Rush,228,22,206
2011-03-04,18,Friday,Spring,2,Evening Rush,187,15,172
2011-03-04,19,Friday,Spring,1,Evening Rush,107,5,102
2011-03-04,20,Friday,Spring,2,Night,87,9,78
2011-03-04,21,Friday,Spring,2,Night,70,6,64
2011-03-04,22,Friday,Spring,1,Night,44,4,40
2011-03-04,23,Friday,Spring,2,Night,46,6,40
2011-03-05,0,Saturday,Spring,2,Early Morning,19,4,15
2011-03-05,1,Saturday,Spring,2,Early Morning,25,5,20
2011-03-05,2,Saturday,Spring,2,Early Morning,20,5,15
2011-03-05,3,Saturday,Spring,2,Early Morning,2,0,2
2011-03-05,4,Saturday,Spring,2,Early Morning,1,0,1
2011-03-05,5,Saturday,Spring,2,Early Morning,3,0,3
2011-03-05,6,Saturday,Spring,2,Morning Rush,4,1,3
2011-03-05,7,Saturday,Spring,2,Morning Rush,15,5,10
2011-03-05,8,Saturday,Spring,2,Morning Rush,45,11,34
2011-03-05,9,Saturday,Spring,2,Morning Rush,63,15,48
2011-03-05,10,Saturday,Spring,2,Mid-Day,103,34,69
2011-03-05,11,Saturday,Spring,2,Mid-Day,159,43,116
2011-03-05,12,Saturday,Spring,2,Mid-Day,167,46,121
2011-03-05,13,Saturday,Spring,2,Mid-Day,190,60,130
2011-03-05,14,Saturday,Spring,2,Mid-Day,198,80,118
2011-03-05,15,Saturday,Spring,2,Mid-Day,205,83,122
2011-03-05,16,Saturday,Spring,2,Evening Rush,204,74,130
2011-03-05,17,Saturday,Spring,2,Evening Rush,164,60,104
2011-03-05,18,Saturday,Spring,2,Evening Rush,152,37,115
2011-03-05,19,Saturday,Spring,2,Evening Rush,89,27,62
2011-03-05,20,Saturday,Spring,2,Night,70,12,58
2011-03-05,21,Saturday,Spring,2,Night,72,12,60
2011-03-05,22,Saturday,Spring,2,Night,63,16,47
2011-03-05,23,Saturday,Spring,2,Night,44,10,34
2011-03-06,0,Sunday,Spring,2,Early Morning,52,11,41
2011-03-06,1,Sunday,Spring,2,Early Morning,39,12,27
2011-03-06,2,Sunday,Spring,2,Early Morning,32,5,27
2011-03-06,3,Sunday,Spring,2,Early Morning,11,2,9
2011-03-06,4,Sunday,Spring,2,Early Morning,3,0,3
2011-03-06,6,Sunday,Spring,2,Morning Rush,2,1,1
2011-03-06,7,Sunday,Spring,3,Morning Rush,5,0,5
2011-03-06,8,Sunday,Spring,2,Morning Rush,9,1,8
2011-03-06,9,Sunday,Spring,2,Morning Rush,22,4,18
2011-03-06,10,Sunday,Spring,2,Mid-Day,31,4,27
2011-03-06,11,Sunday,Spring,2,Mid-Day,62,18,44
2011-03-06,12,Sunday,Spring,2,Mid-Day,79,10,69
2011-03-06,13,Sunday,Spring,2,Mid-Day,105,22,83
2011-03-06,14,Sunday,Spring,3,Mid-Day,39,12,27
2011-03-06,15,Sunday,Spring,3,Mid-Day,7,3,4
2011-03-06,16,Sunday,Spring,3,Evening Rush,11,3,8
2011-03-06,17,Sunday,Spring,3,Evening Rush,25,2,23
2011-03-06,18,Sunday,Spring,3,Evening Rush,23,0,23
2011-03-06,19,Sunday,Spring,3,Evening Rush,11,0,11
2011-03-06,20,Sunday,Spring,3,Night,11,3,8
2011-03-06,21,Sunday,Spring,3,Night,7,1,6
2011-03-06,22,Sunday,Spring,2,Night,10,0,10
2011-03-06,23,Sunday,Spring,2,Night,9,0,9
2011-03-07,0,Monday,Spring,3,Early Morning,4,0,4
2011-03-07,1,Monday,Spring,3,Early Morning,2,0,2
2011-03-07,3,Monday,Spring,1,Early Morning,1,0,1
2011-03-07,4,Monday,Spring,1,Early Morning,1,1,0
2011-03-07,5,Monday,Spring,1,Early Morning,1,0,1
2011-03-07,6,Monday,Spring,1,Morning Rush,34,3,31
2011-03-07,7,Monday,Spring,1,Morning Rush,91,3,88
2011-03-07,8,Monday,Spring,1,Morning Rush,211,11,200
2011-03-07,9,Monday,Spring,1,Morning Rush,134,5,129
2011-03-07,10,Monday,Spring,1,Mid-Day,58,15,43
2011-03-07,11,Monday,Spring,1,Mid-Day,60,19,41
2011-03-07,12,Monday,Spring,1,Mid-Day,96,28,68
2011-03-07,13,Monday,Spring,1,Mid-Day,70,16,54
2011-03-07,14,Monday,Spring,1,Mid-Day,77,21,56
2011-03-07,15,Monday,Spring,1,Mid-Day,96,32,64
2011-03-07,16,Monday,Spring,1,Evening Rush,122,26,96
2011-03-07,17,Monday,Spring,1,Evening Rush,233,27,206
2011-03-07,18,Monday,Spring,1,Evening Rush,233,19,214
2011-03-07,19,Monday,Spring,1,Evening Rush,145,11,134
2011-03-07,20,Monday,Spring,1,Night,92,5,87
2011-03-07,21,Monday,Spring,1,Night,54,1,53
2011-03-07,22,Monday,Spring,1,Night,35,1,34
2011-03-07,23,Monday,Spring,1,Night,22,0,22
2011-03-08,0,Tuesday,Spring,1,Early Morning,10,1,9
2011-03-08,1,Tuesday,Spring,1,Early Morning,4,0,4
2011-03-08,2,Tuesday,Spring,1,Early Morning,1,1,0
2011-03-08,3,Tuesday,Spring,1,Early Morning,7,5,2
2011-03-08,4,Tuesday,Spring,1,Early Morning,2,0,2
2011-03-08,5,Tuesday,Spring,1,Early Morning,10,2,8
2011-03-08,6,Tuesday,Spring,1,Morning Rush,45,3,42
2011-03-08,7,Tuesday,Spring,1,Morning Rush,128,9,119
2011-03-08,8,Tuesday,Spring,1,Morning Rush,257,10,247
2011-03-08,9,Tuesday,Spring,1,Morning Rush,151,11,140
2011-03-08,10,Tuesday,Spring,2,Mid-Day,71,25,46
2011-03-08,11,Tuesday,Spring,2,Mid-Day,78,26,52
2011-03-08,12,Tuesday,Spring,2,Mid-Day,99,29,70
2011-03-08,13,Tuesday,Spring,2,Mid-Day,98,25,73
2011-03-08,14,Tuesday,Spring,2,Mid-Day,72,16,56
2011-03-08,15,Tuesday,Spring,2,Mid-Day,112,35,77
2011-03-08,16,Tuesday,Spring,1,Evening Rush,108,26,82
2011-03-08,17,Tuesday,Spring,1,Evening Rush,248,39,209
2011-03-08,18,Tuesday,Spring,1,Evening Rush,235,21,214
2011-03-08,19,Tuesday,Spring,1,Evening Rush,150,9,141
2011-03-08,20,Tuesday,Spring,1,Night,76,2,74
2011-03-08,21,Tuesday,Spring,1,Night,75,7,68
2011-03-08,22,Tuesday,Spring,1,Night,55,11,44
2011-03-08,23,Tuesday,Spring,1,Night,41,3,38
2011-03-09,0,Wednesday,Spring,1,Early Morning,9,0,9
2011-03-09,1,Wednesday,Spring,1,Early Morning,4,0,4
2011-03-09,2,Wednesday,Spring,1,Early Morning,2,1,1
2011-03-09,3,Wednesday,Spring,1,Early Morning,3,1,2
2011-03-09,4,Wednesday,Spring,1,Early Morning,2,0,2
2011-03-09,5,Wednesday,Spring,2,Early Morning,8,1,7
2011-03-09,6,Wednesday,Spring,2,Morning Rush,49,5,44
2011-03-09,7,Wednesday,Spring,2,Morning Rush,141,18,123
2011-03-09,8,Wednesday,Spring,2,Morning Rush,249,11,238
2011-03-09,9,Wednesday,Spring,2,Morning Rush,141,5,136
2011-03-09,10,Wednesday,Spring,2,Mid-Day,57,8,49
2011-03-09,11,Wednesday,Spring,2,Mid-Day,59,15,44
2011-03-09,12,Wednesday,Spring,2,Mid-Day,98,14,84
2011-03-09,13,Wednesday,Spring,2,Mid-Day,99,17,82
2011-03-09,14,Wednesday,Spring,2,Mid-Day,71,10,61
2011-03-09,15,Wednesday,Spring,2,Mid-Day,79,15,64
2011-03-09,16,Wednesday,Spring,2,Evening Rush,112,10,102
2011-03-09,17,Wednesday,Spring,2,Evening Rush,194,18,176
2011-03-09,18,Wednesday,Spring,2,Evening Rush,188,12,176
2011-03-09,19,Wednesday,Spring,2,Evening Rush,134,11,123
2011-03-09,20,Wednesday,Spring,2,Night,91,4,87
2011-03-09,21,Wednesday,Spring,2,Night,62,10,52
2011-03-09,22,Wednesday,Spring,3,Night,21,4,17
2011-03-09,23,Wednesday,Spring,3,Night,18,1,17
2011-03-10,0,Thursday,Spring,3,Early Morning,3,3,0
2011-03-10,1,Thursday,Spring,3,Early Morning,2,0,2
2011-03-10,2,Thursday,Spring,3,Early Morning,1,0,1
2011-03-10,5,Thursday,Spring,3,Early Morning,3,1,2
2011-03-10,6,Thursday,Spring,3,Morning Rush,12,0,12
2011-03-10,7,Thursday,Spring,3,Morning Rush,37,1,36
2011-03-10,8,Thursday,Spring,3,Morning Rush,44,1,43
2011-03-10,9,Thursday,Spring,3,Morning Rush,24,1,23
2011-03-10,10,Thursday,Spring,3,Mid-Day,17,0,17
2011-03-10,11,Thursday,Spring,3,Mid-Day,11,6,5
2011-03-10,12,Thursday,Spring,3,Mid-Day,34,4,30
2011-03-10,13,Thursday,Spring,3,Mid-Day,12,1,11
2011-03-10,14,Thursday,Spring,3,Mid-Day,12,0,12
2011-03-10,15,Thursday,Spring,3,Mid-Day,14,3,11
2011-03-10,16,Thursday,Spring,3,Evening Rush,21,1,20
2011-03-10,17,Thursday,Spring,2,Evening Rush,111,2,109
2011-03-10,18,Thursday,Spring,3,Evening Rush,82,2,80
2011-03-10,19,Thursday,Spring,3,Evening Rush,56,5,51
2011-03-10,20,Thursday,Spring,3,Night,38,9,29
2011-03-10,21,Thursday,Spring,3,Night,28,1,27
2011-03-10,22,Thursday,Spring,2,Night,34,4,30
2011-03-10,23,Thursday,Spring,3,Night,27,1,26
2011-03-11,0,Friday,Spring,2,Early Morning,6,0,6
2011-03-11,1,Friday,Spring,3,Early Morning,8,0,8
2011-03-11,2,Friday,Spring,3,Early Morning,5,2,3
2011-03-11,3,Friday,Spring,2,Early Morning,2,0,2
2011-03-11,5,Friday,Spring,1,Early Morning,7,1,6
2011-03-11,6,Friday,Spring,1,Morning Rush,32,1,31
2011-03-11,7,Friday,Spring,1,Morning Rush,114,10,104
2011-03-11,8,Friday,Spring,1,Morning Rush,259,15,244
2011-03-11,9,Friday,Spring,2,Morning Rush,156,13,143
2011-03-11,10,Friday,Spring,2,Mid-Day,78,18,60
2011-03-11,11,Friday,Spring,2,Mid-Day,81,14,67
2011-03-11,12,Friday,Spring,2,Mid-Day,111,15,96
2011-03-11,13,Friday,Spring,1,Mid-Day,107,15,92
2011-03-11,14,Friday,Spring,2,Mid-Day,89,25,64
2011-03-11,15,Friday,Spring,2,Mid-Day,85,21,64
2011-03-11,16,Friday,Spring,2,Evening Rush,113,18,95
2011-03-11,17,Friday,Spring,1,Evening Rush,223,23,200
2011-03-11,18,Friday,Spring,1,Evening Rush,153,19,134
2011-03-11,19,Friday,Spring,1,Evening Rush,118,7,111
2011-03-11,20,Friday,Spring,1,Night,76,6,70
2011-03-11,21,Friday,Spring,2,Night,53,10,43
2011-03-11,22,Friday,Spring,1,Night,64,11,53
2011-03-11,23,Friday,Spring,1,Night,37,3,34
2011-03-12,0,Saturday,Spring,1,Early Morning,34,4,30
2011-03-12,1,Saturday,Spring,1,Early Morning,18,3,15
2011-03-12,2,Saturday,Spring,1,Early Morning,14,0,14
2011-03-12,3,Saturday,Spring,1,Early Morning,7,1,6
2011-03-12,4,Saturday,Spring,1,Early Morning,1,0,1
2011-03-12,5,Saturday,Spring,1,Early Morning,2,0,2
2011-03-12,6,Saturday,Spring,1,Morning Rush,4,2,2
2011-03-12,7,Saturday,Spring,1,Morning Rush,23,4,19
2011-03-12,8,Saturday,Spring,1,Morning Rush,53,9,44
2011-03-12,9,Saturday,Spring,1,Morning Rush,101,25,76
2011-03-12,10,Saturday,Spring,1,Mid-Day,99,21,78
2011-03-12,11,Saturday,Spring,1,Mid-Day,119,36,83
2011-03-12,12,Saturday,Spring,1,Mid-Day,158,51,107
2011-03-12,13,Saturday,Spring,1,Mid-Day,157,62,95
2011-03-12,14,Saturday,Spring,1,Mid-Day,166,70,96
2011-03-12,15,Saturday,Spring,1,Mid-Day,182,81,101
2011-03-12,16,Saturday,Spring,1,Evening Rush,244,100,144
2011-03-12,17,Saturday,Spring,1,Evening Rush,213,99,114
2011-03-12,18,Saturday,Spring,1,Evening Rush,145,54,91
2011-03-12,19,Saturday,Spring,1,Evening Rush,112,26,86
2011-03-12,20,Saturday,Spring,1,Night,86,22,64
2011-03-12,21,Saturday,Spring,1,Night,82,36,46
2011-03-12,22,Saturday,Spring,1,Night,63,7,56
2011-03-12,23,Saturday,Spring,1,Night,49,11,38
2011-03-13,0,Sunday,Spring,1,Early Morning,38,3,35
2011-03-13,1,Sunday,Spring,1,Early Morning,33,10,23
2011-03-13,3,Sunday,Spring,1,Early Morning,23,6,17
2011-03-13,4,Sunday,Spring,1,Early Morning,13,4,9
2011-03-13,5,Sunday,Spring,1,Early Morning,3,0,3
2011-03-13,6,Sunday,Spring,1,Morning Rush,2,0,2
2011-03-13,7,Sunday,Spring,1,Morning Rush,10,2,8
2011-03-13,8,Sunday,Spring,1,Morning Rush,34,11,23
2011-03-13,9,Sunday,Spring,1,Morning Rush,44,8,36
2011-03-13,10,Sunday,Spring,1,Mid-Day,122,36,86
2011-03-13,11,Sunday,Spring,1,Mid-Day,181,88,93
2011-03-13,12,Sunday,Spring,1,Mid-Day,194,74,120
2011-03-13,13,Sunday,Spring,1,Mid-Day,221,97,124
2011-03-13,14,Sunday,Spring,1,Mid-Day,250,144,106
2011-03-13,15,Sunday,Spring,1,Mid-Day,304,149,155
2011-03-13,16,Sunday,Spring,1,Evening Rush,256,124,132
2011-03-13,17,Sunday,Spring,1,Evening Rush,241,98,143
2011-03-13,18,Sunday,Spring,1,Evening Rush,147,55,92
2011-03-13,19,Sunday,Spring,1,Evening Rush,101,28,73
2011-03-13,20,Sunday,Spring,1,Night,77,23,54
2011-03-13,21,Sunday,Spring,1,Night,58,9,49
2011-03-13,22,Sunday,Spring,1,Night,37,8,29
2011-03-13,23,Sunday,Spring,1,Night,28,5,23
2011-03-14,0,Monday,Spring,1,Early Morning,11,4,7
2011-03-14,1,Monday,Spring,1,Early Morning,1,0,1
2011-03-14,2,Monday,Spring,1,Early Morning,1,0,1
2011-03-14,3,Monday,Spring,1,Early Morning,3,0,3
2011-03-14,5,Monday,Spring,1,Early Morning,8,0,8
2011-03-14,6,Monday,Spring,1,Morning Rush,28,1,27
2011-03-14,7,Monday,Spring,2,Morning Rush,88,4,84
2011-03-14,8,Monday,Spring,2,Morning Rush,241,24,217
2011-03-14,9,Monday,Spring,1,Morning Rush,140,13,127
2011-03-14,10,Monday,Spring,1,Mid-Day,84,27,57
2011-03-14,11,Monday,Spring,1,Mid-Day,71,26,45
2011-03-14,12,Monday,Spring,1,Mid-Day,94,40,54
2011-03-14,13,Monday,Spring,1,Mid-Day,75,24,51
2011-03-14,14,Monday,Spring,2,Mid-Day,79,27,52
2011-03-14,15,Monday,Spring,1,Mid-Day,101,24,77
2011-03-14,16,Monday,Spring,1,Evening Rush,107,27,80
2011-03-14,17,Monday,Spring,1,Evening Rush,271,42,229
2011-03-14,18,Monday,Spring,1,Evening Rush,235,25,210
2011-03-14,19,Monday,Spring,1,Evening Rush,150,17,133
2011-03-14,20,Monday,Spring,1,Night,129,23,106
2011-03-14,21,Monday,Spring,1,Night,63,5,58
2011-03-14,22,Monday,Spring,1,Night,47,4,43
2011-03-14,23,Monday,Spring,1,Night,19,2,17
2011-03-15,0,Tuesday,Spring,1,Early Morning,14,7,7
2011-03-15,1,Tuesday,Spring,1,Early Morning,10,4,6
2011-03-15,2,Tuesday,Spring,1,Early Morning,3,1,2
2011-03-15,4,Tuesday,Spring,1,Early Morning,2,1,1
2011-03-15,5,Tuesday,Spring,1,Early Morning,11,0,11
2011-03-15,6,Tuesday,Spring,1,Morning Rush,35,3,32
2011-03-15,7,Tuesday,Spring,1,Morning Rush,119,10,109
2011-03-15,8,Tuesday,Spring,1,Morning Rush,282,23,259
2011-03-15,9,Tuesday,Spring,2,Morning Rush,157,10,147
2011-03-15,10,Tuesday,Spring,2,Mid-Day,78,22,56
2011-03-15,11,Tuesday,Spring,2,Mid-Day,78,27,51
2011-03-15,12,Tuesday,Spring,2,Mid-Day,102,32,70
2011-03-15,13,Tuesday,Spring,2,Mid-Day,97,23,74
2011-03-15,14,Tuesday,Spring,2,Mid-Day,88,14,74
2011-03-15,15,Tuesday,Spring,2,Mid-Day,90,24,66
2011-03-15,16,Tuesday,Spring,2,Evening Rush,114,21,93
2011-03-15,17,Tuesday,Spring,2,Evening Rush,217,22,195
2011-03-15,18,Tuesday,Spring,2,Evening Rush,225,18,207
2011-03-15,19,Tuesday,Spring,2,Evening Rush,152,14,138
2011-03-15,20,Tuesday,Spring,2,Night,88,9,79
2011-03-15,21,Tuesday,Spring,3,Night,55,2,53
2011-03-15,22,Tuesday,Spring,2,Night,21,1,20
2011-03-15,23,Tuesday,Spring,2,Night,18,1,17
2011-03-16,0,Wednesday,Spring,3,Early Morning,8,0,8
2011-03-16,1,Wednesday,Spring,3,Early Morning,3,1,2
2011-03-16,3,Wednesday,Spring,2,Early Morning,3,1,2
2011-03-16,4,Wednesday,Spring,2,Early Morning,1,0,1
2011-03-16,5,Wednesday,Spring,2,Early Morning,3,0,3
2011-03-16,6,Wednesday,Spring,2,Morning Rush,31,1,30
2011-03-16,7,Wednesday,Spring,2,Morning Rush,111,10,101
2011-03-16,8,Wednesday,Spring,2,Morning Rush,253,26,227
2011-03-16,9,Wednesday,Spring,2,Morning Rush,154,10,144
2011-03-16,10,Wednesday,Spring,2,Mid-Day,68,19,49
2011-03-16,11,Wednesday,Spring,2,Mid-Day,75,13,62
2011-03-16,12,Wednesday,Spring,2,Mid-Day,88,23,65
2011-03-16,13,Wednesday,Spring,2,Mid-Day,99,18,81
2011-03-16,14,Wednesday,Spring,2,Mid-Day,100,33,67
2011-03-16,15,Wednesday,Spring,2,Mid-Day,101,22,79
2011-03-16,16,Wednesday,Spring,2,Evening Rush,151,30,121
2011-03-16,17,Wednesday,Spring,2,Evening Rush,253,37,216
2011-03-16,18,Wednesday,Spring,2,Evening Rush,237,26,211
2011-03-16,19,Wednesday,Spring,2,Evening Rush,168,18,150
2011-03-16,20,Wednesday,Spring,2,Night,121,10,111
2011-03-16,21,Wednesday,Spring,2,Night,78,3,75
2011-03-16,22,Wednesday,Spring,2,Night,59,11,48
2011-03-16,23,Wednesday,Spring,1,Night,27,9,18
2011-03-17,0,Thursday,Spring,1,Early Morning,23,4,19
2011-03-17,1,Thursday,Spring,1,Early Morning,12,1,11
2011-03-17,2,Thursday,Spring,1,Early Morning,8,3,5
2011-03-17,3,Thursday,Spring,1,Early Morning,2,1,1
2011-03-17,4,Thursday,Spring,1,Early Morning,3,0,3
2011-03-17,5,Thursday,Spring,1,Early Morning,13,0,13
2011-03-17,6,Thursday,Spring,1,Morning Rush,51,4,47
2011-03-17,7,Thursday,Spring,1,Morning Rush,140,12,128
2011-03-17,8,Thursday,Spring,1,Morning Rush,299,17,282
2011-03-17,9,Thursday,Spring,1,Morning Rush,185,23,162
2011-03-17,10,Thursday,Spring,1,Mid-Day,78,9,69
2011-03-17,11,Thursday,Spring,1,Mid-Day,86,20,66
2011-03-17,12,Thursday,Spring,1,Mid-Day,105,24,81
2011-03-17,13,Thursday,Spring,2,Mid-Day,111,26,85
2011-03-17,14,Thursday,Spring,1,Mid-Day,119,32,87
2011-03-17,15,Thursday,Spring,1,Mid-Day,125,30,95
2011-03-17,16,Thursday,Spring,1,Evening Rush,142,34,108
2011-03-17,17,Thursday,Spring,1,Evening Rush,313,48,265
2011-03-17,18,Thursday,Spring,2,Evening Rush,310,50,260
2011-03-17,19,Thursday,Spring,1,Evening Rush,207,18,189
2011-03-17,20,Thursday,Spring,1,Night,137,25,112
2011-03-17,21,Thursday,Spring,1,Night,138,19,119
2011-03-17,22,Thursday,Spring,1,Night,87,17,70
2011-03-17,23,Thursday,Spring,1,Night,50,7,43
2011-03-18,0,Friday,Spring,1,Early Morning,29,5,24
2011-03-18,1,Friday,Spring,1,Early Morning,16,4,12
2011-03-18,2,Friday,Spring,1,Early Morning,14,5,9
2011-03-18,3,Friday,Spring,1,Early Morning,5,1,4
2011-03-18,5,Friday,Spring,1,Early Morning,10,2,8
2011-03-18,6,Friday,Spring,1,Morning Rush,36,1,35
2011-03-18,7,Friday,Spring,1,Morning Rush,123,11,112
2011-03-18,8,Friday,Spring,1,Morning Rush,280,24,256
2011-03-18,9,Friday,Spring,1,Morning Rush,210,18,192
2011-03-18,10,Friday,Spring,1,Mid-Day,117,43,74
2011-03-18,11,Friday,Spring,1,Mid-Day,159,55,104
2011-03-18,12,Friday,Spring,2,Mid-Day,195,72,123
2011-03-18,13,Friday,Spring,1,Mid-Day,175,57,118
2011-03-18,14,Friday,Spring,1,Mid-Day,174,71,103
2011-03-18,15,Friday,Spring,2,Mid-Day,173,62,111
2011-03-18,16,Friday,Spring,1,Evening Rush,204,67,137
2011-03-18,17,Friday,Spring,1,Evening Rush,332,95,237
2011-03-18,18,Friday,Spring,1,Evening Rush,331,84,247
2011-03-18,19,Friday,Spring,1,Evening Rush,190,58,132
2011-03-18,20,Friday,Spring,1,Night,149,46,103
2011-03-18,21,Friday,Spring,1,Night,113,22,91
2011-03-18,22,Friday,Spring,1,Night,118,55,63
2011-03-18,23,Friday,Spring,2,Night,86,26,60
2011-03-19,0,Saturday,Spring,2,Early Morning,76,26,50
2011-03-19,1,Saturday,Spring,2,Early Morning,51,16,35
2011-03-19,2,Saturday,Spring,2,Early Morning,25,5,20
2011-03-19,3,Saturday,Spring,2,Early Morning,8,1,7
2011-03-19,4,Saturday,Spring,1,Early Morning,3,1,2
2011-03-19,5,Saturday,Spring,1,Early Morning,2,0,2
2011-03-19,6,Saturday,Spring,1,Morning Rush,10,0,10
2011-03-19,7,Saturday,Spring,1,Morning Rush,13,4,9
2011-03-19,8,Saturday,Spring,1,Morning Rush,48,11,37
2011-03-19,9,Saturday,Spring,1,Morning Rush,76,35,41
2011-03-19,10,Saturday,Spring,1,Mid-Day,140,55,85
2011-03-19,11,Saturday,Spring,1,Mid-Day,196,90,106
2011-03-19,12,Saturday,Spring,1,Mid-Day,267,126,141
2011-03-19,13,Saturday,Spring,1,Mid-Day,301,174,127
2011-03-19,14,Saturday,Spring,1,Mid-Day,312,168,144
2011-03-19,15,Saturday,Spring,1,Mid-Day,313,170,143
2011-03-19,16,Saturday,Spring,1,Evening Rush,304,175,129
2011-03-19,17,Saturday,Spring,1,Evening Rush,278,138,140
2011-03-19,18,Saturday,Spring,1,Evening Rush,217,92,125
2011-03-19,19,Saturday,Spring,1,Evening Rush,154,38,116
2011-03-19,20,Saturday,Spring,1,Night,108,39,69
2011-03-19,21,Saturday,Spring,1,Night,93,20,73
2011-03-19,22,Saturday,Spring,1,Night,72,27,45
2011-03-19,23,Saturday,Spring,1,Night,50,13,37
2011-03-20,0,Sunday,Spring,1,Early Morning,40,7,33
2011-03-20,1,Sunday,Spring,1,Early Morning,24,2,22
2011-03-20,2,Sunday,Spring,1,Early Morning,30,6,24
2011-03-20,3,Sunday,Spring,1,Early Morning,12,1,11
2011-03-20,4,Sunday,Spring,1,Early Morning,3,2,1
2011-03-20,5,Sunday,Spring,1,Early Morning,9,3,6
2011-03-20,6,Sunday,Spring,1,Morning Rush,4,1,3
2011-03-20,7,Sunday,Spring,1,Morning Rush,14,5,9
2011-03-20,8,Sunday,Spring,1,Morning Rush,37,7,30
2011-03-20,9,Sunday,Spring,1,Morning Rush,78,35,43
2011-03-20,10,Sunday,Spring,2,Mid-Day,136,55,81
2011-03-20,11,Sunday,Spring,1,Mid-Day,203,92,111
2011-03-20,12,Sunday,Spring,1,Mid-Day,228,120,108
2011-03-20,13,Sunday,Spring,1,Mid-Day,203,88,115
2011-03-20,14,Sunday,Spring,1,Mid-Day,279,145,134
2011-03-20,15,Sunday,Spring,1,Mid-Day,308,172,136
2011-03-20,16,Sunday,Spring,1,Evening Rush,224,92,132
2011-03-20,17,Sunday,Spring,1,Evening Rush,226,83,143
2011-03-20,18,Sunday,Spring,1,Evening Rush,156,58,98
2011-03-20,19,Sunday,Spring,1,Evening Rush,79,21,58
2011-03-20,20,Sunday,Spring,1,Night,67,21,46
2011-03-20,21,Sunday,Spring,2,Night,49,10,39
2011-03-20,22,Sunday,Spring,2,Night,38,8,30
2011-03-20,23,Sunday,Spring,3,Night,24,13,11
2011-03-21,0,Monday,Summer,3,Early Morning,13,2,11
2011-03-21,1,Monday,Summer,2,Early Morning,7,1,6
2011-03-21,2,Monday,Summer,2,Early Morning,6,1,5
2011-03-21,3,Monday,Summer,2,Early Morning,1,0,1
2011-03-21,5,Monday,Summer,1,Early Morning,2,1,1
2011-03-21,6,Monday,Summer,3,Morning Rush,32,2,30
2011-03-21,7,Monday,Summer,3,Morning Rush,18,3,15
2011-03-21,8,Monday,Summer,2,Morning Rush,98,3,95
2011-03-21,9,Monday,Summer,2,Morning Rush,127,12,115
2011-03-21,10,Monday,Summer,2,Mid-Day,62,17,45
2011-03-21,11,Monday,Summer,2,Mid-Day,79,32,47
2011-03-21,12,Monday,Summer,2,Mid-Day,81,25,56
2011-03-21,13,Monday,Summer,2,Mid-Day,112,35,77
2011-03-21,14,Monday,Summer,2,Mid-Day,101,36,65
2011-03-21,15,Monday,Summer,2,Mid-Day,107,41,66
2011-03-21,16,Monday,Summer,2,Evening Rush,141,29,112
2011-03-21,17,Monday,Summer,2,Evening Rush,272,41,231
2011-03-21,18,Monday,Summer,2,Evening Rush,276,44,232
2011-03-21,19,Monday,Summer,1,Evening Rush,221,22,199
2011-03-21,20,Monday,Summer,1,Night,122,16,106
2011-03-21,21,Monday,Summer,1,Night,91,12,79
2011-03-21,22,Monday,Summer,1,Night,78,18,60
2011-03-21,23,Monday,Summer,1,Night,30,8,22
2011-03-22,0,Tuesday,Summer,1,Early Morning,11,4,7
2011-03-22,1,Tuesday,Summer,1,Early Morning,19,6,13
2011-03-22,2,Tuesday,Summer,1,Early Morning,1,0,1
2011-03-22,3,Tuesday,Summer,1,Early Morning,5,3,2
2011-03-22,4,Tuesday,Summer,2,Early Morning,1,0,1
2011-03-22,5,Tuesday,Summer,2,Early Morning,12,1,11
2011-03-22,6,Tuesday,Summer,1,Morning Rush,60,2,58
2011-03-22,7,Tuesday,Summer,2,Morning Rush,136,4,132
2011-03-22,8,Tuesday,Summer,2,Morning Rush,336,24,312
2011-03-22,9,Tuesday,Summer,2,Morning Rush,178,19,159
2011-03-22,10,Tuesday,Summer,2,Mid-Day,124,29,95
2011-03-22,11,Tuesday,Summer,1,Mid-Day,86,22,64
2011-03-22,12,Tuesday,Summer,1,Mid-Day,121,35,86
2011-03-22,13,Tuesday,Summer,1,Mid-Day,106,21,85
2011-03-22,14,Tuesday,Summer,1,Mid-Day,101,30,71
2011-03-22,15,Tuesday,Summer,1,Mid-Day,134,55,79
2011-03-22,16,Tuesday,Summer,1,Evening Rush,165,40,125
2011-03-22,17,Tuesday,Summer,1,Evening Rush,307,42,265
2011-03-22,18,Tuesday,Summer,1,Evening Rush,312,41,271
2011-03-22,19,Tuesday,Summer,2,Evening Rush,164,22,142
2011-03-22,20,Tuesday,Summer,2,Night,135,19,116
2011-03-22,21,Tuesday,Summer,2,Night,87,24,63
2011-03-22,22,Tuesday,Summer,2,Night,70,13,57
2011-03-22,23,Tuesday,Summer,2,Night,32,4,28
2011-03-23,0,Wednesday,Summer,3,Early Morning,11,3,8
2011-03-23,1,Wednesday,Summer,3,Early Morning,7,0,7
2011-03-23,2,Wednesday,Summer,3,Early Morning,2,1,1
2011-03-23,3,Wednesday,Summer,2,Early Morning,3,0,3
2011-03-23,5,Wednesday,Summer,3,Early Morning,10,0,10
2011-03-23,6,Wednesday,Summer,2,Morning Rush,44,1,43
2011-03-23,7,Wednesday,Summer,2,Morning Rush,118,7,111
2011-03-23,8,Wednesday,Summer,2,Morning Rush,261,14,247
2011-03-23,9,Wednesday,Summer,2,Morning Rush,182,8,174
2011-03-23,10,Wednesday,Summer,2,Mid-Day,75,15,60
2011-03-23,11,Wednesday,Summer,2,Mid-Day,71,18,53
2011-03-23,12,Wednesday,Summer,2,Mid-Day,87,14,73
2011-03-23,13,Wednesday,Summer,3,Mid-Day,108,14,94
2011-03-23,14,Wednesday,Summer,2,Mid-Day,84,13,71
2011-03-23,15,Wednesday,Summer,2,Mid-Day,85,11,74
2011-03-23,16,Wednesday,Summer,2,Evening Rush,136,13,123
2011-03-23,17,Wednesday,Summer,2,Evening Rush,273,28,245
2011-03-23,18,Wednesday,Summer,3,Evening Rush,238,20,218
2011-03-23,19,Wednesday,Summer,3,Evening Rush,159,12,147
2011-03-23,20,Wednesday,Summer,3,Night,75,3,72
2011-03-23,21,Wednesday,Summer,3,Night,22,0,22
2011-03-23,22,Wednesday,Summer,2,Night,44,6,38
2011-03-23,23,Wednesday,Summer,3,Night,26,2,24
2011-03-24,0,Thursday,Summer,2,Early Morning,11,0,11
2011-03-24,1,Thursday,Summer,2,Early Morning,3,0,3
2011-03-24,2,Thursday,Summer,2,Early Morning,6,0,6
2011-03-24,3,Thursday,Summer,2,Early Morning,1,1,0
2011-03-24,4,Thursday,Summer,2,Early Morning,1,0,1
2011-03-24,5,Thursday,Summer,2,Early Morning,9,1,8
2011-03-24,6,Thursday,Summer,2,Morning Rush,41,0,41
2011-03-24,7,Thursday,Summer,3,Morning Rush,108,2,106
2011-03-24,8,Thursday,Summer,3,Morning Rush,124,4,120
2011-03-24,9,Thursday,Summer,2,Morning Rush,97,3,94
2011-03-24,10,Thursday,Summer,2,Mid-Day,65,10,55
2011-03-24,11,Thursday,Summer,2,Mid-Day,71,10,61
2011-03-24,12,Thursday,Summer,2,Mid-Day,94,12,82
2011-03-24,13,Thursday,Summer,2,Mid-Day,101,11,90
2011-03-24,14,Thursday,Summer,2,Mid-Day,83,17,66
2011-03-24,15,Thursday,Summer,2,Mid-Day,90,13,77
2011-03-24,16,Thursday,Summer,2,Evening Rush,84,6,78
2011-03-24,17,Thursday,Summer,2,Evening Rush,233,12,221
2011-03-24,18,Thursday,Summer,2,Evening Rush,214,17,197
2011-03-24,19,Thursday,Summer,1,Evening Rush,138,16,122
2011-03-24,20,Thursday,Summer,1,Night,118,8,110
2011-03-24,21,Thursday,Summer,1,Night,78,11,67
2011-03-24,22,Thursday,Summer,1,Night,62,3,59
2011-03-24,23,Thursday,Summer,1,Night,33,9,24
2011-03-25,0,Friday,Summer,1,Early Morning,18,1,17
2011-03-25,1,Friday,Summer,1,Early Morning,5,0,5
2011-03-25,2,Friday,Summer,1,Early Morning,5,0,5
2011-03-25,3,Friday,Summer,1,Early Morning,2,0,2
2011-03-25,4,Friday,Summer,1,Early Morning,5,3,2
2011-03-25,5,Friday,Summer,1,Early Morning,9,0,9
2011-03-25,6,Friday,Summer,1,Morning Rush,32,0,32
2011-03-25,7,Friday,Summer,1,Morning Rush,104,4,100
2011-03-25,8,Friday,Summer,1,Morning Rush,237,9,228
2011-03-25,9,Friday,Summer,1,Morning Rush,166,16,150
2011-03-25,10,Friday,Summer,1,Mid-Day,68,15,53
2011-03-25,11,Friday,Summer,1,Mid-Day,75,17,58
2011-03-25,12,Friday,Summer,1,Mid-Day,145,37,108
2011-03-25,13,Friday,Summer,1,Mid-Day,138,34,104
2011-03-25,14,Friday,Summer,1,Mid-Day,133,30,103
2011-03-25,15,Friday,Summer,2,Mid-Day,122,43,79
2011-03-25,16,Friday,Summer,2,Evening Rush,150,23,127
2011-03-25,17,Friday,Summer,2,Evening Rush,225,23,202
2011-03-25,18,Friday,Summer,1,Evening Rush,198,8,190
2011-03-25,19,Friday,Summer,2,Evening Rush,135,9,126
2011-03-25,20,Friday,Summer,2,Night,81,6,75
2011-03-25,21,Friday,Summer,2,Night,75,11,64
2011-03-25,22,Friday,Summer,2,Night,43,3,40
2011-03-25,23,Friday,Summer,2,Night,39,8,31
2011-03-26,0,Saturday,Summer,2,Early Morning,28,3,25
2011-03-26,1,Saturday,Summer,1,Early Morning,27,3,24
2011-03-26,2,Saturday,Summer,1,Early Morning,25,4,21
2011-03-26,3,Saturday,Summer,1,Early Morning,9,2,7
2011-03-26,4,Saturday,Summer,1,Early Morning,6,2,4
2011-03-26,5,Saturday,Summer,1,Early Morning,8,0,8
2011-03-26,6,Saturday,Summer,1,Morning Rush,10,2,8
2011-03-26,7,Saturday,Summer,1,Morning Rush,41,18,23
2011-03-26,8,Saturday,Summer,1,Morning Rush,66,24,42
2011-03-26,9,Saturday,Summer,1,Morning Rush,100,32,68
2011-03-26,10,Saturday,Summer,1,Mid-Day,125,32,93
2011-03-26,11,Saturday,Summer,1,Mid-Day,168,75,93
2011-03-26,12,Saturday,Summer,1,Mid-Day,227,98,129
2011-03-26,13,Saturday,Summer,1,Mid-Day,239,94,145
2011-03-26,14,Saturday,Summer,1,Mid-Day,216,93,123
2011-03-26,15,Saturday,Summer,1,Mid-Day,219,110,109
2011-03-26,16,Saturday,Summer,1,Evening Rush,248,118,130
2011-03-26,17,Saturday,Summer,1,Evening Rush,203,102,101
2011-03-26,18,Saturday,Summer,2,Evening Rush,153,64,89
2011-03-26,19,Saturday,Summer,2,Evening Rush,138,45,93
2011-03-26,20,Saturday,Summer,2,Night,85,18,67
2011-03-26,21,Saturday,Summer,2,Night,51,15,36
2011-03-26,22,Saturday,Summer,2,Night,63,17,46
2011-03-26,23,Saturday,Summer,2,Night,41,10,31
2011-03-27,0,Sunday,Summer,2,Early Morning,31,5,26
2011-03-27,1,Sunday,Summer,2,Early Morning,20,3,17
2011-03-27,2,Sunday,Summer,3,Early Morning,21,6,15
2011-03-27,3,Sunday,Summer,3,Early Morning,14,0,14
2011-03-27,4,Sunday,Summer,3,Early Morning,6,1,5
2011-03-27,6,Sunday,Summer,3,Morning Rush,2,0,2
2011-03-27,7,Sunday,Summer,3,Morning Rush,7,0,7
2011-03-27,8,Sunday,Summer,1,Morning Rush,14,6,8
2011-03-27,9,Sunday,Summer,1,Morning Rush,54,17,37
2011-03-27,10,Sunday,Summer,2,Mid-Day,86,27,59
2011-03-27,11,Sunday,Summer,2,Mid-Day,108,23,85
2011-03-27,12,Sunday,Summer,2,Mid-Day,163,43,120
2011-03-27,13,Sunday,Summer,1,Mid-Day,147,47,100
2011-03-27,14,Sunday,Summer,1,Mid-Day,164,61,103
2011-03-27,15,Sunday,Summer,1,Mid-Day,172,61,111
2011-03-27,16,Sunday,Summer,1,Evening Rush,143,45,98
2011-03-27,17,Sunday,Summer,1,Evening Rush,159,50,109
2011-03-27,18,Sunday,Summer,1,Evening Rush,137,32,105
2011-03-27,19,Sunday,Summer,1,Evening Rush,103,23,80
2011-03-27,20,Sunday,Summer,1,Night,57,7,50
2011-03-27,21,Sunday,Summer,1,Night,36,7,29
2011-03-27,22,Sunday,Summer,1,Night,30,5,25
2011-03-27,23,Sunday,Summer,1,Night,19,3,16
2011-03-28,0,Monday,Summer,1,Early Morning,12,1,11
2011-03-28,1,Monday,Summer,1,Early Morning,6,2,4
2011-03-28,2,Monday,Summer,1,Early Morning,5,0,5
2011-03-28,3,Monday,Summer,1,Early Morning,2,0,2
2011-03-28,5,Monday,Summer,1,Early Morning,8,0,8
2011-03-28,6,Monday,Summer,1,Morning Rush,40,0,40
2011-03-28,7,Monday,Summer,1,Morning Rush,110,6,104
2011-03-28,8,Monday,Summer,1,Morning Rush,254,15,239
2011-03-28,9,Monday,Summer,2,Morning Rush,121,12,109
2011-03-28,10,Monday,Summer,1,Mid-Day,69,22,47
2011-03-28,11,Monday,Summer,2,Mid-Day,57,18,39
2011-03-28,12,Monday,Summer,2,Mid-Day,79,8,71
2011-03-28,13,Monday,Summer,2,Mid-Day,83,14,69
2011-03-28,14,Monday,Summer,1,Mid-Day,80,15,65
2011-03-28,15,Monday,Summer,1,Mid-Day,72,19,53
2011-03-28,16,Monday,Summer,1,Evening Rush,132,15,117
2011-03-28,17,Monday,Summer,1,Evening Rush,252,25,227
2011-03-28,18,Monday,Summer,1,Evening Rush,241,21,220
2011-03-28,19,Monday,Summer,1,Evening Rush,173,17,156
2011-03-28,20,Monday,Summer,1,Night,112,5,107
2011-03-28,21,Monday,Summer,1,Night,61,6,55
2011-03-28,22,Monday,Summer,1,Night,40,0,40
2011-03-28,23,Monday,Summer,1,Night,19,1,18
2011-03-29,0,Tuesday,Summer,1,Early Morning,16,1,15
2011-03-29,1,Tuesday,Summer,1,Early Morning,4,0,4
2011-03-29,2,Tuesday,Summer,1,Early Morning,3,0,3
2011-03-29,3,Tuesday,Summer,1,Early Morning,3,2,1
2011-03-29,4,Tuesday,Summer,1,Early Morning,2,1,1
2011-03-29,5,Tuesday,Summer,1,Early Morning,8,0,8
2011-03-29,6,Tuesday,Summer,1,Morning Rush,50,4,46
2011-03-29,7,Tuesday,Summer,1,Morning Rush,133,5,128
2011-03-29,8,Tuesday,Summer,1,Morning Rush,287,19,268
2011-03-29,9,Tuesday,Summer,1,Morning Rush,172,16,156
2011-03-29,10,Tuesday,Summer,1,Mid-Day,59,13,46
2011-03-29,11,Tuesday,Summer,2,Mid-Day,81,18,63
2011-03-29,12,Tuesday,Summer,1,Mid-Day,106,29,77
2011-03-29,13,Tuesday,Summer,1,Mid-Day,104,24,80
2011-03-29,14,Tuesday,Summer,1,Mid-Day,86,20,66
2011-03-29,15,Tuesday,Summer,1,Mid-Day,87,22,65
2011-03-29,16,Tuesday,Summer,1,Evening Rush,136,12,124
2011-03-29,17,Tuesday,Summer,1,Evening Rush,299,34,265
2011-03-29,18,Tuesday,Summer,1,Evening Rush,294,42,252
2011-03-29,19,Tuesday,Summer,1,Evening Rush,190,20,170
2011-03-29,20,Tuesday,Summer,1,Night,132,13,119
2011-03-29,21,Tuesday,Summer,1,Night,83,8,75
2011-03-29,22,Tuesday,Summer,1,Night,55,6,49
2011-03-29,23,Tuesday,Summer,2,Night,35,8,27
2011-03-30,0,Wednesday,Summer,2,Early Morning,11,3,8
2011-03-30,1,Wednesday,Summer,1,Early Morning,10,1,9
2011-03-30,2,Wednesday,Summer,2,Early Morning,4,0,4
2011-03-30,3,Wednesday,Summer,2,Early Morning,4,0,4
2011-03-30,4,Wednesday,Summer,2,Early Morning,1,1,0
2011-03-30,5,Wednesday,Summer,2,Early Morning,7,0,7
2011-03-30,6,Wednesday,Summer,2,Morning Rush,48,4,44
2011-03-30,7,Wednesday,Summer,2,Morning Rush,136,8,128
2011-03-30,8,Wednesday,Summer,2,Morning Rush,263,16,247
2011-03-30,9,Wednesday,Summer,2,Morning Rush,154,7,147
2011-03-30,10,Wednesday,Summer,2,Mid-Day,64,13,51
2011-03-30,11,Wednesday,Summer,2,Mid-Day,90,26,64
2011-03-30,12,Wednesday,Summer,2,Mid-Day,80,15,65
2011-03-30,13,Wednesday,Summer,2,Mid-Day,98,14,84
2011-03-30,14,Wednesday,Summer,2,Mid-Day,80,16,64
2011-03-30,15,Wednesday,Summer,3,Mid-Day,70,14,56
2011-03-30,16,Wednesday,Summer,3,Evening Rush,36,0,36
2011-03-30,17,Wednesday,Summer,3,Evening Rush,116,11,105
2011-03-30,18,Wednesday,Summer,2,Evening Rush,85,6,79
2011-03-30,19,Wednesday,Summer,2,Evening Rush,72,5,67
2011-03-30,20,Wednesday,Summer,3,Night,44,4,40
2011-03-30,21,Wednesday,Summer,2,Night,27,0,27
2011-03-30,22,Wednesday,Summer,3,Night,24,3,21
2011-03-30,23,Wednesday,Summer,3,Night,12,1,11
2011-03-31,0,Thursday,Summer,3,Early Morning,3,0,3
2011-03-31,1,Thursday,Summer,3,Early Morning,5,1,4
2011-03-31,2,Thursday,Summer,3,Early Morning,5,0,5
2011-03-31,3,Thursday,Summer,3,Early Morning,1,0,1
2011-03-31,4,Thursday,Summer,3,Early Morning,2,0,2
2011-03-31,5,Thursday,Summer,3,Early Morning,8,0,8
2011-03-31,6,Thursday,Summer,3,Morning Rush,36,2,34
2011-03-31,7,Thursday,Summer,3,Morning Rush,92,5,87
2011-03-31,8,Thursday,Summer,2,Morning Rush,192,7,185
2011-03-31,9,Thursday,Summer,3,Morning Rush,132,6,126
2011-03-31,10,Thursday,Summer,3,Mid-Day,69,15,54
2011-03-31,11,Thursday,Summer,3,Mid-Day,58,6,52
2011-03-31,12,Thursday,Summer,3,Mid-Day,90,17,73
2011-03-31,13,Thursday,Summer,3,Mid-Day,68,13,55
2011-03-31,14,Thursday,Summer,3,Mid-Day,76,27,49
2011-03-31,15,Thursday,Summer,3,Mid-Day,65,4,61
2011-03-31,16,Thursday,Summer,2,Evening Rush,85,13,72
2011-03-31,17,Thursday,Summer,2,Evening Rush,168,15,153
2011-03-31,18,Thursday,Summer,2,Evening Rush,177,12,165
2011-03-31,19,Thursday,Summer,2,Evening Rush,130,12,118
2011-03-31,20,Thursday,Summer,3,Night,85,6,79
2011-03-31,21,Thursday,Summer,2,Night,60,7,53
2011-03-31,22,Thursday,Summer,3,Night,51,7,44
2011-03-31,23,Thursday,Summer,3,Night,27,4,23
2011-04-01,0,Friday,Summer,3,Early Morning,6,0,6
2011-04-01,1,Friday,Summer,3,Early Morning,4,0,4
2011-04-01,2,Friday,Summer,3,Early Morning,7,0,7
2011-04-01,3,Friday,Summer,2,Early Morning,4,0,4
2011-04-01,4,Friday,Summer,2,Early Morning,3,0,3
2011-04-01,5,Friday,Summer,3,Early Morning,12,1,11
2011-04-01,6,Friday,Summer,3,Morning Rush,28,2,26
2011-04-01,7,Friday,Summer,3,Morning Rush,95,4,91
2011-04-01,8,Friday,Summer,2,Morning Rush,206,8,198
2011-04-01,9,Friday,Summer,1,Morning Rush,173,11,162
2011-04-01,10,Friday,Summer,1,Mid-Day,75,12,63
2011-04-01,11,Friday,Summer,1,Mid-Day,89,17,72
2011-04-01,12,Friday,Summer,1,Mid-Day,95,15,80
2011-04-01,13,Friday,Summer,1,Mid-Day,110,18,92
2011-04-01,14,Friday,Summer,2,Mid-Day,87,26,61
2011-04-01,15,Friday,Summer,1,Mid-Day,111,30,81
2011-04-01,16,Friday,Summer,1,Evening Rush,167,42,125
2011-04-01,17,Friday,Summer,1,Evening Rush,281,36,245
2011-04-01,18,Friday,Summer,1,Evening Rush,241,36,205
2011-04-01,19,Friday,Summer,1,Evening Rush,136,16,120
2011-04-01,20,Friday,Summer,1,Night,77,2,75
2011-04-01,21,Friday,Summer,1,Night,93,9,84
2011-04-01,22,Friday,Summer,1,Night,74,10,64
2011-04-01,23,Friday,Summer,1,Night,53,12,41
2011-04-02,0,Saturday,Summer,2,Early Morning,32,3,29
2011-04-02,1,Saturday,Summer,1,Early Morning,32,4,28
2011-04-02,2,Saturday,Summer,1,Early Morning,21,1,20
2011-04-02,3,Saturday,Summer,1,Early Morning,9,1,8
2011-04-02,4,Saturday,Summer,1,Early Morning,5,0,5
2011-04-02,5,Saturday,Summer,2,Early Morning,5,1,4
2011-04-02,6,Saturday,Summer,1,Morning Rush,12,5,7
2011-04-02,7,Saturday,Summer,2,Morning Rush,18,2,16
2011-04-02,8,Saturday,Summer,1,Morning Rush,55,10,45
2011-04-02,9,Saturday,Summer,2,Morning Rush,87,22,65
2011-04-02,10,Saturday,Summer,2,Mid-Day,154,41,113
2011-04-02,11,Saturday,Summer,2,Mid-Day,198,72,126
2011-04-02,12,Saturday,Summer,3,Mid-Day,184,84,100
2011-04-02,13,Saturday,Summer,1,Mid-Day,137,56,81
2011-04-02,14,Saturday,Summer,3,Mid-Day,190,97,93
2011-04-02,15,Saturday,Summer,3,Mid-Day,136,72,64
2011-04-02,16,Saturday,Summer,1,Evening Rush,196,111,85
2011-04-02,17,Saturday,Summer,1,Evening Rush,184,89,95
2011-04-02,18,Saturday,Summer,1,Evening Rush,179,69,110
2011-04-02,19,Saturday,Summer,1,Evening Rush,148,71,77
2011-04-02,20,Saturday,Summer,1,Night,85,29,56
2011-04-02,21,Saturday,Summer,1,Night,77,24,53
2011-04-02,22,Saturday,Summer,1,Night,55,14,41
2011-04-02,23,Saturday,Summer,1,Night,53,20,33
2011-04-03,0,Sunday,Summer,1,Early Morning,39,8,31
2011-04-03,1,Sunday,Summer,1,Early Morning,34,8,26
2011-04-03,2,Sunday,Summer,1,Early Morning,24,5,19
2011-04-03,3,Sunday,Summer,1,Early Morning,11,3,8
2011-04-03,4,Sunday,Summer,1,Early Morning,3,3,0
2011-04-03,5,Sunday,Summer,1,Early Morning,5,1,4
2011-04-03,6,Sunday,Summer,1,Morning Rush,33,10,23
2011-04-03,7,Sunday,Summer,1,Morning Rush,33,13,20
2011-04-03,8,Sunday,Summer,1,Morning Rush,62,18,44
2011-04-03,9,Sunday,Summer,1,Morning Rush,142,68,74
2011-04-03,10,Sunday,Summer,1,Mid-Day,215,111,104
2011-04-03,11,Sunday,Summer,1,Mid-Day,243,139,104
2011-04-03,12,Sunday,Summer,1,Mid-Day,313,166,147
2011-04-03,13,Sunday,Summer,1,Mid-Day,367,219,148
2011-04-03,14,Sunday,Summer,1,Mid-Day,349,240,109
2011-04-03,15,Sunday,Summer,2,Mid-Day,292,174,118
2011-04-03,16,Sunday,Summer,2,Evening Rush,303,147,156
2011-04-03,17,Sunday,Summer,2,Evening Rush,274,148,126
2011-04-03,18,Sunday,Summer,2,Evening Rush,172,71,101
2011-04-03,19,Sunday,Summer,2,Evening Rush,144,51,93
2011-04-03,20,Sunday,Summer,3,Night,79,24,55
2011-04-03,21,Sunday,Summer,2,Night,45,8,37
2011-04-03,22,Sunday,Summer,1,Night,36,7,29
2011-04-03,23,Sunday,Summer,1,Night,31,9,22
2011-04-04,0,Monday,Summer,1,Early Morning,6,1,5
2011-04-04,1,Monday,Summer,1,Early Morning,11,7,4
2011-04-04,2,Monday,Summer,1,Early Morning,2,1,1
2011-04-04,3,Monday,Summer,1,Early Morning,1,1,0
2011-04-04,4,Monday,Summer,1,Early Morning,2,1,1
2011-04-04,5,Monday,Summer,1,Early Morning,7,0,7
2011-04-04,6,Monday,Summer,1,Morning Rush,46,3,43
2011-04-04,7,Monday,Summer,2,Morning Rush,157,7,150
2011-04-04,8,Monday,Summer,2,Morning Rush,339,31,308
2011-04-04,9,Monday,Summer,2,Morning Rush,158,24,134
2011-04-04,10,Monday,Summer,2,Mid-Day,90,35,55
2011-04-04,11,Monday,Summer,1,Mid-Day,124,58,66
2011-04-04,12,Monday,Summer,1,Mid-Day,157,59,98
2011-04-04,13,Monday,Summer,1,Mid-Day,139,47,92
2011-04-04,14,Monday,Summer,2,Mid-Day,123,47,76
2011-04-04,15,Monday,Summer,1,Mid-Day,143,47,96
2011-04-04,16,Monday,Summer,1,Evening Rush,189,59,130
2011-04-04,17,Monday,Summer,1,Evening Rush,366,83,283
2011-04-04,18,Monday,Summer,2,Evening Rush,386,78,308
2011-04-04,19,Monday,Summer,1,Evening Rush,278,51,227
2011-04-04,20,Monday,Summer,2,Night,173,40,133
2011-04-04,21,Monday,Summer,2,Night,95,19,76
2011-04-04,22,Monday,Summer,2,Night,75,17,58
2011-04-04,23,Monday,Summer,2,Night,48,18,30
2011-04-05,0,Tuesday,Summer,1,Early Morning,22,10,12
2011-04-05,1,Tuesday,Summer,3,Early Morning,15,10,5
2011-04-05,2,Tuesday,Summer,2,Early Morning,5,0,5
2011-04-05,3,Tuesday,Summer,2,Early Morning,4,1,3
2011-04-05,4,Tuesday,Summer,3,Early Morning,2,0,2
2011-04-05,5,Tuesday,Summer,3,Early Morning,5,0,5
2011-04-05,6,Tuesday,Summer,2,Morning Rush,38,2,36
2011-04-05,7,Tuesday,Summer,2,Morning Rush,134,10,124
2011-04-05,8,Tuesday,Summer,3,Morning Rush,157,9,148
2011-04-05,9,Tuesday,Summer,3,Morning Rush,46,2,44
2011-04-05,10,Tuesday,Summer,3,Mid-Day,28,3,25
2011-04-05,11,Tuesday,Summer,3,Mid-Day,19,1,18
2011-04-05,12,Tuesday,Summer,2,Mid-Day,38,6,32
2011-04-05,13,Tuesday,Summer,2,Mid-Day,56,5,51
2011-04-05,14,Tuesday,Summer,2,Mid-Day,76,9,67
2011-04-05,15,Tuesday,Summer,1,Mid-Day,68,6,62
2011-04-05,16,Tuesday,Summer,1,Evening Rush,130,17,113
2011-04-05,17,Tuesday,Summer,1,Evening Rush,273,27,246
2011-04-05,18,Tuesday,Summer,1,Evening Rush,267,19,248
2011-04-05,19,Tuesday,Summer,1,Evening Rush,160,12,148
2011-04-05,20,Tuesday,Summer,1,Night,91,4,87
2011-04-05,21,Tuesday,Summer,1,Night,89,8,81
2011-04-05,22,Tuesday,Summer,1,Night,46,3,43
2011-04-05,23,Tuesday,Summer,1,Night,26,3,23
2011-04-06,0,Wednesday,Summer,1,Early Morning,15,0,15
2011-04-06,1,Wednesday,Summer,1,Early Morning,2,0,2
2011-04-06,2,Wednesday,Summer,1,Early Morning,5,0,5
2011-04-06,3,Wednesday,Summer,1,Early Morning,4,0,4
2011-04-06,4,Wednesday,Summer,1,Early Morning,1,0,1
2011-04-06,5,Wednesday,Summer,1,Early Morning,13,1,12
2011-04-06,6,Wednesday,Summer,1,Morning Rush,56,4,52
2011-04-06,7,Wednesday,Summer,1,Morning Rush,133,3,130
2011-04-06,8,Wednesday,Summer,1,Morning Rush,325,17,308
2011-04-06,9,Wednesday,Summer,1,Morning Rush,165,8,157
2011-04-06,10,Wednesday,Summer,1,Mid-Day,69,21,48
2011-04-06,11,Wednesday,Summer,1,Mid-Day,93,23,70
2011-04-06,12,Wednesday,Summer,1,Mid-Day,134,22,112
2011-04-06,13,Wednesday,Summer,1,Mid-Day,112,29,83
2011-04-06,14,Wednesday,Summer,1,Mid-Day,115,35,80
2011-04-06,15,Wednesday,Summer,1,Mid-Day,117,34,83
2011-04-06,16,Wednesday,Summer,1,Evening Rush,169,27,142
2011-04-06,17,Wednesday,Summer,1,Evening Rush,356,53,303
2011-04-06,18,Wednesday,Summer,1,Evening Rush,325,43,282
2011-04-06,19,Wednesday,Summer,1,Evening Rush,232,36,196
2011-04-06,20,Wednesday,Summer,1,Night,141,15,126
2011-04-06,21,Wednesday,Summer,1,Night,102,18,84
2011-04-06,22,Wednesday,Summer,1,Night,84,13,71
2011-04-06,23,Wednesday,Summer,1,Night,40,11,29
2011-04-07,0,Thursday,Summer,1,Early Morning,20,5,15
2011-04-07,1,Thursday,Summer,1,Early Morning,13,2,11
2011-04-07,2,Thursday,Summer,1,Early Morning,7,0,7
2011-04-07,3,Thursday,Summer,1,Early Morning,3,0,3
2011-04-07,4,Thursday,Summer,1,Early Morning,1,0,1
2011-04-07,5,Thursday,Summer,1,Early Morning,6,0,6
2011-04-07,6,Thursday,Summer,1,Morning Rush,64,5,59
2011-04-07,7,Thursday,Summer,2,Morning Rush,160,8,152
2011-04-07,8,Thursday,Summer,1,Morning Rush,314,23,291
2011-04-07,9,Thursday,Summer,2,Morning Rush,170,15,155
2011-04-07,10,Thursday,Summer,2,Mid-Day,95,29,66
2011-04-07,11,Thursday,Summer,2,Mid-Day,122,36,86
2011-04-07,12,Thursday,Summer,2,Mid-Day,153,39,114
2011-04-07,13,Thursday,Summer,2,Mid-Day,135,36,99
2011-04-07,14,Thursday,Summer,1,Mid-Day,157,46,111
2011-04-07,15,Thursday,Summer,1,Mid-Day,160,27,133
2011-04-07,16,Thursday,Summer,1,Evening Rush,213,52,161
2011-04-07,17,Thursday,Summer,1,Evening Rush,343,63,280
2011-04-07,18,Thursday,Summer,1,Evening Rush,333,68,265
2011-04-07,19,Thursday,Summer,1,Evening Rush,226,34,192
2011-04-07,20,Thursday,Summer,1,Night,203,37,166
2011-04-07,21,Thursday,Summer,2,Night,108,19,89
2011-04-07,22,Thursday,Summer,2,Night,81,18,63
2011-04-07,23,Thursday,Summer,1,Night,54,9,45
2011-04-08,0,Friday,Summer,2,Early Morning,25,4,21
2011-04-08,1,Friday,Summer,2,Early Morning,9,3,6
2011-04-08,2,Friday,Summer,3,Early Morning,13,3,10
2011-04-08,3,Friday,Summer,3,Early Morning,1,0,1
2011-04-08,4,Friday,Summer,2,Early Morning,1,0,1
2011-04-08,5,Friday,Summer,2,Early Morning,9,1,8
2011-04-08,6,Friday,Summer,2,Morning Rush,35,2,33
2011-04-08,7,Friday,Summer,3,Morning Rush,113,4,109
2011-04-08,8,Friday,Summer,3,Morning Rush,221,13,208
2011-04-08,9,Friday,Summer,2,Morning Rush,185,17,168
2011-04-08,10,Friday,Summer,2,Mid-Day,73,10,63
2011-04-08,11,Friday,Summer,2,Mid-Day,98,19,79
2011-04-08,12,Friday,Summer,3,Mid-Day,80,29,51
2011-04-08,13,Friday,Summer,3,Mid-Day,42,7,35
2011-04-08,14,Friday,Summer,3,Mid-Day,15,2,13
2011-04-08,15,Friday,Summer,3,Mid-Day,25,1,24
2011-04-08,16,Friday,Summer,2,Evening Rush,60,2,58
2011-04-08,17,Friday,Summer,3,Evening Rush,148,10,138
2011-04-08,18,Friday,Summer,3,Evening Rush,62,8,54
2011-04-08,19,Friday,Summer,3,Evening Rush,53,1,52
2011-04-08,20,Friday,Summer,2,Night,63,12,51
2011-04-08,21,Friday,Summer,2,Night,54,11,43
2011-04-08,22,Friday,Summer,2,Night,51,9,42
2011-04-08,23,Friday,Summer,2,Night,35,4,31
2011-04-09,0,Saturday,Summer,2,Early Morning,31,5,26
2011-04-09,1,Saturday,Summer,2,Early Morning,20,3,17
2011-04-09,2,Saturday,Summer,2,Early Morning,17,2,15
2011-04-09,3,Saturday,Summer,3,Early Morning,14,3,11
2011-04-09,4,Saturday,Summer,3,Early Morning,3,0,3
2011-04-09,5,Saturday,Summer,2,Early Morning,5,0,5
2011-04-09,6,Saturday,Summer,2,Morning Rush,13,0,13
2011-04-09,7,Saturday,Summer,2,Morning Rush,21,8,13
2011-04-09,8,Saturday,Summer,2,Morning Rush,54,7,47
2011-04-09,9,Saturday,Summer,2,Morning Rush,98,27,71
2011-04-09,10,Saturday,Summer,2,Mid-Day,133,43,90
2011-04-09,11,Saturday,Summer,2,Mid-Day,142,51,91
2011-04-09,12,Saturday,Summer,2,Mid-Day,202,79,123
2011-04-09,13,Saturday,Summer,2,Mid-Day,222,114,108
2011-04-09,14,Saturday,Summer,2,Mid-Day,212,94,118
2011-04-09,15,Saturday,Summer,2,Mid-Day,201,85,116
2011-04-09,16,Saturday,Summer,2,Evening Rush,191,73,118
2011-04-09,17,Saturday,Summer,2,Evening Rush,257,128,129
2011-04-09,18,Saturday,Summer,2,Evening Rush,177,48,129
2011-04-09,19,Saturday,Summer,2,Evening Rush,130,47,83
2011-04-09,20,Saturday,Summer,2,Night,93,19,74
2011-04-09,21,Saturday,Summer,2,Night,75,10,65
2011-04-09,22,Saturday,Summer,2,Night,87,21,66
2011-04-09,23,Saturday,Summer,2,Night,57,12,45
2011-04-10,0,Sunday,Summer,2,Early Morning,53,5,48
2011-04-10,1,Sunday,Summer,2,Early Morning,37,6,31
2011-04-10,2,Sunday,Summer,2,Early Morning,36,12,24
2011-04-10,3,Sunday,Summer,2,Early Morning,16,5,11
2011-04-10,4,Sunday,Summer,2,Early Morning,5,3,2
2011-04-10,5,Sunday,Summer,2,Early Morning,4,0,4
2011-04-10,6,Sunday,Summer,2,Morning Rush,4,0,4
2011-04-10,7,Sunday,Summer,2,Morning Rush,10,3,7
2011-04-10,8,Sunday,Summer,2,Morning Rush,55,17,38
2011-04-10,9,Sunday,Summer,2,Morning Rush,81,31,50
2011-04-10,10,Sunday,Summer,2,Mid-Day,150,69,81
2011-04-10,11,Sunday,Summer,2,Mid-Day,202,93,109
2011-04-10,12,Sunday,Summer,2,Mid-Day,230,94,136
2011-04-10,13,Sunday,Summer,1,Mid-Day,263,121,142
2011-04-10,14,Sunday,Summer,1,Mid-Day,281,148,133
2011-04-10,15,Sunday,Summer,1,Mid-Day,297,156,141
2011-04-10,16,Sunday,Summer,2,Evening Rush,288,135,153
2011-04-10,17,Sunday,Summer,2,Evening Rush,236,84,152
2011-04-10,18,Sunday,Summer,1,Evening Rush,240,103,137
2011-04-10,19,Sunday,Summer,1,Evening Rush,131,47,84
2011-04-10,20,Sunday,Summer,1,Night,92,21,71
2011-04-10,21,Sunday,Summer,1,Night,95,18,77
2011-04-10,22,Sunday,Summer,1,Night,57,12,45
2011-04-10,23,Sunday,Summer,1,Night,32,5,27
2011-04-11,0,Monday,Summer,1,Early Morning,23,7,16
2011-04-11,1,Monday,Summer,1,Early Morning,4,1,3
2011-04-11,2,Monday,Summer,1,Early Morning,9,7,2
2011-04-11,4,Monday,Summer,1,Early Morning,1,0,1
2011-04-11,5,Monday,Summer,1,Early Morning,13,1,12
2011-04-11,6,Monday,Summer,2,Morning Rush,61,2,59
2011-04-11,7,Monday,Summer,2,Morning Rush,176,12,164
2011-04-11,8,Monday,Summer,2,Morning Rush,314,28,286
2011-04-11,9,Monday,Summer,2,Morning Rush,165,33,132
2011-04-11,10,Monday,Summer,2,Mid-Day,96,41,55
2011-04-11,11,Monday,Summer,2,Mid-Day,104,45,59
2011-04-11,12,Monday,Summer,2,Mid-Day,134,37,97
2011-04-11,13,Monday,Summer,2,Mid-Day,139,62,77
2011-04-11,14,Monday,Summer,2,Mid-Day,145,60,85
2011-04-11,15,Monday,Summer,1,Mid-Day,141,56,85
2011-04-11,16,Monday,Summer,1,Evening Rush,235,73,162
2011-04-11,17,Monday,Summer,1,Evening Rush,452,100,352
2011-04-11,18,Monday,Summer,1,Evening Rush,383,93,290
2011-04-11,19,Monday,Summer,1,Evening Rush,284,73,211
2011-04-11,20,Monday,Summer,1,Night,166,44,122
2011-04-11,21,Monday,Summer,1,Night,158,39,119
2011-04-11,22,Monday,Summer,2,Night,91,25,66
2011-04-11,23,Monday,Summer,3,Night,54,16,38
2011-04-12,0,Tuesday,Summer,2,Early Morning,24,11,13
2011-04-12,1,Tuesday,Summer,2,Early Morning,13,6,7
2011-04-12,2,Tuesday,Summer,2,Early Morning,14,7,7
2011-04-12,3,Tuesday,Summer,2,Early Morning,1,0,1
2011-04-12,4,Tuesday,Summer,2,Early Morning,6,4,2
2011-04-12,5,Tuesday,Summer,2,Early Morning,16,1,15
2011-04-12,6,Tuesday,Summer,2,Morning Rush,58,3,55
2011-04-12,7,Tuesday,Summer,2,Morning Rush,189,12,177
2011-04-12,8,Tuesday,Summer,3,Morning Rush,226,15,211
2011-04-12,9,Tuesday,Summer,3,Morning Rush,54,4,50
2011-04-12,10,Tuesday,Summer,3,Mid-Day,40,6,34
2011-04-12,11,Tuesday,Summer,1,Mid-Day,49,11,38
2011-04-12,12,Tuesday,Summer,2,Mid-Day,92,9,83
2011-04-12,13,Tuesday,Summer,3,Mid-Day,106,22,84
2011-04-12,14,Tuesday,Summer,2,Mid-Day,44,16,28
2011-04-12,15,Tuesday,Summer,2,Mid-Day,78,24,54
2011-04-12,16,Tuesday,Summer,2,Evening Rush,99,19,80
2011-04-12,17,Tuesday,Summer,3,Evening Rush,291,29,262
2011-04-12,18,Tuesday,Summer,3,Evening Rush,224,21,203
2011-04-12,19,Tuesday,Summer,2,Evening Rush,130,3,127
2011-04-12,20,Tuesday,Summer,2,Night,103,9,94
2011-04-12,21,Tuesday,Summer,2,Night,84,10,74
2011-04-12,22,Tuesday,Summer,2,Night,54,7,47
2011-04-12,23,Tuesday,Summer,2,Night,39,8,31
2011-04-13,0,Wednesday,Summer,2,Early Morning,15,3,12
2011-04-13,1,Wednesday,Summer,2,Early Morning,1,0,1
2011-04-13,2,Wednesday,Summer,3,Early Morning,2,0,2
2011-04-13,3,Wednesday,Summer,3,Early Morning,2,0,2
2011-04-13,4,Wednesday,Summer,3,Early Morning,3,1,2
2011-04-13,5,Wednesday,Summer,3,Early Morning,5,1,4
2011-04-13,6,Wednesday,Summer,3,Morning Rush,34,1,33
2011-04-13,7,Wednesday,Summer,3,Morning Rush,70,3,67
2011-04-13,8,Wednesday,Summer,3,Morning Rush,164,6,158
2011-04-13,9,Wednesday,Summer,2,Morning Rush,65,2,63
2011-04-13,10,Wednesday,Summer,2,Mid-Day,46,4,42
2011-04-13,11,Wednesday,Summer,2,Mid-Day,61,4,57
2011-04-13,12,Wednesday,Summer,3,Mid-Day,95,12,83
2011-04-13,13,Wednesday,Summer,2,Mid-Day,61,6,55
2011-04-13,14,Wednesday,Summer,2,Mid-Day,106,24,82
2011-04-13,15,Wednesday,Summer,2,Mid-Day,81,12,69
2011-04-13,16,Wednesday,Summer,1,Evening Rush,142,23,119
2011-04-13,17,Wednesday,Summer,1,Evening Rush,309,25,284
2011-04-13,18,Wednesday,Summer,1,Evening Rush,321,28,293
2011-04-13,19,Wednesday,Summer,1,Evening Rush,175,15,160
2011-04-13,20,Wednesday,Summer,1,Night,126,7,119
2011-04-13,21,Wednesday,Summer,1,Night,117,17,100
2011-04-13,22,Wednesday,Summer,1,Night,99,10,89
2011-04-13,23,Wednesday,Summer,1,Night,62,5,57
2011-04-14,0,Thursday,Summer,1,Early Morning,21,3,18
2011-04-14,1,Thursday,Summer,1,Early Morning,10,1,9
2011-04-14,2,Thursday,Summer,1,Early Morning,3,0,3
2011-04-14,3,Thursday,Summer,1,Early Morning,2,0,2
2011-04-14,4,Thursday,Summer,1,Early Morning,9,1,8
2011-04-14,5,Thursday,Summer,1,Early Morning,14,2,12
2011-04-14,6,Thursday,Summer,1,Morning Rush,70,4,66
2011-04-14,7,Thursday,Summer,1,Morning Rush,193,11,182
2011-04-14,8,Thursday,Summer,1,Morning Rush,337,21,316
2011-04-14,9,Thursday,Summer,1,Morning Rush,170,18,152
2011-04-14,10,Thursday,Summer,1,Mid-Day,89,21,68
2011-04-14,11,Thursday,Summer,1,Mid-Day,115,28,87
2011-04-14,12,Thursday,Summer,1,Mid-Day,145,35,110
2011-04-14,13,Thursday,Summer,1,Mid-Day,159,38,121
2011-04-14,14,Thursday,Summer,1,Mid-Day,137,36,101
2011-04-14,15,Thursday,Summer,1,Mid-Day,142,57,85
2011-04-14,16,Thursday,Summer,1,Evening Rush,202,49,153
2011-04-14,17,Thursday,Summer,1,Evening Rush,388,50,338
2011-04-14,18,Thursday,Summer,1,Evening Rush,337,47,290
2011-04-14,19,Thursday,Summer,1,Evening Rush,259,37,222
2011-04-14,20,Thursday,Summer,1,Night,169,22,147
2011-04-14,21,Thursday,Summer,1,Night,145,19,126
2011-04-14,22,Thursday,Summer,1,Night,104,22,82
2011-04-14,23,Thursday,Summer,1,Night,47,7,40
2011-04-15,0,Friday,Summer,1,Early Morning,27,6,21
2011-04-15,1,Friday,Summer,1,Early Morning,15,6,9
2011-04-15,2,Friday,Summer,1,Early Morning,18,8,10
2011-04-15,3,Friday,Summer,1,Early Morning,3,0,3
2011-04-15,4,Friday,Summer,1,Early Morning,3,0,3
2011-04-15,5,Friday,Summer,1,Early Morning,13,2,11
2011-04-15,6,Friday,Summer,1,Morning Rush,47,5,42
2011-04-15,7,Friday,Summer,1,Morning Rush,149,10,139
2011-04-15,8,Friday,Summer,1,Morning Rush,300,21,279
2011-04-15,9,Friday,Summer,1,Morning Rush,178,16,162
2011-04-15,10,Friday,Summer,1,Mid-Day,122,31,91
2011-04-15,11,Friday,Summer,1,Mid-Day,136,41,95
2011-04-15,12,Friday,Summer,1,Mid-Day,200,45,155
2011-04-15,13,Friday,Summer,1,Mid-Day,180,47,133
2011-04-15,14,Friday,Summer,1,Mid-Day,163,57,106
2011-04-15,15,Friday,Summer,1,Mid-Day,162,50,112
2011-04-15,16,Friday,Summer,1,Evening Rush,243,70,173
2011-04-15,17,Friday,Summer,2,Evening Rush,331,64,267
2011-04-15,18,Friday,Summer,2,Evening Rush,263,47,216
2011-04-15,19,Friday,Summer,1,Evening Rush,209,41,168
2011-04-15,20,Friday,Summer,2,Night,118,26,92
2011-04-15,21,Friday,Summer,2,Night,102,25,77
2011-04-15,22,Friday,Summer,2,Night,80,16,64
2011-04-15,23,Friday,Summer,2,Night,64,8,56
2011-04-16,0,Saturday,Summer,2,Early Morning,43,7,36
2011-04-16,1,Saturday,Summer,2,Early Morning,33,5,28
2011-04-16,2,Saturday,Summer,2,Early Morning,24,5,19
2011-04-16,3,Saturday,Summer,2,Early Morning,14,5,9
2011-04-16,4,Saturday,Summer,2,Early Morning,5,1,4
2011-04-16,5,Saturday,Summer,2,Early Morning,4,1,3
2011-04-16,6,Saturday,Summer,3,Morning Rush,10,1,9
2011-04-16,7,Saturday,Summer,2,Morning Rush,21,3,18
2011-04-16,8,Saturday,Summer,3,Morning Rush,45,7,38
2011-04-16,9,Saturday,Summer,3,Morning Rush,29,2,27
2011-04-16,10,Saturday,Summer,3,Mid-Day,22,1,21
2011-04-16,11,Saturday,Summer,3,Mid-Day,31,4,27
2011-04-16,12,Saturday,Summer,2,Mid-Day,32,6,26
2011-04-16,13,Saturday,Summer,3,Mid-Day,58,9,49
2011-04-16,14,Saturday,Summer,3,Mid-Day,63,14,49
2011-04-16,15,Saturday,Summer,3,Mid-Day,78,16,62
2011-04-16,16,Saturday,Summer,3,Evening Rush,33,6,27
2011-04-16,17,Saturday,Summer,3,Evening Rush,15,1,14
2011-04-16,18,Saturday,Summer,2,Evening Rush,38,6,32
2011-04-16,19,Saturday,Summer,2,Evening Rush,71,9,62
2011-04-16,20,Saturday,Summer,3,Night,53,4,49
2011-04-16,21,Saturday,Summer,2,Night,14,1,13
2011-04-16,22,Saturday,Summer,3,Night,24,2,22
2011-04-16,23,Saturday,Summer,2,Night,35,5,30
2011-04-17,0,Sunday,Summer,2,Early Morning,33,4,29
2011-04-17,1,Sunday,Summer,1,Early Morning,31,6,25
2011-04-17,2,Sunday,Summer,1,Early Morning,29,4,25
2011-04-17,3,Sunday,Summer,1,Early Morning,25,12,13
2011-04-17,4,Sunday,Summer,1,Early Morning,7,2,5
2011-04-17,5,Sunday,Summer,1,Early Morning,3,2,1
2011-04-17,6,Sunday,Summer,1,Morning Rush,8,3,5
2011-04-17,7,Sunday,Summer,1,Morning Rush,16,2,14
2011-04-17,8,Sunday,Summer,1,Morning Rush,43,7,36
2011-04-17,9,Sunday,Summer,1,Morning Rush,102,31,71
2011-04-17,10,Sunday,Summer,1,Mid-Day,211,91,120
2011-04-17,11,Sunday,Summer,1,Mid-Day,304,119,185
2011-04-17,12,Sunday,Summer,1,Mid-Day,354,167,187
2011-04-17,13,Sunday,Summer,1,Mid-Day,343,181,162
2011-04-17,14,Sunday,Summer,1,Mid-Day,361,170,191
2011-04-17,15,Sunday,Summer,1,Mid-Day,388,179,209
2011-04-17,16,Sunday,Summer,1,Evening Rush,343,161,182
2011-04-17,17,Sunday,Summer,1,Evening Rush,306,143,163
2011-04-17,18,Sunday,Summer,1,Evening Rush,277,102,175
2011-04-17,19,Sunday,Summer,1,Evening Rush,210,75,135
2011-04-17,20,Sunday,Summer,1,Night,141,44,97
2011-04-17,21,Sunday,Summer,1,Night,83,13,70
2011-04-17,22,Sunday,Summer,1,Night,70,21,49
2011-04-17,23,Sunday,Summer,1,Night,56,19,37
2011-04-18,0,Monday,Summer,1,Early Morning,39,15,24
2011-04-18,1,Monday,Summer,1,Early Morning,19,11,8
2011-04-18,2,Monday,Summer,1,Early Morning,16,14,2
2011-04-18,3,Monday,Summer,1,Early Morning,7,6,1
2011-04-18,4,Monday,Summer,1,Early Morning,6,2,4
2011-04-18,5,Monday,Summer,1,Early Morning,16,0,16
2011-04-18,6,Monday,Summer,1,Morning Rush,54,3,51
2011-04-18,7,Monday,Summer,1,Morning Rush,168,12,156
2011-04-18,8,Monday,Summer,1,Morning Rush,297,20,277
2011-04-18,9,Monday,Summer,2,Morning Rush,169,37,132
2011-04-18,10,Monday,Summer,2,Mid-Day,109,41,68
2011-04-18,11,Monday,Summer,2,Mid-Day,123,36,87
2011-04-18,12,Monday,Summer,2,Mid-Day,184,60,124
2011-04-18,13,Monday,Summer,2,Mid-Day,169,41,128
2011-04-18,14,Monday,Summer,2,Mid-Day,144,49,95
2011-04-18,15,Monday,Summer,2,Mid-Day,176,64,112
2011-04-18,16,Monday,Summer,1,Evening Rush,205,40,165
2011-04-18,17,Monday,Summer,1,Evening Rush,428,66,362
2011-04-18,18,Monday,Summer,1,Evening Rush,362,41,321
2011-04-18,19,Monday,Summer,1,Evening Rush,286,42,244
2011-04-18,20,Monday,Summer,1,Night,165,29,136
2011-04-18,21,Monday,Summer,1,Night,151,20,131
2011-04-18,22,Monday,Summer,1,Night,90,9,81
2011-04-18,23,Monday,Summer,1,Night,46,11,35
2011-04-19,0,Tuesday,Summer,1,Early Morning,25,2,23
2011-04-19,1,Tuesday,Summer,1,Early Morning,7,5,2
2011-04-19,2,Tuesday,Summer,1,Early Morning,13,8,5
2011-04-19,3,Tuesday,Summer,1,Early Morning,3,0,3
2011-04-19,4,Tuesday,Summer,1,Early Morning,5,1,4
2011-04-19,5,Tuesday,Summer,2,Early Morning,18,1,17
2011-04-19,6,Tuesday,Summer,2,Morning Rush,65,2,63
2011-04-19,7,Tuesday,Summer,2,Morning Rush,188,22,166
2011-04-19,8,Tuesday,Summer,2,Morning Rush,351,20,331
2011-04-19,9,Tuesday,Summer,3,Morning Rush,162,23,139
2011-04-19,10,Tuesday,Summer,2,Mid-Day,75,15,60
2011-04-19,11,Tuesday,Summer,2,Mid-Day,72,19,53
2011-04-19,12,Tuesday,Summer,2,Mid-Day,103,19,84
2011-04-19,13,Tuesday,Summer,2,Mid-Day,129,26,103
2011-04-19,14,Tuesday,Summer,2,Mid-Day,107,19,88
2011-04-19,15,Tuesday,Summer,2,Mid-Day,127,44,83
2011-04-19,16,Tuesday,Summer,1,Evening Rush,192,30,162
2011-04-19,17,Tuesday,Summer,1,Evening Rush,411,39,372
2011-04-19,18,Tuesday,Summer,2,Evening Rush,421,44,377
2011-04-19,19,Tuesday,Summer,2,Evening Rush,276,28,248
2011-04-19,20,Tuesday,Summer,2,Night,168,20,148
2011-04-19,21,Tuesday,Summer,2,Night,122,8,114
2011-04-19,22,Tuesday,Summer,1,Night,112,3,109
2011-04-19,23,Tuesday,Summer,1,Night,52,11,41
2011-04-20,0,Wednesday,Summer,1,Early Morning,33,4,29
2011-04-20,1,Wednesday,Summer,1,Early Morning,7,2,5
2011-04-20,2,Wednesday,Summer,1,Early Morning,2,0,2
2011-04-20,3,Wednesday,Summer,1,Early Morning,2,0,2
2011-04-20,4,Wednesday,Summer,1,Early Morning,9,5,4
2011-04-20,5,Wednesday,Summer,1,Early Morning,15,1,14
2011-04-20,6,Wednesday,Summer,1,Morning Rush,64,2,62
2011-04-20,7,Wednesday,Summer,1,Morning Rush,237,26,211
2011-04-20,8,Wednesday,Summer,1,Morning Rush,396,22,374
2011-04-20,9,Wednesday,Summer,1,Morning Rush,197,27,170
2011-04-20,10,Wednesday,Summer,1,Mid-Day,131,45,86
2011-04-20,11,Wednesday,Summer,1,Mid-Day,118,31,87
2011-04-20,12,Wednesday,Summer,1,Mid-Day,145,28,117
2011-04-20,13,Wednesday,Summer,1,Mid-Day,177,42,135
2011-04-20,14,Wednesday,Summer,1,Mid-Day,148,33,115
2011-04-20,15,Wednesday,Summer,2,Mid-Day,145,32,113
2011-04-20,16,Wednesday,Summer,2,Evening Rush,255,54,201
2011-04-20,17,Wednesday,Summer,2,Evening Rush,432,34,398
2011-04-20,18,Wednesday,Summer,1,Evening Rush,441,56,385
2011-04-20,19,Wednesday,Summer,1,Evening Rush,383,74,309
2011-04-20,20,Wednesday,Summer,1,Night,225,31,194
2011-04-20,21,Wednesday,Summer,1,Night,172,38,134
2011-04-20,22,Wednesday,Summer,1,Night,117,12,105
2011-04-20,23,Wednesday,Summer,1,Night,93,14,79
2011-04-21,0,Thursday,Summer,1,Early Morning,44,11,33
2011-04-21,1,Thursday,Summer,1,Early Morning,26,6,20
2011-04-21,2,Thursday,Summer,1,Early Morning,13,3,10
2011-04-21,3,Thursday,Summer,2,Early Morning,7,4,3
2011-04-21,4,Thursday,Summer,2,Early Morning,6,2,4
2011-04-21,5,Thursday,Summer,2,Early Morning,14,0,14
2011-04-21,6,Thursday,Summer,2,Morning Rush,75,2,73
2011-04-21,7,Thursday,Summer,2,Morning Rush,198,15,183
2011-04-21,8,Thursday,Summer,2,Morning Rush,365,19,346
2011-04-21,9,Thursday,Summer,2,Morning Rush,196,18,178
2011-04-21,10,Thursday,Summer,1,Mid-Day,98,25,73
2011-04-21,11,Thursday,Summer,1,Mid-Day,133,34,99
2011-04-21,12,Thursday,Summer,1,Mid-Day,199,49,150
2011-04-21,13,Thursday,Summer,1,Mid-Day,177,55,122
2011-04-21,14,Thursday,Summer,1,Mid-Day,228,68,160
2011-04-21,15,Thursday,Summer,1,Mid-Day,235,69,166
2011-04-21,16,Thursday,Summer,1,Evening Rush,294,66,228
2011-04-21,17,Thursday,Summer,1,Evening Rush,481,79,402
2011-04-21,18,Thursday,Summer,1,Evening Rush,452,71,381
2011-04-21,19,Thursday,Summer,1,Evening Rush,324,52,272
2011-04-21,20,Thursday,Summer,1,Night,204,28,176
2011-04-21,21,Thursday,Summer,1,Night,184,25,159
2011-04-21,22,Thursday,Summer,1,Night,137,31,106
2011-04-21,23,Thursday,Summer,1,Night,99,13,86
2011-04-22,0,Friday,Summer,1,Early Morning,33,3,30
2011-04-22,1,Friday,Summer,1,Early Morning,24,2,22
2011-04-22,2,Friday,Summer,1,Early Morning,9,2,7
2011-04-22,3,Friday,Summer,1,Early Morning,2,0,2
2011-04-22,4,Friday,Summer,1,Early Morning,3,1,2
2011-04-22,5,Friday,Summer,1,Early Morning,16,0,16
2011-04-22,6,Friday,Summer,1,Morning Rush,49,2,47
2011-04-22,7,Friday,Summer,2,Morning Rush,180,5,175
2011-04-22,8,Friday,Summer,2,Morning Rush,346,15,331
2011-04-22,9,Friday,Summer,3,Morning Rush,195,17,178
2011-04-22,10,Friday,Summer,2,Mid-Day,136,32,104
2011-04-22,11,Friday,Summer,3,Mid-Day,106,23,83
2011-04-22,12,Friday,Summer,3,Mid-Day,80,19,61
2011-04-22,13,Friday,Summer,3,Mid-Day,40,3,37
2011-04-22,14,Friday,Summer,3,Mid-Day,36,3,33
2011-04-22,15,Friday,Summer,3,Mid-Day,75,13,62
2011-04-22,16,Friday,Summer,3,Evening Rush,62,4,58
2011-04-22,17,Friday,Summer,3,Evening Rush,69,6,63
2011-04-22,18,Friday,Summer,3,Evening Rush,51,4,47
2011-04-22,19,Friday,Summer,3,Evening Rush,55,7,48
2011-04-22,20,Friday,Summer,3,Night,47,8,39
2011-04-22,21,Friday,Summer,3,Night,28,5,23
2011-04-22,22,Friday,Summer,3,Night,24,3,21
2011-04-22,23,Friday,Summer,3,Night,17,0,17
2011-04-23,0,Saturday,Summer,2,Early Morning,18,0,18
2011-04-23,1,Saturday,Summer,2,Early Morning,16,5,11
2011-04-23,2,Saturday,Summer,3,Early Morning,17,3,14
2011-04-23,3,Saturday,Summer,3,Early Morning,4,0,4
2011-04-23,4,Saturday,Summer,3,Early Morning,5,2,3
2011-04-23,5,Saturday,Summer,3,Early Morning,7,1,6
2011-04-23,6,Saturday,Summer,2,Morning Rush,11,0,11
2011-04-23,7,Saturday,Summer,3,Morning Rush,19,2,17
2011-04-23,8,Saturday,Summer,2,Morning Rush,47,15,32
2011-04-23,9,Saturday,Summer,2,Morning Rush,68,13,55
2011-04-23,10,Saturday,Summer,2,Mid-Day,129,36,93
2011-04-23,11,Saturday,Summer,2,Mid-Day,232,68,164
2011-04-23,12,Saturday,Summer,1,Mid-Day,291,94,197
2011-04-23,13,Saturday,Summer,1,Mid-Day,312,126,186
2011-04-23,14,Saturday,Summer,1,Mid-Day,391,182,209
2011-04-23,15,Saturday,Summer,1,Mid-Day,397,171,226
2011-04-23,16,Saturday,Summer,1,Evening Rush,426,180,246
2011-04-23,17,Saturday,Summer,1,Evening Rush,383,168,215
2011-04-23,18,Saturday,Summer,1,Evening Rush,376,149,227
2011-04-23,19,Saturday,Summer,1,Evening Rush,283,84,199
2011-04-23,20,Saturday,Summer,2,Night,183,45,138
2011-04-23,21,Saturday,Summer,2,Night,135,32,103
2011-04-23,22,Saturday,Summer,2,Night,169,55,114
2011-04-23,23,Saturday,Summer,2,Night,117,31,86
2011-04-24,0,Sunday,Summer,1,Early Morning,96,30,66
2011-04-24,1,Sunday,Summer,1,Early Morning,54,14,40
2011-04-24,2,Sunday,Summer,1,Early Morning,72,27,45
2011-04-24,3,Sunday,Summer,1,Early Morning,24,4,20
2011-04-24,4,Sunday,Summer,1,Early Morning,5,0,5
2011-04-24,5,Sunday,Summer,1,Early Morning,12,5,7
2011-04-24,6,Sunday,Summer,2,Morning Rush,13,10,3
2011-04-24,7,Sunday,Summer,2,Morning Rush,27,16,11
2011-04-24,8,Sunday,Summer,1,Morning Rush,80,38,42
2011-04-24,9,Sunday,Summer,1,Morning Rush,177,73,104
2011-04-24,10,Sunday,Summer,1,Mid-Day,289,118,171
2011-04-24,11,Sunday,Summer,1,Mid-Day,317,124,193
2011-04-24,12,Sunday,Summer,1,Mid-Day,388,168,220
2011-04-24,13,Sunday,Summer,1,Mid-Day,441,205,236
2011-04-24,14,Sunday,Summer,1,Mid-Day,420,197,223
2011-04-24,15,Sunday,Summer,1,Mid-Day,369,167,202
2011-04-24,16,Sunday,Summer,1,Evening Rush,359,162,197
2011-04-24,17,Sunday,Summer,1,Evening Rush,331,142,189
2011-04-24,18,Sunday,Summer,1,Evening Rush,270,96,174
2011-04-24,19,Sunday,Summer,3,Evening Rush,194,62,132
2011-04-24,20,Sunday,Summer,3,Night,105,34,71
2011-04-24,21,Sunday,Summer,3,Night,61,8,53
2011-04-24,22,Sunday,Summer,3,Night,45,5,40
2011-04-24,23,Sunday,Summer,3,Night,42,5,37
2011-04-25,0,Monday,Summer,3,Early Morning,12,2,10
2011-04-25,1,Monday,Summer,1,Early Morning,10,2,8
2011-04-25,2,Monday,Summer,1,Early Morning,10,1,9
2011-04-25,3,Monday,Summer,2,Early Morning,10,2,8
2011-04-25,4,Monday,Summer,2,Early Morning,5,1,4
2011-04-25,5,Monday,Summer,2,Early Morning,17,3,14
2011-04-25,6,Monday,Summer,2,Morning Rush,66,7,59
2011-04-25,7,Monday,Summer,2,Morning Rush,196,13,183
2011-04-25,8,Monday,Summer,1,Morning Rush,353,27,326
2011-04-25,9,Monday,Summer,1,Morning Rush,174,27,147
2011-04-25,10,Monday,Summer,1,Mid-Day,125,61,64
2011-04-25,11,Monday,Summer,1,Mid-Day,147,53,94
2011-04-25,12,Monday,Summer,1,Mid-Day,188,48,140
2011-04-25,13,Monday,Summer,1,Mid-Day,203,57,146
2011-04-25,14,Monday,Summer,1,Mid-Day,146,47,99
2011-04-25,15,Monday,Summer,1,Mid-Day,175,50,125
2011-04-25,16,Monday,Summer,1,Evening Rush,239,41,198
2011-04-25,17,Monday,Summer,1,Evening Rush,521,80,441
2011-04-25,18,Monday,Summer,1,Evening Rush,499,74,425
2011-04-25,19,Monday,Summer,1,Evening Rush,382,62,320
2011-04-25,20,Monday,Summer,1,Night,237,42,195
2011-04-25,21,Monday,Summer,1,Night,190,41,149
2011-04-25,22,Monday,Summer,1,Night,106,23,83
2011-04-25,23,Monday,Summer,1,Night,62,9,53
2011-04-26,0,Tuesday,Summer,1,Early Morning,27,10,17
2011-04-26,1,Tuesday,Summer,1,Early Morning,21,16,5
2011-04-26,2,Tuesday,Summer,1,Early Morning,26,17,9
2011-04-26,3,Tuesday,Summer,1,Early Morning,21,17,4
2011-04-26,4,Tuesday,Summer,1,Early Morning,6,2,4
2011-04-26,5,Tuesday,Summer,1,Early Morning,16,0,16
2011-04-26,6,Tuesday,Summer,1,Morning Rush,80,0,80
2011-04-26,7,Tuesday,Summer,1,Morning Rush,270,16,254
2011-04-26,8,Tuesday,Summer,1,Morning Rush,449,32,417
2011-04-26,9,Tuesday,Summer,1,Morning Rush,199,35,164
2011-04-26,10,Tuesday,Summer,1,Mid-Day,120,22,98
2011-04-26,11,Tuesday,Summer,1,Mid-Day,172,40,132
2011-04-26,12,Tuesday,Summer,1,Mid-Day,186,40,146
2011-04-26,13,Tuesday,Summer,1,Mid-Day,176,37,139
2011-04-26,14,Tuesday,Summer,1,Mid-Day,155,40,115
2011-04-26,15,Tuesday,Summer,1,Mid-Day,153,34,119
2011-04-26,16,Tuesday,Summer,1,Evening Rush,291,40,251
2011-04-26,17,Tuesday,Summer,1,Evening Rush,521,66,455
2011-04-26,18,Tuesday,Summer,1,Evening Rush,528,65,463
2011-04-26,19,Tuesday,Summer,1,Evening Rush,328,42,286
2011-04-26,20,Tuesday,Summer,1,Night,234,35,199
2011-04-26,21,Tuesday,Summer,1,Night,195,33,162
2011-04-26,22,Tuesday,Summer,2,Night,148,32,116
2011-04-26,23,Tuesday,Summer,2,Night,78,7,71
2011-04-27,0,Wednesday,Summer,1,Early Morning,27,3,24
2011-04-27,1,Wednesday,Summer,1,Early Morning,17,2,15
2011-04-27,2,Wednesday,Summer,1,Early Morning,5,0,5
2011-04-27,3,Wednesday,Summer,2,Early Morning,7,3,4
2011-04-27,4,Wednesday,Summer,1,Early Morning,6,0,6
2011-04-27,5,Wednesday,Summer,2,Early Morning,17,1,16
2011-04-27,6,Wednesday,Summer,1,Morning Rush,84,5,79
2011-04-27,7,Wednesday,Summer,2,Morning Rush,246,17,229
2011-04-27,8,Wednesday,Summer,2,Morning Rush,444,31,413
2011-04-27,9,Wednesday,Summer,2,Morning Rush,181,20,161
2011-04-27,10,Wednesday,Summer,2,Mid-Day,92,26,66
2011-04-27,11,Wednesday,Summer,2,Mid-Day,156,53,103
2011-04-27,12,Wednesday,Summer,1,Mid-Day,173,38,135
2011-04-27,13,Wednesday,Summer,1,Mid-Day,150,31,119
2011-04-27,14,Wednesday,Summer,1,Mid-Day,148,29,119
2011-04-27,15,Wednesday,Summer,1,Mid-Day,138,18,120
2011-04-27,16,Wednesday,Summer,1,Evening Rush,218,29,189
2011-04-27,17,Wednesday,Summer,3,Evening Rush,521,63,458
2011-04-27,18,Wednesday,Summer,3,Evening Rush,412,46,366
2011-04-27,19,Wednesday,Summer,1,Evening Rush,260,40,220
2011-04-27,20,Wednesday,Summer,1,Night,218,30,188
2011-04-27,21,Wednesday,Summer,1,Night,145,19,126
2011-04-27,22,Wednesday,Summer,2,Night,129,18,111
2011-04-27,23,Wednesday,Summer,2,Night,78,25,53
2011-04-28,0,Thursday,Summer,1,Early Morning,54,13,41
2011-04-28,1,Thursday,Summer,2,Early Morning,20,8,12
2011-04-28,2,Thursday,Summer,2,Early Morning,21,14,7
2011-04-28,3,Thursday,Summer,2,Early Morning,3,2,1
2011-04-28,4,Thursday,Summer,2,Early Morning,9,4,5
2011-04-28,5,Thursday,Summer,2,Early Morning,13,0,13
2011-04-28,6,Thursday,Summer,2,Morning Rush,86,7,79
2011-04-28,7,Thursday,Summer,2,Morning Rush,215,14,201
2011-04-28,8,Thursday,Summer,2,Morning Rush,398,31,367
2011-04-28,9,Thursday,Summer,3,Morning Rush,183,18,165
2011-04-28,10,Thursday,Summer,2,Mid-Day,54,9,45
2011-04-28,11,Thursday,Summer,2,Mid-Day,84,10,74
2011-04-28,12,Thursday,Summer,2,Mid-Day,107,23,84
2011-04-28,13,Thursday,Summer,2,Mid-Day,121,18,103
2011-04-28,14,Thursday,Summer,1,Mid-Day,142,21,121
2011-04-28,15,Thursday,Summer,1,Mid-Day,163,46,117
2011-04-28,16,Thursday,Summer,1,Evening Rush,270,42,228
2011-04-28,17,Thursday,Summer,1,Evening Rush,455,49,406
2011-04-28,18,Thursday,Summer,1,Evening Rush,530,44,486
2011-04-28,19,Thursday,Summer,1,Evening Rush,404,57,347
2011-04-28,20,Thursday,Summer,1,Night,269,49,220
2011-04-28,21,Thursday,Summer,1,Night,194,27,167
2011-04-28,22,Thursday,Summer,1,Night,153,34,119
2011-04-28,23,Thursday,Summer,1,Night,110,29,81
2011-04-29,0,Friday,Summer,1,Early Morning,48,11,37
2011-04-29,1,Friday,Summer,1,Early Morning,31,10,21
2011-04-29,2,Friday,Summer,1,Early Morning,10,2,8
2011-04-29,3,Friday,Summer,1,Early Morning,5,1,4
2011-04-29,4,Friday,Summer,1,Early Morning,6,0,6
2011-04-29,5,Friday,Summer,1,Early Morning,25,0,25
2011-04-29,6,Friday,Summer,1,Morning Rush,71,4,67
2011-04-29,7,Friday,Summer,1,Morning Rush,240,18,222
2011-04-29,8,Friday,Summer,1,Morning Rush,421,35,386
2011-04-29,9,Friday,Summer,1,Morning Rush,230,45,185
2011-04-29,10,Friday,Summer,1,Mid-Day,156,57,99
2011-04-29,11,Friday,Summer,1,Mid-Day,157,49,108
2011-04-29,12,Friday,Summer,1,Mid-Day,223,63,160
2011-04-29,13,Friday,Summer,1,Mid-Day,308,74,234
2011-04-29,14,Friday,Summer,1,Mid-Day,248,58,190
2011-04-29,15,Friday,Summer,2,Mid-Day,252,77,175
2011-04-29,16,Friday,Summer,2,Evening Rush,299,59,240
2011-04-29,17,Friday,Summer,2,Evening Rush,508,75,433
2011-04-29,18,Friday,Summer,1,Evening Rush,439,55,384
2011-04-29,19,Friday,Summer,1,Evening Rush,270,40,230
2011-04-29,20,Friday,Summer,1,Night,194,34,160
2011-04-29,21,Friday,Summer,1,Night,195,50,145
2011-04-29,22,Friday,Summer,1,Night,146,36,110
2011-04-29,23,Friday,Summer,2,Night,113,25,88
2011-04-30,0,Saturday,Summer,2,Early Morning,106,33,73
2011-04-30,1,Saturday,Summer,2,Early Morning,74,15,59
2011-04-30,2,Saturday,Summer,2,Early Morning,65,12,53
2011-04-30,3,Saturday,Summer,2,Early Morning,17,4,13
2011-04-30,4,Saturday,Summer,2,Early Morning,7,2,5
2011-04-30,5,Saturday,Summer,1,Early Morning,7,3,4
2011-04-30,6,Saturday,Summer,1,Morning Rush,21,10,11
2011-04-30,7,Saturday,Summer,1,Morning Rush,48,21,27
2011-04-30,8,Saturday,Summer,1,Morning Rush,91,21,70
2011-04-30,9,Saturday,Summer,1,Morning Rush,156,35,121
2011-04-30,10,Saturday,Summer,1,Mid-Day,279,94,185
2011-04-30,11,Saturday,Summer,1,Mid-Day,321,120,201
2011-04-30,12,Saturday,Summer,1,Mid-Day,416,178,238
2011-04-30,13,Saturday,Summer,1,Mid-Day,455,185,270
2011-04-30,14,Saturday,Summer,1,Mid-Day,452,184,268
2011-04-30,15,Saturday,Summer,1,Mid-Day,499,217,282
2011-04-30,16,Saturday,Summer,1,Evening Rush,464,191,273
2011-04-30,17,Saturday,Summer,1,Evening Rush,407,162,245
2011-04-30,18,Saturday,Summer,1,Evening Rush,371,134,237
2011-04-30,19,Saturday,Summer,1,Evening Rush,387,150,237
2011-04-30,20,Saturday,Summer,1,Night,224,65,159
2011-04-30,21,Saturday,Summer,1,Night,177,58,119
2011-04-30,22,Saturday,Summer,1,Night,143,37,106
2011-04-30,23,Saturday,Summer,1,Night,125,34,91
2011-05-01,0,Sunday,Summer,1,Early Morning,96,19,77
2011-05-01,1,Sunday,Summer,1,Early Morning,59,9,50
2011-05-01,2,Sunday,Summer,1,Early Morning,50,7,43
2011-05-01,3,Sunday,Summer,1,Early Morning,23,8,15
2011-05-01,4,Sunday,Summer,1,Early Morning,17,6,11
2011-05-01,5,Sunday,Summer,1,Early Morning,10,0,10
2011-05-01,6,Sunday,Summer,2,Morning Rush,13,4,9
2011-05-01,7,Sunday,Summer,2,Morning Rush,33,7,26
2011-05-01,8,Sunday,Summer,2,Morning Rush,59,16,43
2011-05-01,9,Sunday,Summer,2,Morning Rush,141,45,96
2011-05-01,10,Sunday,Summer,2,Mid-Day,264,109,155
2011-05-01,11,Sunday,Summer,1,Mid-Day,250,109,141
2011-05-01,12,Sunday,Summer,2,Mid-Day,281,109,172
2011-05-01,13,Sunday,Summer,2,Mid-Day,332,123,209
2011-05-01,14,Sunday,Summer,2,Mid-Day,238,85,153
2011-05-01,15,Sunday,Summer,2,Mid-Day,266,113,153
2011-05-01,16,Sunday,Summer,2,Evening Rush,214,75,139
2011-05-01,17,Sunday,Summer,2,Evening Rush,196,60,136
2011-05-01,18,Sunday,Summer,2,Evening Rush,159,33,126
2011-05-01,19,Sunday,Summer,2,Evening Rush,178,47,131
2011-05-01,20,Sunday,Summer,2,Night,121,35,86
2011-05-01,21,Sunday,Summer,2,Night,105,23,82
2011-05-01,22,Sunday,Summer,2,Night,100,32,68
2011-05-01,23,Sunday,Summer,1,Night,146,64,82
2011-05-02,0,Monday,Summer,1,Early Morning,177,68,109
2011-05-02,1,Monday,Summer,1,Early Morning,114,41,73
2011-05-02,2,Monday,Summer,2,Early Morning,35,16,19
2011-05-02,3,Monday,Summer,1,Early Morning,16,9,7
2011-05-02,4,Monday,Summer,1,Early Morning,17,9,8
2011-05-02,5,Monday,Summer,2,Early Morning,20,4,16
2011-05-02,6,Monday,Summer,1,Morning Rush,62,3,59
2011-05-02,7,Monday,Summer,2,Morning Rush,209,16,193
2011-05-02,8,Monday,Summer,2,Morning Rush,371,21,350
2011-05-02,9,Monday,Summer,2,Morning Rush,172,41,131
2011-05-02,10,Monday,Summer,2,Mid-Day,108,31,77
2011-05-02,11,Monday,Summer,1,Mid-Day,130,34,96
2011-05-02,12,Monday,Summer,1,Mid-Day,187,40,147
2011-05-02,13,Monday,Summer,2,Mid-Day,170,51,119
2011-05-02,14,Monday,Summer,1,Mid-Day,181,48,133
2011-05-02,15,Monday,Summer,1,Mid-Day,155,45,110
2011-05-02,16,Monday,Summer,1,Evening Rush,269,49,220
2011-05-02,17,Monday,Summer,1,Evening Rush,537,65,472
2011-05-02,18,Monday,Summer,2,Evening Rush,518,68,450
2011-05-02,19,Monday,Summer,2,Evening Rush,314,46,268
2011-05-02,20,Monday,Summer,2,Night,218,44,174
2011-05-02,21,Monday,Summer,2,Night,232,54,178
2011-05-02,22,Monday,Summer,2,Night,125,28,97
2011-05-02,23,Monday,Summer,2,Night,64,16,48
2011-05-03,0,Tuesday,Summer,2,Early Morning,16,0,16
2011-05-03,1,Tuesday,Summer,2,Early Morning,14,0,14
2011-05-03,2,Tuesday,Summer,2,Early Morning,5,0,5
2011-05-03,3,Tuesday,Summer,1,Early Morning,2,0,2
2011-05-03,4,Tuesday,Summer,1,Early Morning,4,3,1
2011-05-03,5,Tuesday,Summer,1,Early Morning,14,0,14
2011-05-03,6,Tuesday,Summer,2,Morning Rush,109,7,102
2011-05-03,7,Tuesday,Summer,2,Morning Rush,265,17,248
2011-05-03,8,Tuesday,Summer,2,Morning Rush,459,24,435
2011-05-03,9,Tuesday,Summer,2,Morning Rush,186,29,157
2011-05-03,10,Tuesday,Summer,2,Mid-Day,127,36,91
2011-05-03,11,Tuesday,Summer,2,Mid-Day,140,20,120
2011-05-03,12,Tuesday,Summer,2,Mid-Day,217,48,169
2011-05-03,13,Tuesday,Summer,2,Mid-Day,194,50,144
2011-05-03,14,Tuesday,Summer,2,Mid-Day,158,36,122
2011-05-03,15,Tuesday,Summer,2,Mid-Day,154,37,117
2011-05-03,16,Tuesday,Summer,1,Evening Rush,271,46,225
2011-05-03,17,Tuesday,Summer,1,Evening Rush,517,53,464
2011-05-03,18,Tuesday,Summer,1,Evening Rush,544,59,485
2011-05-03,19,Tuesday,Summer,1,Evening Rush,365,42,323
2011-05-03,20,Tuesday,Summer,1,Night,290,28,262
2011-05-03,21,Tuesday,Summer,2,Night,225,42,183
2011-05-03,22,Tuesday,Summer,2,Night,113,14,99
2011-05-03,23,Tuesday,Summer,2,Night,62,12,50
2011-05-04,0,Wednesday,Summer,3,Early Morning,27,5,22
2011-05-04,1,Wednesday,Summer,3,Early Morning,7,1,6
2011-05-04,2,Wednesday,Summer,3,Early Morning,4,0,4
2011-05-04,3,Wednesday,Summer,3,Early Morning,1,0,1
2011-05-04,4,Wednesday,Summer,3,Early Morning,3,1,2
2011-05-04,5,Wednesday,Summer,3,Early Morning,9,1,8
2011-05-04,6,Wednesday,Summer,3,Morning Rush,21,0,21
2011-05-04,7,Wednesday,Summer,3,Morning Rush,52,6,46
2011-05-04,8,Wednesday,Summer,3,Morning Rush,79,5,74
2011-05-04,9,Wednesday,Summer,3,Morning Rush,40,5,35
2011-05-04,10,Wednesday,Summer,2,Mid-Day,31,5,26
2011-05-04,11,Wednesday,Summer,1,Mid-Day,72,3,69
2011-05-04,12,Wednesday,Summer,2,Mid-Day,124,19,105
2011-05-04,13,Wednesday,Summer,2,Mid-Day,143,15,128
2011-05-04,14,Wednesday,Summer,1,Mid-Day,107,13,94
2011-05-04,15,Wednesday,Summer,1,Mid-Day,129,22,107
2011-05-04,16,Wednesday,Summer,1,Evening Rush,195,22,173
2011-05-04,17,Wednesday,Summer,1,Evening Rush,410,22,388
2011-05-04,18,Wednesday,Summer,1,Evening Rush,396,29,367
2011-05-04,19,Wednesday,Summer,1,Evening Rush,296,30,266
2011-05-04,20,Wednesday,Summer,1,Night,191,17,174
2011-05-04,21,Wednesday,Summer,1,Night,150,17,133
2011-05-04,22,Wednesday,Summer,1,Night,89,9,80
2011-05-04,23,Wednesday,Summer,1,Night,57,8,49
2011-05-05,0,Thursday,Summer,1,Early Morning,27,4,23
2011-05-05,1,Thursday,Summer,1,Early Morning,10,4,6
2011-05-05,2,Thursday,Summer,1,Early Morning,5,1,4
2011-05-05,3,Thursday,Summer,1,Early Morning,4,0,4
2011-05-05,4,Thursday,Summer,1,Early Morning,7,4,3
2011-05-05,5,Thursday,Summer,1,Early Morning,30,1,29
2011-05-05,6,Thursday,Summer,1,Morning Rush,89,3,86
2011-05-05,7,Thursday,Summer,1,Morning Rush,271,16,255
2011-05-05,8,Thursday,Summer,1,Morning Rush,440,25,415
2011-05-05,9,Thursday,Summer,1,Morning Rush,184,20,164
2011-05-05,10,Thursday,Summer,1,Mid-Day,128,30,98
2011-05-05,11,Thursday,Summer,1,Mid-Day,148,43,105
2011-05-05,12,Thursday,Summer,1,Mid-Day,196,27,169
2011-05-05,13,Thursday,Summer,1,Mid-Day,192,50,142
2011-05-05,14,Thursday,Summer,1,Mid-Day,154,19,135
2011-05-05,15,Thursday,Summer,1,Mid-Day,147,27,120
2011-05-05,16,Thursday,Summer,1,Evening Rush,269,36,233
2011-05-05,17,Thursday,Summer,1,Evening Rush,533,66,467
2011-05-05,18,Thursday,Summer,1,Evening Rush,520,64,456
2011-05-05,19,Thursday,Summer,1,Evening Rush,361,56,305
2011-05-05,20,Thursday,Summer,1,Night,258,33,225
2011-05-05,21,Thursday,Summer,1,Night,180,39,141
2011-05-05,22,Thursday,Summer,1,Night,165,30,135
2011-05-05,23,Thursday,Summer,1,Night,115,16,99
2011-05-06,0,Friday,Summer,1,Early Morning,56,13,43
2011-05-06,1,Friday,Summer,1,Early Morning,32,8,24
2011-05-06,2,Friday,Summer,1,Early Morning,16,1,15
2011-05-06,3,Friday,Summer,1,Early Morning,9,3,6
2011-05-06,4,Friday,Summer,1,Early Morning,1,0,1
2011-05-06,5,Friday,Summer,1,Early Morning,16,0,16
2011-05-06,6,Friday,Summer,1,Morning Rush,82,8,74
2011-05-06,7,Friday,Summer,1,Morning Rush,222,20,202
2011-05-06,8,Friday,Summer,1,Morning Rush,450,35,415
2011-05-06,9,Friday,Summer,1,Morning Rush,188,27,161
2011-05-06,10,Friday,Summer,2,Mid-Day,127,30,97
2011-05-06,11,Friday,Summer,2,Mid-Day,165,42,123
2011-05-06,12,Friday,Summer,1,Mid-Day,246,48,198
2011-05-06,13,Friday,Summer,1,Mid-Day,253,71,182
2011-05-06,14,Friday,Summer,1,Mid-Day,213,86,127
2011-05-06,15,Friday,Summer,1,Mid-Day,260,89,171
2011-05-06,16,Friday,Summer,1,Evening Rush,344,82,262
2011-05-06,17,Friday,Summer,1,Evening Rush,553,83,470
2011-05-06,18,Friday,Summer,3,Evening Rush,470,85,385
2011-05-06,19,Friday,Summer,3,Evening Rush,292,39,253
2011-05-06,20,Friday,Summer,1,Night,190,29,161
2011-05-06,21,Friday,Summer,1,Night,152,22,130
2011-05-06,22,Friday,Summer,1,Night,151,46,105
2011-05-06,23,Friday,Summer,1,Night,120,27,93
2011-05-07,0,Saturday,Summer,1,Early Morning,86,10,76
2011-05-07,1,Saturday,Summer,1,Early Morning,58,8,50
2011-05-07,2,Saturday,Summer,1,Early Morning,52,5,47
2011-05-07,3,Saturday,Summer,1,Early Morning,18,9,9
2011-05-07,4,Saturday,Summer,1,Early Morning,5,1,4
2011-05-07,5,Saturday,Summer,1,Early Morning,7,4,3
2011-05-07,6,Saturday,Summer,1,Morning Rush,13,1,12
2011-05-07,7,Saturday,Summer,1,Morning Rush,40,8,32
2011-05-07,8,Saturday,Summer,1,Morning Rush,115,19,96
2011-05-07,9,Saturday,Summer,1,Morning Rush,218,54,164
2011-05-07,10,Saturday,Summer,1,Mid-Day,298,90,208
2011-05-07,11,Saturday,Summer,1,Mid-Day,347,132,215
2011-05-07,12,Saturday,Summer,1,Mid-Day,373,129,244
2011-05-07,13,Saturday,Summer,1,Mid-Day,436,196,240
2011-05-07,14,Saturday,Summer,3,Mid-Day,378,143,235
2011-05-07,15,Saturday,Summer,1,Mid-Day,378,148,230
2011-05-07,16,Saturday,Summer,1,Evening Rush,342,119,223
2011-05-07,17,Saturday,Summer,1,Evening Rush,354,138,216
2011-05-07,18,Saturday,Summer,1,Evening Rush,289,114,175
2011-05-07,19,Saturday,Summer,1,Evening Rush,267,88,179
2011-05-07,20,Saturday,Summer,1,Night,219,82,137
2011-05-07,21,Saturday,Summer,1,Night,182,58,124
2011-05-07,22,Saturday,Summer,1,Night,120,26,94
2011-05-07,23,Saturday,Summer,1,Night,119,30,89
2011-05-08,0,Sunday,Summer,2,Early Morning,100,22,78
2011-05-08,1,Sunday,Summer,2,Early Morning,64,8,56
2011-05-08,2,Sunday,Summer,1,Early Morning,59,17,42
2011-05-08,3,Sunday,Summer,1,Early Morning,31,10,21
2011-05-08,4,Sunday,Summer,1,Early Morning,10,2,8
2011-05-08,5,Sunday,Summer,2,Early Morning,5,0,5
2011-05-08,6,Sunday,Summer,2,Morning Rush,6,2,4
2011-05-08,7,Sunday,Summer,2,Morning Rush,23,8,15
2011-05-08,8,Sunday,Summer,1,Morning Rush,86,28,58
2011-05-08,9,Sunday,Summer,1,Morning Rush,160,48,112
2011-05-08,10,Sunday,Summer,1,Mid-Day,244,91,153
2011-05-08,11,Sunday,Summer,1,Mid-Day,340,142,198
2011-05-08,12,Sunday,Summer,1,Mid-Day,382,139,243
2011-05-08,13,Sunday,Summer,1,Mid-Day,390,166,224
2011-05-08,14,Sunday,Summer,1,Mid-Day,366,126,240
2011-05-08,15,Sunday,Summer,1,Mid-Day,358,128,230
2011-05-08,16,Sunday,Summer,1,Evening Rush,385,122,263
2011-05-08,17,Sunday,Summer,3,Evening Rush,351,106,245
2011-05-08,18,Sunday,Summer,1,Evening Rush,268,63,205
2011-05-08,19,Sunday,Summer,1,Evening Rush,239,61,178
2011-05-08,20,Sunday,Summer,1,Night,174,42,132
2011-05-08,21,Sunday,Summer,1,Night,127,32,95
2011-05-08,22,Sunday,Summer,1,Night,115,29,86
2011-05-08,23,Sunday,Summer,1,Night,50,9,41
2011-05-09,0,Monday,Summer,1,Early Morning,53,31,22
2011-05-09,1,Monday,Summer,1,Early Morning,33,25,8
2011-05-09,2,Monday,Summer,1,Early Morning,8,6,2
2011-05-09,3,Monday,Summer,1,Early Morning,7,0,7
2011-05-09,4,Monday,Summer,1,Early Morning,4,0,4
2011-05-09,5,Monday,Summer,1,Early Morning,23,0,23
2011-05-09,6,Monday,Summer,1,Morning Rush,89,2,87
2011-05-09,7,Monday,Summer,1,Morning Rush,237,16,221
2011-05-09,8,Monday,Summer,1,Morning Rush,374,23,351
2011-05-09,9,Monday,Summer,1,Morning Rush,178,36,142
2011-05-09,10,Monday,Summer,1,Mid-Day,119,24,95
2011-05-09,11,Monday,Summer,1,Mid-Day,125,26,99
2011-05-09,12,Monday,Summer,1,Mid-Day,195,35,160
2011-05-09,13,Monday,Summer,1,Mid-Day,174,36,138
2011-05-09,14,Monday,Summer,1,Mid-Day,162,44,118
2011-05-09,15,Monday,Summer,1,Mid-Day,199,51,148
2011-05-09,16,Monday,Summer,1,Evening Rush,304,49,255
2011-05-09,17,Monday,Summer,1,Evening Rush,598,59,539
2011-05-09,18,Monday,Summer,1,Evening Rush,524,66,458
2011-05-09,19,Monday,Summer,1,Evening Rush,384,45,339
2011-05-09,20,Monday,Summer,1,Night,239,25,214
2011-05-09,21,Monday,Summer,1,Night,156,28,128
2011-05-09,22,Monday,Summer,1,Night,116,21,95
2011-05-09,23,Monday,Summer,1,Night,61,16,45
2011-05-10,0,Tuesday,Summer,1,Early Morning,18,6,12
2011-05-10,1,Tuesday,Summer,1,Early Morning,15,3,12
2011-05-10,2,Tuesday,Summer,1,Early Morning,5,1,4
2011-05-10,3,Tuesday,Summer,1,Early Morning,4,1,3
2011-05-10,4,Tuesday,Summer,1,Early Morning,2,0,2
2011-05-10,5,Tuesday,Summer,1,Early Morning,29,1,28
2011-05-10,6,Tuesday,Summer,1,Morning Rush,112,9,103
2011-05-10,7,Tuesday,Summer,2,Morning Rush,314,13,301
2011-05-10,8,Tuesday,Summer,2,Morning Rush,425,28,397
2011-05-10,9,Tuesday,Summer,2,Morning Rush,205,29,176
2011-05-10,10,Tuesday,Summer,2,Mid-Day,127,27,100
2011-05-10,11,Tuesday,Summer,2,Mid-Day,125,17,108
2011-05-10,12,Tuesday,Summer,2,Mid-Day,217,47,170
2011-05-10,13,Tuesday,Summer,2,Mid-Day,202,50,152
2011-05-10,14,Tuesday,Summer,2,Mid-Day,176,42,134
2011-05-10,15,Tuesday,Summer,2,Mid-Day,180,28,152
2011-05-10,16,Tuesday,Summer,1,Evening Rush,327,56,271
2011-05-10,17,Tuesday,Summer,1,Evening Rush,611,79,532
2011-05-10,18,Tuesday,Summer,1,Evening Rush,550,70,480
2011-05-10,19,Tuesday,Summer,1,Evening Rush,434,69,365
2011-05-10,20,Tuesday,Summer,1,Night,291,50,241
2011-05-10,21,Tuesday,Summer,1,Night,203,30,173
2011-05-10,22,Tuesday,Summer,1,Night,150,29,121
2011-05-10,23,Tuesday,Summer,2,Night,81,9,72
2011-05-11,0,Wednesday,Summer,2,Early Morning,38,8,30
2011-05-11,1,Wednesday,Summer,2,Early Morning,20,4,16
2011-05-11,2,Wednesday,Summer,1,Early Morning,10,6,4
2011-05-11,3,Wednesday,Summer,1,Early Morning,3,0,3
2011-05-11,4,Wednesday,Summer,2,Early Morning,2,0,2
2011-05-11,5,Wednesday,Summer,1,Early Morning,20,0,20
2011-05-11,6,Wednesday,Summer,1,Morning Rush,99,6,93
2011-05-11,7,Wednesday,Summer,1,Morning Rush,318,25,293
2011-05-11,8,Wednesday,Summer,1,Morning Rush,442,21,421
2011-05-11,9,Wednesday,Summer,1,Morning Rush,203,21,182
2011-05-11,10,Wednesday,Summer,1,Mid-Day,154,30,124
2011-05-11,11,Wednesday,Summer,1,Mid-Day,141,18,123
2011-05-11,12,Wednesday,Summer,1,Mid-Day,226,41,185
2011-05-11,13,Wednesday,Summer,1,Mid-Day,193,36,157
2011-05-11,14,Wednesday,Summer,1,Mid-Day,177,36,141
2011-05-11,15,Wednesday,Summer,1,Mid-Day,179,48,131
2011-05-11,16,Wednesday,Summer,1,Evening Rush,289,49,240
2011-05-11,17,Wednesday,Summer,1,Evening Rush,259,17,242
2011-05-11,18,Wednesday,Summer,1,Evening Rush,274,40,234
2011-05-11,19,Wednesday,Summer,1,Evening Rush,401,60,341
2011-05-11,20,Wednesday,Summer,1,Night,273,28,245
2011-05-11,21,Wednesday,Summer,1,Night,234,32,202
2011-05-11,22,Wednesday,Summer,1,Night,146,12,134
2011-05-11,23,Wednesday,Summer,1,Night,81,12,69
2011-05-12,0,Thursday,Summer,2,Early Morning,44,5,39
2011-05-12,1,Thursday,Summer,1,Early Morning,17,1,16
2011-05-12,2,Thursday,Summer,1,Early Morning,15,1,14
2011-05-12,3,Thursday,Summer,1,Early Morning,5,0,5
2011-05-12,4,Thursday,Summer,1,Early Morning,6,1,5
2011-05-12,5,Thursday,Summer,1,Early Morning,29,2,27
2011-05-12,6,Thursday,Summer,1,Morning Rush,112,9,103
2011-05-12,7,Thursday,Summer,1,Morning Rush,297,14,283
2011-05-12,8,Thursday,Summer,1,Morning Rush,421,27,394
2011-05-12,9,Thursday,Summer,2,Morning Rush,212,21,191
2011-05-12,10,Thursday,Summer,2,Mid-Day,147,28,119
2011-05-12,11,Thursday,Summer,1,Mid-Day,179,43,136
2011-05-12,12,Thursday,Summer,1,Mid-Day,207,43,164
2011-05-12,13,Thursday,Summer,2,Mid-Day,218,48,170
2011-05-12,14,Thursday,Summer,2,Mid-Day,191,43,148
2011-05-12,15,Thursday,Summer,2,Mid-Day,217,54,163
2011-05-12,16,Thursday,Summer,2,Evening Rush,288,50,238
2011-05-12,17,Thursday,Summer,2,Evening Rush,594,54,540
2011-05-12,18,Thursday,Summer,1,Evening Rush,527,64,463
2011-05-12,19,Thursday,Summer,2,Evening Rush,364,59,305
2011-05-12,20,Thursday,Summer,1,Night,276,56,220
2011-05-12,21,Thursday,Summer,1,Night,223,31,192
2011-05-12,22,Thursday,Summer,1,Night,172,25,147
2011-05-12,23,Thursday,Summer,2,Night,103,16,87
2011-05-13,0,Friday,Summer,2,Early Morning,52,6,46
2011-05-13,1,Friday,Summer,1,Early Morning,20,5,15
2011-05-13,2,Friday,Summer,2,Early Morning,11,3,8
2011-05-13,3,Friday,Summer,2,Early Morning,4,2,2
2011-05-13,4,Friday,Summer,3,Early Morning,5,2,3
2011-05-13,5,Friday,Summer,2,Early Morning,25,1,24
2011-05-13,6,Friday,Summer,3,Morning Rush,82,6,76
2011-05-13,7,Friday,Summer,3,Morning Rush,157,16,141
2011-05-13,8,Friday,Summer,2,Morning Rush,387,26,361
2011-05-13,9,Friday,Summer,2,Morning Rush,233,18,215
2011-05-13,10,Friday,Summer,2,Mid-Day,130,31,99
2011-05-13,11,Friday,Summer,2,Mid-Day,146,56,90
2011-05-13,12,Friday,Summer,2,Mid-Day,223,53,170
2011-05-13,13,Friday,Summer,2,Mid-Day,226,69,157
2011-05-13,14,Friday,Summer,2,Mid-Day,190,70,120
2011-05-13,15,Friday,Summer,2,Mid-Day,198,56,142
2011-05-13,16,Friday,Summer,2,Evening Rush,300,44,256
2011-05-13,17,Friday,Summer,3,Evening Rush,491,62,429
2011-05-13,18,Friday,Summer,3,Evening Rush,398,39,359
2011-05-13,19,Friday,Summer,2,Evening Rush,270,25,245
2011-05-13,20,Friday,Summer,2,Night,152,22,130
2011-05-13,21,Friday,Summer,2,Night,154,24,130
2011-05-13,22,Friday,Summer,2,Night,132,25,107
2011-05-13,23,Friday,Summer,3,Night,119,31,88
2011-05-14,0,Saturday,Summer,2,Early Morning,102,24,78
2011-05-14,1,Saturday,Summer,2,Early Morning,82,18,64
2011-05-14,2,Saturday,Summer,2,Early Morning,52,15,37
2011-05-14,3,Saturday,Summer,2,Early Morning,35,5,30
2011-05-14,4,Saturday,Summer,2,Early Morning,5,1,4
2011-05-14,5,Saturday,Summer,2,Early Morning,14,7,7
2011-05-14,6,Saturday,Summer,2,Morning Rush,11,2,9
2011-05-14,7,Saturday,Summer,3,Morning Rush,32,4,28
2011-05-14,8,Saturday,Summer,3,Morning Rush,88,16,72
2011-05-14,9,Saturday,Summer,2,Morning Rush,100,14,86
2011-05-14,10,Saturday,Summer,2,Mid-Day,167,34,133
2011-05-14,11,Saturday,Summer,2,Mid-Day,279,72,207
2011-05-14,12,Saturday,Summer,3,Mid-Day,279,75,204
2011-05-14,13,Saturday,Summer,3,Mid-Day,248,68,180
2011-05-14,14,Saturday,Summer,2,Mid-Day,216,57,159
2011-05-14,15,Saturday,Summer,2,Mid-Day,294,73,221
2011-05-14,16,Saturday,Summer,2,Evening Rush,295,107,188
2011-05-14,17,Saturday,Summer,2,Evening Rush,272,78,194
2011-05-14,18,Saturday,Summer,2,Evening Rush,304,88,216
2011-05-14,19,Saturday,Summer,3,Evening Rush,248,69,179
2011-05-14,20,Saturday,Summer,3,Night,157,42,115
2011-05-14,21,Saturday,Summer,3,Night,59,15,44
2011-05-14,22,Saturday,Summer,3,Night,26,7,19
2011-05-14,23,Saturday,Summer,3,Night,44,11,33
2011-05-15,0,Sunday,Summer,2,Early Morning,39,5,34
2011-05-15,1,Sunday,Summer,2,Early Morning,47,4,43
2011-05-15,2,Sunday,Summer,2,Early Morning,50,13,37
2011-05-15,3,Sunday,Summer,2,Early Morning,32,11,21
2011-05-15,4,Sunday,Summer,2,Early Morning,13,5,8
2011-05-15,5,Sunday,Summer,3,Early Morning,14,3,11
2011-05-15,6,Sunday,Summer,2,Morning Rush,17,3,14
2011-05-15,7,Sunday,Summer,2,Morning Rush,42,4,38
2011-05-15,8,Sunday,Summer,2,Morning Rush,70,24,46
2011-05-15,9,Sunday,Summer,1,Morning Rush,134,36,98
2011-05-15,10,Sunday,Summer,1,Mid-Day,226,73,153
2011-05-15,11,Sunday,Summer,1,Mid-Day,322,120,202
2011-05-15,12,Sunday,Summer,1,Mid-Day,367,120,247
2011-05-15,13,Sunday,Summer,1,Mid-Day,456,195,261
2011-05-15,14,Sunday,Summer,1,Mid-Day,437,183,254
2011-05-15,15,Sunday,Summer,1,Mid-Day,459,206,253
2011-05-15,16,Sunday,Summer,1,Evening Rush,440,158,282
2011-05-15,17,Sunday,Summer,3,Evening Rush,392,137,255
2011-05-15,18,Sunday,Summer,1,Evening Rush,237,60,177
2011-05-15,19,Sunday,Summer,1,Evening Rush,231,78,153
2011-05-15,20,Sunday,Summer,1,Night,191,53,138
2011-05-15,21,Sunday,Summer,1,Night,151,44,107
2011-05-15,22,Sunday,Summer,1,Night,117,29,88
2011-05-15,23,Sunday,Summer,1,Night,69,18,51
2011-05-16,0,Monday,Summer,1,Early Morning,38,17,21
2011-05-16,1,Monday,Summer,1,Early Morning,14,6,8
2011-05-16,2,Monday,Summer,1,Early Morning,13,4,9
2011-05-16,3,Monday,Summer,1,Early Morning,4,1,3
2011-05-16,4,Monday,Summer,1,Early Morning,6,1,5
2011-05-16,5,Monday,Summer,1,Early Morning,21,1,20
2011-05-16,6,Monday,Summer,1,Morning Rush,104,11,93
2011-05-16,7,Monday,Summer,1,Morning Rush,272,27,245
2011-05-16,8,Monday,Summer,1,Morning Rush,394,28,366
2011-05-16,9,Monday,Summer,1,Morning Rush,194,38,156
2011-05-16,10,Monday,Summer,1,Mid-Day,112,37,75
2011-05-16,11,Monday,Summer,1,Mid-Day,185,56,129
2011-05-16,12,Monday,Summer,1,Mid-Day,209,72,137
2011-05-16,13,Monday,Summer,1,Mid-Day,214,61,153
2011-05-16,14,Monday,Summer,1,Mid-Day,193,76,117
2011-05-16,15,Monday,Summer,1,Mid-Day,165,55,110
2011-05-16,16,Monday,Summer,3,Evening Rush,226,45,181
2011-05-16,17,Monday,Summer,1,Evening Rush,274,47,227
2011-05-16,18,Monday,Summer,3,Evening Rush,453,55,398
2011-05-16,19,Monday,Summer,1,Evening Rush,308,36,272
2011-05-16,20,Monday,Summer,1,Night,198,31,167
2011-05-16,21,Monday,Summer,1,Night,177,28,149
2011-05-16,22,Monday,Summer,1,Night,127,22,105
2011-05-16,23,Monday,Summer,1,Night,57,18,39
2011-05-17,0,Tuesday,Summer,2,Early Morning,31,13,18
2011-05-17,1,Tuesday,Summer,3,Early Morning,13,7,6
2011-05-17,2,Tuesday,Summer,3,Early Morning,8,4,4
2011-05-17,3,Tuesday,Summer,3,Early Morning,4,1,3
2011-05-17,4,Tuesday,Summer,3,Early Morning,4,2,2
2011-05-17,5,Tuesday,Summer,3,Early Morning,22,0,22
2011-05-17,6,Tuesday,Summer,3,Morning Rush,49,0,49
2011-05-17,7,Tuesday,Summer,2,Morning Rush,151,13,138
2011-05-17,8,Tuesday,Summer,2,Morning Rush,347,22,325
2011-05-17,9,Tuesday,Summer,2,Morning Rush,207,17,190
2011-05-17,10,Tuesday,Summer,3,Mid-Day,104,31,73
2011-05-17,11,Tuesday,Summer,2,Mid-Day,130,26,104
2011-05-17,12,Tuesday,Summer,3,Mid-Day,153,38,115
2011-05-17,13,Tuesday,Summer,2,Mid-Day,172,31,141
2011-05-17,14,Tuesday,Summer,1,Mid-Day,184,61,123
2011-05-17,15,Tuesday,Summer,1,Mid-Day,210,79,131
2011-05-17,16,Tuesday,Summer,1,Evening Rush,290,73,217
2011-05-17,17,Tuesday,Summer,1,Evening Rush,604,83,521
2011-05-17,18,Tuesday,Summer,1,Evening Rush,480,54,426
2011-05-17,19,Tuesday,Summer,1,Evening Rush,349,51,298
2011-05-17,20,Tuesday,Summer,1,Night,283,30,253
2011-05-17,21,Tuesday,Summer,1,Night,174,23,151
2011-05-17,22,Tuesday,Summer,2,Night,98,12,86
2011-05-17,23,Tuesday,Summer,2,Night,56,7,49
2011-05-18,0,Wednesday,Summer,2,Early Morning,23,8,15
2011-05-18,1,Wednesday,Summer,2,Early Morning,12,3,9
2011-05-18,2,Wednesday,Summer,3,Early Morning,6,1,5
2011-05-18,3,Wednesday,Summer,3,Early Morning,9,6,3
2011-05-18,4,Wednesday,Summer,3,Early Morning,3,1,2
2011-05-18,5,Wednesday,Summer,1,Early Morning,9,0,9
2011-05-18,6,Wednesday,Summer,1,Morning Rush,101,2,99
2011-05-18,7,Wednesday,Summer,1,Morning Rush,274,14,260
2011-05-18,8,Wednesday,Summer,1,Morning Rush,453,25,428
2011-05-18,9,Wednesday,Summer,3,Morning Rush,202,26,176
2011-05-18,10,Wednesday,Summer,3,Mid-Day,106,33,73
2011-05-18,11,Wednesday,Summer,2,Mid-Day,23,6,17
2011-05-18,12,Wednesday,Summer,1,Mid-Day,54,12,42
2011-05-18,13,Wednesday,Summer,2,Mid-Day,122,30,92
2011-05-18,14,Wednesday,Summer,2,Mid-Day,138,44,94
2011-05-18,15,Wednesday,Summer,1,Mid-Day,167,34,133
2011-05-18,16,Wednesday,Summer,1,Evening Rush,294,53,241
2011-05-18,17,Wednesday,Summer,1,Evening Rush,565,78,487
2011-05-18,18,Wednesday,Summer,1,Evening Rush,489,58,431
2011-05-18,19,Wednesday,Summer,3,Evening Rush,331,43,288
2011-05-18,20,Wednesday,Summer,3,Night,213,24,189
2011-05-18,21,Wednesday,Summer,1,Night,85,11,74
2011-05-18,22,Wednesday,Summer,1,Night,117,14,103
2011-05-18,23,Wednesday,Summer,1,Night,59,10,49
2011-05-19,0,Thursday,Summer,1,Early Morning,29,6,23
2011-05-19,1,Thursday,Summer,1,Early Morning,6,2,4
2011-05-19,2,Thursday,Summer,1,Early Morning,15,3,12
2011-05-19,3,Thursday,Summer,1,Early Morning,4,1,3
2011-05-19,4,Thursday,Summer,1,Early Morning,5,2,3
2011-05-19,5,Thursday,Summer,1,Early Morning,26,2,24
2011-05-19,6,Thursday,Summer,2,Morning Rush,103,17,86
2011-05-19,7,Thursday,Summer,2,Morning Rush,257,18,239
2011-05-19,8,Thursday,Summer,2,Morning Rush,487,34,453
2011-05-19,9,Thursday,Summer,2,Morning Rush,216,40,176
2011-05-19,10,Thursday,Summer,2,Mid-Day,130,35,95
2011-05-19,11,Thursday,Summer,3,Mid-Day,164,53,111
2011-05-19,12,Thursday,Summer,2,Mid-Day,168,38,130
2011-05-19,13,Thursday,Summer,3,Mid-Day,183,44,139
2011-05-19,14,Thursday,Summer,3,Mid-Day,180,43,137
2011-05-19,15,Thursday,Summer,1,Mid-Day,188,63,125
2011-05-19,16,Thursday,Summer,1,Evening Rush,302,55,247
2011-05-19,17,Thursday,Summer,1,Evening Rush,547,60,487
2011-05-19,18,Thursday,Summer,1,Evening Rush,513,59,454
2011-05-19,19,Thursday,Summer,1,Evening Rush,410,65,345
2011-05-19,20,Thursday,Summer,1,Night,282,46,236
2011-05-19,21,Thursday,Summer,1,Night,209,29,180
2011-05-19,22,Thursday,Summer,3,Night,79,11,68
2011-05-19,23,Thursday,Summer,1,Night,72,9,63
2011-05-20,0,Friday,Summer,1,Early Morning,48,15,33
2011-05-20,1,Friday,Summer,1,Early Morning,25,8,17
2011-05-20,2,Friday,Summer,1,Early Morning,8,4,4
2011-05-20,3,Friday,Summer,1,Early Morning,5,1,4
2011-05-20,4,Friday,Summer,1,Early Morning,5,1,4
2011-05-20,5,Friday,Summer,1,Early Morning,28,0,28
2011-05-20,6,Friday,Summer,1,Morning Rush,117,15,102
2011-05-20,7,Friday,Summer,1,Morning Rush,319,30,289
2011-05-20,8,Friday,Summer,1,Morning Rush,517,41,476
2011-05-20,9,Friday,Summer,1,Morning Rush,234,35,199
2011-05-20,10,Friday,Summer,1,Mid-Day,148,44,104
2011-05-20,11,Friday,Summer,2,Mid-Day,196,63,133
2011-05-20,12,Friday,Summer,2,Mid-Day,255,69,186
2011-05-20,13,Friday,Summer,3,Mid-Day,232,60,172
2011-05-20,14,Friday,Summer,1,Mid-Day,197,66,131
2011-05-20,15,Friday,Summer,2,Mid-Day,242,74,168
2011-05-20,16,Friday,Summer,2,Evening Rush,330,61,269
2011-05-20,17,Friday,Summer,1,Evening Rush,554,71,483
2011-05-20,18,Friday,Summer,1,Evening Rush,473,79,394
2011-05-20,19,Friday,Summer,1,Evening Rush,302,49,253
2011-05-20,20,Friday,Summer,1,Night,220,40,180
2011-05-20,21,Friday,Summer,1,Night,195,40,155
2011-05-20,22,Friday,Summer,1,Night,152,28,124
2011-05-20,23,Friday,Summer,1,Night,115,15,100
2011-05-21,0,Saturday,Summer,1,Early Morning,98,20,78
2011-05-21,1,Saturday,Summer,1,Early Morning,72,8,64
2011-05-21,2,Saturday,Summer,1,Early Morning,40,5,35
2011-05-21,3,Saturday,Summer,1,Early Morning,19,7,12
2011-05-21,4,Saturday,Summer,1,Early Morning,7,1,6
2011-05-21,5,Saturday,Summer,1,Early Morning,5,1,4
2011-05-21,6,Saturday,Summer,1,Morning Rush,28,6,22
2011-05-21,7,Saturday,Summer,1,Morning Rush,43,10,33
2011-05-21,8,Saturday,Summer,1,Morning Rush,126,29,97
2011-05-21,9,Saturday,Summer,1,Morning Rush,225,60,165
2011-05-21,10,Saturday,Summer,1,Mid-Day,323,122,201
2011-05-21,11,Saturday,Summer,1,Mid-Day,418,173,245
2011-05-21,12,Saturday,Summer,1,Mid-Day,493,222,271
2011-05-21,13,Saturday,Summer,1,Mid-Day,462,191,271
2011-05-21,14,Saturday,Summer,1,Mid-Day,456,187,269
2011-05-21,15,Saturday,Summer,1,Mid-Day,506,232,274
2011-05-21,16,Saturday,Summer,2,Evening Rush,471,204,267
2011-05-21,17,Saturday,Summer,2,Evening Rush,444,191,253
2011-05-21,18,Saturday,Summer,2,Evening Rush,444,191,253
2011-05-21,19,Saturday,Summer,1,Evening Rush,301,117,184
2011-05-21,20,Saturday,Summer,1,Night,248,84,164
2011-05-21,21,Saturday,Summer,1,Night,227,77,150
2011-05-21,22,Saturday,Summer,1,Night,204,78,126
2011-05-21,23,Saturday,Summer,1,Night,145,42,103
2011-05-22,0,Sunday,Summer,1,Early Morning,131,31,100
2011-05-22,1,Sunday,Summer,1,Early Morning,98,17,81
2011-05-22,2,Sunday,Summer,1,Early Morning,68,18,50
2011-05-22,3,Sunday,Summer,1,Early Morning,33,10,23
2011-05-22,4,Sunday,Summer,1,Early Morning,12,3,9
2011-05-22,5,Sunday,Summer,1,Early Morning,6,1,5
2011-05-22,6,Sunday,Summer,1,Morning Rush,18,5,13
2011-05-22,7,Sunday,Summer,1,Morning Rush,40,13,27
2011-05-22,8,Sunday,Summer,1,Morning Rush,94,29,65
2011-05-22,9,Sunday,Summer,1,Morning Rush,189,59,130
2011-05-22,10,Sunday,Summer,1,Mid-Day,305,135,170
2011-05-22,11,Sunday,Summer,1,Mid-Day,373,164,209
2011-05-22,12,Sunday,Summer,2,Mid-Day,401,146,255
2011-05-22,13,Sunday,Summer,2,Mid-Day,455,180,275
2011-05-22,14,Sunday,Summer,3,Mid-Day,316,125,191
2011-05-22,15,Sunday,Summer,2,Mid-Day,331,110,221
2011-05-22,16,Sunday,Summer,1,Evening Rush,273,72,201
2011-05-22,17,Sunday,Summer,1,Evening Rush,306,93,213
2011-05-22,18,Sunday,Summer,1,Evening Rush,358,120,238
2011-05-22,19,Sunday,Summer,1,Evening Rush,300,107,193
2011-05-22,20,Sunday,Summer,1,Night,231,57,174
2011-05-22,21,Sunday,Summer,1,Night,136,27,109
2011-05-22,22,Sunday,Summer,1,Night,121,35,86
2011-05-22,23,Sunday,Summer,2,Night,65,19,46
2011-05-23,0,Monday,Summer,2,Early Morning,41,23,18
2011-05-23,1,Monday,Summer,1,Early Morning,9,4,5
2011-05-23,2,Monday,Summer,3,Early Morning,5,2,3
2011-05-23,3,Monday,Summer,3,Early Morning,4,0,4
2011-05-23,4,Monday,Summer,2,Early Morning,4,2,2
2011-05-23,5,Monday,Summer,2,Early Morning,11,0,11
2011-05-23,6,Monday,Summer,2,Morning Rush,96,4,92
2011-05-23,7,Monday,Summer,2,Morning Rush,236,13,223
2011-05-23,8,Monday,Summer,1,Morning Rush,409,50,359
2011-05-23,9,Monday,Summer,1,Morning Rush,167,36,131
2011-05-23,10,Monday,Summer,1,Mid-Day,121,49,72
2011-05-23,11,Monday,Summer,1,Mid-Day,180,73,107
2011-05-23,12,Monday,Summer,1,Mid-Day,204,65,139
2011-05-23,13,Monday,Summer,2,Mid-Day,204,49,155
2011-05-23,14,Monday,Summer,2,Mid-Day,187,57,130
2011-05-23,15,Monday,Summer,2,Mid-Day,176,57,119
2011-05-23,16,Monday,Summer,2,Evening Rush,279,56,223
2011-05-23,17,Monday,Summer,3,Evening Rush,429,56,373
2011-05-23,18,Monday,Summer,1,Evening Rush,453,68,385
2011-05-23,19,Monday,Summer,1,Evening Rush,358,56,302
2011-05-23,20,Monday,Summer,1,Night,310,39,271
2011-05-23,21,Monday,Summer,1,Night,188,33,155
2011-05-23,22,Monday,Summer,1,Night,131,25,106
2011-05-23,23,Monday,Summer,2,Night,72,19,53
2011-05-24,0,Tuesday,Summer,2,Early Morning,35,12,23
2011-05-24,1,Tuesday,Summer,2,Early Morning,15,6,9
2011-05-24,2,Tuesday,Summer,2,Early Morning,10,2,8
2011-05-24,3,Tuesday,Summer,2,Early Morning,2,0,2
2011-05-24,4,Tuesday,Summer,1,Early Morning,4,1,3
2011-05-24,5,Tuesday,Summer,2,Early Morning,24,2,22
2011-05-24,6,Tuesday,Summer,2,Morning Rush,112,10,102
2011-05-24,7,Tuesday,Summer,3,Morning Rush,314,26,288
2011-05-24,8,Tuesday,Summer,3,Morning Rush,434,31,403
2011-05-24,9,Tuesday,Summer,2,Morning Rush,138,27,111
2011-05-24,10,Tuesday,Summer,1,Mid-Day,108,18,90
2011-05-24,11,Tuesday,Summer,1,Mid-Day,175,33,142
2011-05-24,12,Tuesday,Summer,1,Mid-Day,170,41,129
2011-05-24,13,Tuesday,Summer,1,Mid-Day,190,38,152
2011-05-24,14,Tuesday,Summer,1,Mid-Day,153,27,126
2011-05-24,15,Tuesday,Summer,3,Mid-Day,188,59,129
2011-05-24,16,Tuesday,Summer,1,Evening Rush,277,52,225
2011-05-24,17,Tuesday,Summer,1,Evening Rush,548,56,492
2011-05-24,18,Tuesday,Summer,1,Evening Rush,564,74,490
2011-05-24,19,Tuesday,Summer,1,Evening Rush,355,45,310
2011-05-24,20,Tuesday,Summer,1,Night,280,39,241
2011-05-24,21,Tuesday,Summer,1,Night,189,21,168
2011-05-24,22,Tuesday,Summer,3,Night,141,26,115
2011-05-24,23,Tuesday,Summer,3,Night,66,13,53
2011-05-25,0,Wednesday,Summer,3,Early Morning,35,3,32
2011-05-25,1,Wednesday,Summer,3,Early Morning,8,6,2
2011-05-25,2,Wednesday,Summer,2,Early Morning,8,0,8
2011-05-25,3,Wednesday,Summer,1,Early Morning,9,0,9
2011-05-25,4,Wednesday,Summer,1,Early Morning,3,0,3
2011-05-25,5,Wednesday,Summer,1,Early Morning,25,2,23
2011-05-25,6,Wednesday,Summer,1,Morning Rush,117,4,113
2011-05-25,7,Wednesday,Summer,1,Morning Rush,313,29,284
2011-05-25,8,Wednesday,Summer,1,Morning Rush,531,36,495
2011-05-25,9,Wednesday,Summer,1,Morning Rush,234,27,207
2011-05-25,10,Wednesday,Summer,1,Mid-Day,135,30,105
2011-05-25,11,Wednesday,Summer,1,Mid-Day,140,36,104
2011-05-25,12,Wednesday,Summer,1,Mid-Day,210,32,178
2011-05-25,13,Wednesday,Summer,1,Mid-Day,202,39,163
2011-05-25,14,Wednesday,Summer,1,Mid-Day,168,47,121
2011-05-25,15,Wednesday,Summer,1,Mid-Day,182,37,145
2011-05-25,16,Wednesday,Summer,1,Evening Rush,299,61,238
2011-05-25,17,Wednesday,Summer,1,Evening Rush,601,77,524
2011-05-25,18,Wednesday,Summer,1,Evening Rush,517,66,451
2011-05-25,19,Wednesday,Summer,1,Evening Rush,405,73,332
2011-05-25,20,Wednesday,Summer,1,Night,340,56,284
2011-05-25,21,Wednesday,Summer,1,Night,236,33,203
2011-05-25,22,Wednesday,Summer,1,Night,174,34,140
2011-05-25,23,Wednesday,Summer,1,Night,86,12,74
2011-05-26,0,Thursday,Summer,1,Early Morning,45,11,34
2011-05-26,1,Thursday,Summer,1,Early Morning,16,3,13
2011-05-26,2,Thursday,Summer,1,Early Morning,14,7,7
2011-05-26,3,Thursday,Summer,1,Early Morning,4,0,4
2011-05-26,4,Thursday,Summer,1,Early Morning,2,0,2
2011-05-26,5,Thursday,Summer,2,Early Morning,27,2,25
2011-05-26,6,Thursday,Summer,2,Morning Rush,98,4,94
2011-05-26,7,Thursday,Summer,2,Morning Rush,286,16,270
2011-05-26,8,Thursday,Summer,2,Morning Rush,489,31,458
2011-05-26,9,Thursday,Summer,1,Morning Rush,216,22,194
2011-05-26,10,Thursday,Summer,1,Mid-Day,143,49,94
2011-05-26,11,Thursday,Summer,1,Mid-Day,160,36,124
2011-05-26,12,Thursday,Summer,1,Mid-Day,194,53,141
2011-05-26,13,Thursday,Summer,1,Mid-Day,197,52,145
2011-05-26,14,Thursday,Summer,1,Mid-Day,189,44,145
2011-05-26,15,Thursday,Summer,2,Mid-Day,141,40,101
2011-05-26,16,Thursday,Summer,2,Evening Rush,291,58,233
2011-05-26,17,Thursday,Summer,1,Evening Rush,494,49,445
2011-05-26,18,Thursday,Summer,1,Evening Rush,478,74,404
2011-05-26,19,Thursday,Summer,1,Evening Rush,378,67,311
2011-05-26,20,Thursday,Summer,1,Night,322,55,267
2011-05-26,21,Thursday,Summer,1,Night,223,45,178
2011-05-26,22,Thursday,Summer,1,Night,180,23,157
2011-05-26,23,Thursday,Summer,1,Night,90,17,73
2011-05-27,0,Friday,Summer,1,Early Morning,69,14,55
2011-05-27,1,Friday,Summer,1,Early Morning,50,14,36
2011-05-27,2,Friday,Summer,1,Early Morning,18,6,12
2011-05-27,3,Friday,Summer,1,Early Morning,12,1,11
2011-05-27,4,Friday,Summer,1,Early Morning,7,2,5
2011-05-27,5,Friday,Summer,1,Early Morning,31,2,29
2011-05-27,6,Friday,Summer,1,Morning Rush,81,8,73
2011-05-27,7,Friday,Summer,1,Morning Rush,249,20,229
2011-05-27,8,Friday,Summer,1,Morning Rush,418,25,393
2011-05-27,9,Friday,Summer,1,Morning Rush,227,37,190
2011-05-27,10,Friday,Summer,1,Mid-Day,153,42,111
2011-05-27,11,Friday,Summer,2,Mid-Day,166,40,126
2011-05-27,12,Friday,Summer,2,Mid-Day,243,53,190
2011-05-27,13,Friday,Summer,1,Mid-Day,209,51,158
2011-05-27,14,Friday,Summer,1,Mid-Day,239,51,188
2011-05-27,15,Friday,Summer,1,Mid-Day,356,98,258
2011-05-27,16,Friday,Summer,2,Evening Rush,419,63,356
2011-05-27,17,Friday,Summer,1,Evening Rush,491,77,414
2011-05-27,18,Friday,Summer,2,Evening Rush,399,89,310
2011-05-27,19,Friday,Summer,3,Evening Rush,279,69,210
2011-05-27,20,Friday,Summer,2,Night,144,24,120
2011-05-27,21,Friday,Summer,1,Night,151,37,114
2011-05-27,22,Friday,Summer,1,Night,141,25,116
2011-05-27,23,Friday,Summer,1,Night,127,23,104
2011-05-28,0,Saturday,Summer,1,Early Morning,94,15,79
2011-05-28,1,Saturday,Summer,1,Early Morning,55,8,47
2011-05-28,2,Saturday,Summer,1,Early Morning,48,13,35
2011-05-28,3,Saturday,Summer,1,Early Morning,15,2,13
2011-05-28,4,Saturday,Summer,1,Early Morning,4,0,4
2011-05-28,5,Saturday,Summer,1,Early Morning,7,4,3
2011-05-28,6,Saturday,Summer,1,Morning Rush,19,3,16
2011-05-28,7,Saturday,Summer,1,Morning Rush,50,17,33
2011-05-28,8,Saturday,Summer,1,Morning Rush,102,27,75
2011-05-28,9,Saturday,Summer,1,Morning Rush,177,61,116
2011-05-28,10,Saturday,Summer,1,Mid-Day,276,110,166
2011-05-28,11,Saturday,Summer,1,Mid-Day,349,171,178
2011-05-28,12,Saturday,Summer,1,Mid-Day,358,145,213
2011-05-28,13,Saturday,Summer,1,Mid-Day,385,168,217
2011-05-28,14,Saturday,Summer,1,Mid-Day,382,172,210
2011-05-28,15,Saturday,Summer,1,Mid-Day,374,187,187
2011-05-28,16,Saturday,Summer,1,Evening Rush,402,201,201
2011-05-28,17,Saturday,Summer,1,Evening Rush,341,180,161
2011-05-28,18,Saturday,Summer,1,Evening Rush,385,173,212
2011-05-28,19,Saturday,Summer,1,Evening Rush,252,99,153
2011-05-28,20,Saturday,Summer,1,Night,196,68,128
2011-05-28,21,Saturday,Summer,1,Night,201,87,114
2011-05-28,22,Saturday,Summer,1,Night,161,46,115
2011-05-28,23,Saturday,Summer,1,Night,125,44,81
2011-05-29,0,Sunday,Summer,1,Early Morning,83,32,51
2011-05-29,1,Sunday,Summer,1,Early Morning,66,17,49
2011-05-29,2,Sunday,Summer,1,Early Morning,61,12,49
2011-05-29,3,Sunday,Summer,1,Early Morning,26,2,24
2011-05-29,4,Sunday,Summer,1,Early Morning,23,13,10
2011-05-29,5,Sunday,Summer,1,Early Morning,6,3,3
2011-05-29,6,Sunday,Summer,2,Morning Rush,15,5,10
2011-05-29,7,Sunday,Summer,2,Morning Rush,30,13,17
2011-05-29,8,Sunday,Summer,2,Morning Rush,96,34,62
2011-05-29,9,Sunday,Summer,2,Morning Rush,152,74,78
2011-05-29,10,Sunday,Summer,2,Mid-Day,251,130,121
2011-05-29,11,Sunday,Summer,2,Mid-Day,319,139,180
2011-05-29,12,Sunday,Summer,2,Mid-Day,402,216,186
2011-05-29,13,Sunday,Summer,1,Mid-Day,418,237,181
2011-05-29,14,Sunday,Summer,1,Mid-Day,351,183,168
2011-05-29,15,Sunday,Summer,1,Mid-Day,376,221,155
2011-05-29,16,Sunday,Summer,1,Evening Rush,361,194,167
2011-05-29,17,Sunday,Summer,1,Evening Rush,383,214,169
2011-05-29,18,Sunday,Summer,1,Evening Rush,328,151,177
2011-05-29,19,Sunday,Summer,1,Evening Rush,287,141,146
2011-05-29,20,Sunday,Summer,1,Night,219,91,128
2011-05-29,21,Sunday,Summer,1,Night,229,107,122
2011-05-29,22,Sunday,Summer,1,Night,171,78,93
2011-05-29,23,Sunday,Summer,1,Night,135,48,87
2011-05-30,0,Monday,Summer,1,Early Morning,103,38,65
2011-05-30,1,Monday,Summer,1,Early Morning,79,26,53
2011-05-30,2,Monday,Summer,1,Early Morning,45,17,28
2011-05-30,3,Monday,Summer,1,Early Morning,18,10,8
2011-05-30,4,Monday,Summer,1,Early Morning,6,2,4
2011-05-30,5,Monday,Summer,2,Early Morning,7,1,6
2011-05-30,6,Monday,Summer,2,Morning Rush,16,6,10
2011-05-30,7,Monday,Summer,2,Morning Rush,31,12,19
2011-05-30,8,Monday,Summer,2,Morning Rush,94,36,58
2011-05-30,9,Monday,Summer,1,Morning Rush,128,47,81
2011-05-30,10,Monday,Summer,1,Mid-Day,269,116,153
2011-05-30,11,Monday,Summer,1,Mid-Day,321,153,168
2011-05-30,12,Monday,Summer,1,Mid-Day,366,179,187
2011-05-30,13,Monday,Summer,1,Mid-Day,350,133,217
2011-05-30,14,Monday,Summer,1,Mid-Day,327,142,185
2011-05-30,15,Monday,Summer,1,Mid-Day,311,132,179
2011-05-30,16,Monday,Summer,1,Evening Rush,309,101,208
2011-05-30,17,Monday,Summer,1,Evening Rush,304,102,202
2011-05-30,18,Monday,Summer,1,Evening Rush,249,77,172
2011-05-30,19,Monday,Summer,2,Evening Rush,225,68,157
2011-05-30,20,Monday,Summer,1,Night,237,69,168
2011-05-30,21,Monday,Summer,1,Night,149,42,107
2011-05-30,22,Monday,Summer,1,Night,106,26,80
2011-05-30,23,Monday,Summer,1,Night,48,14,34
2011-05-31,0,Tuesday,Summer,1,Early Morning,29,9,20
2011-05-31,1,Tuesday,Summer,1,Early Morning,17,8,9
2011-05-31,2,Tuesday,Summer,2,Early Morning,12,5,7
2011-05-31,3,Tuesday,Summer,2,Early Morning,4,1,3
2011-05-31,4,Tuesday,Summer,1,Early Morning,3,0,3
2011-05-31,5,Tuesday,Summer,1,Early Morning,26,0,26
2011-05-31,6,Tuesday,Summer,1,Morning Rush,109,11,98
2011-05-31,7,Tuesday,Summer,1,Morning Rush,235,16,219
2011-05-31,8,Tuesday,Summer,1,Morning Rush,406,34,372
2011-05-31,9,Tuesday,Summer,1,Morning Rush,175,22,153
2011-05-31,10,Tuesday,Summer,1,Mid-Day,109,37,72
2011-05-31,11,Tuesday,Summer,1,Mid-Day,106,28,78
2011-05-31,12,Tuesday,Summer,1,Mid-Day,162,37,125
2011-05-31,13,Tuesday,Summer,1,Mid-Day,147,37,110
2011-05-31,14,Tuesday,Summer,1,Mid-Day,140,41,99
2011-05-31,15,Tuesday,Summer,1,Mid-Day,175,42,133
2011-05-31,16,Tuesday,Summer,1,Evening Rush,249,44,205
2011-05-31,17,Tuesday,Summer,1,Evening Rush,495,67,428
2011-05-31,18,Tuesday,Summer,1,Evening Rush,417,55,362
2011-05-31,19,Tuesday,Summer,1,Evening Rush,285,39,246
2011-05-31,20,Tuesday,Summer,1,Night,251,38,213
2011-05-31,21,Tuesday,Summer,1,Night,210,45,165
2011-05-31,22,Tuesday,Summer,1,Night,159,42,117
2011-05-31,23,Tuesday,Summer,1,Night,61,15,46
2011-06-01,0,Wednesday,Summer,1,Early Morning,34,9,25
2011-06-01,1,Wednesday,Summer,1,Early Morning,17,8,9
2011-06-01,2,Wednesday,Summer,1,Early Morning,3,0,3
2011-06-01,3,Wednesday,Summer,1,Early Morning,6,0,6
2011-06-01,4,Wednesday,Summer,2,Early Morning,4,0,4
2011-06-01,5,Wednesday,Summer,2,Early Morning,21,2,19
2011-06-01,6,Wednesday,Summer,2,Morning Rush,128,7,121
2011-06-01,7,Wednesday,Summer,2,Morning Rush,284,19,265
2011-06-01,8,Wednesday,Summer,2,Morning Rush,454,37,417
2011-06-01,9,Wednesday,Summer,2,Morning Rush,207,34,173
2011-06-01,10,Wednesday,Summer,2,Mid-Day,115,31,84
2011-06-01,11,Wednesday,Summer,2,Mid-Day,112,26,86
2011-06-01,12,Wednesday,Summer,1,Mid-Day,169,32,137
2011-06-01,13,Wednesday,Summer,1,Mid-Day,154,29,125
2011-06-01,14,Wednesday,Summer,1,Mid-Day,145,40,105
2011-06-01,15,Wednesday,Summer,1,Mid-Day,152,25,127
2011-06-01,16,Wednesday,Summer,1,Evening Rush,266,39,227
2011-06-01,17,Wednesday,Summer,1,Evening Rush,486,52,434
2011-06-01,18,Wednesday,Summer,3,Evening Rush,309,31,278
2011-06-01,19,Wednesday,Summer,2,Evening Rush,264,16,248
2011-06-01,20,Wednesday,Summer,2,Night,256,23,233
2011-06-01,21,Wednesday,Summer,1,Night,190,29,161
2011-06-01,22,Wednesday,Summer,1,Night,129,14,115
2011-06-01,23,Wednesday,Summer,1,Night,69,10,59
2011-06-02,0,Thursday,Summer,1,Early Morning,42,11,31
2011-06-02,1,Thursday,Summer,1,Early Morning,15,3,12
2011-06-02,2,Thursday,Summer,1,Early Morning,6,0,6
2011-06-02,3,Thursday,Summer,1,Early Morning,4,0,4
2011-06-02,4,Thursday,Summer,1,Early Morning,3,0,3
2011-06-02,5,Thursday,Summer,1,Early Morning,31,3,28
2011-06-02,6,Thursday,Summer,1,Morning Rush,113,7,106
2011-06-02,7,Thursday,Summer,1,Morning Rush,304,19,285
2011-06-02,8,Thursday,Summer,1,Morning Rush,467,25,442
2011-06-02,9,Thursday,Summer,1,Morning Rush,225,28,197
2011-06-02,10,Thursday,Summer,1,Mid-Day,139,33,106
2011-06-02,11,Thursday,Summer,1,Mid-Day,165,42,123
2011-06-02,12,Thursday,Summer,1,Mid-Day,232,39,193
2011-06-02,13,Thursday,Summer,1,Mid-Day,203,35,168
2011-06-02,14,Thursday,Summer,1,Mid-Day,185,43,142
2011-06-02,15,Thursday,Summer,1,Mid-Day,188,44,144
2011-06-02,16,Thursday,Summer,1,Evening Rush,318,63,255
2011-06-02,17,Thursday,Summer,1,Evening Rush,572,88,484
2011-06-02,18,Thursday,Summer,1,Evening Rush,525,74,451
2011-06-02,19,Thursday,Summer,1,Evening Rush,379,58,321
2011-06-02,20,Thursday,Summer,1,Night,337,51,286
2011-06-02,21,Thursday,Summer,1,Night,248,33,215
2011-06-02,22,Thursday,Summer,1,Night,155,14,141
2011-06-02,23,Thursday,Summer,1,Night,112,23,89
2011-06-03,0,Friday,Summer,1,Early Morning,68,15,53
2011-06-03,1,Friday,Summer,1,Early Morning,22,7,15
2011-06-03,2,Friday,Summer,1,Early Morning,12,0,12
2011-06-03,3,Friday,Summer,1,Early Morning,5,0,5
2011-06-03,4,Friday,Summer,1,Early Morning,6,1,5
2011-06-03,5,Friday,Summer,1,Early Morning,28,4,24
2011-06-03,6,Friday,Summer,1,Morning Rush,106,8,98
2011-06-03,7,Friday,Summer,1,Morning Rush,277,25,252
2011-06-03,8,Friday,Summer,2,Morning Rush,502,31,471
2011-06-03,9,Friday,Summer,1,Morning Rush,230,36,194
2011-06-03,10,Friday,Summer,1,Mid-Day,161,54,107
2011-06-03,11,Friday,Summer,1,Mid-Day,192,57,135
2011-06-03,12,Friday,Summer,1,Mid-Day,259,51,208
2011-06-03,13,Friday,Summer,1,Mid-Day,248,58,190
2011-06-03,14,Friday,Summer,1,Mid-Day,240,66,174
2011-06-03,15,Friday,Summer,1,Mid-Day,212,56,156
2011-06-03,16,Friday,Summer,1,Evening Rush,349,63,286
2011-06-03,17,Friday,Summer,1,Evening Rush,558,73,485
2011-06-03,18,Friday,Summer,1,Evening Rush,564,76,488
2011-06-03,19,Friday,Summer,1,Evening Rush,391,53,338
2011-06-03,20,Friday,Summer,1,Night,293,57,236
2011-06-03,21,Friday,Summer,1,Night,247,51,196
2011-06-03,22,Friday,Summer,1,Night,171,26,145
2011-06-03,23,Friday,Summer,1,Night,171,30,141
2011-06-04,0,Saturday,Summer,1,Early Morning,93,24,69
2011-06-04,1,Saturday,Summer,1,Early Morning,94,14,80
2011-06-04,2,Saturday,Summer,1,Early Morning,59,18,41
2011-06-04,3,Saturday,Summer,1,Early Morning,18,8,10
2011-06-04,4,Saturday,Summer,1,Early Morning,15,4,11
2011-06-04,5,Saturday,Summer,1,Early Morning,8,3,5
2011-06-04,6,Saturday,Summer,1,Morning Rush,28,11,17
2011-06-04,7,Saturday,Summer,1,Morning Rush,87,27,60
2011-06-04,8,Saturday,Summer,1,Morning Rush,125,29,96
2011-06-04,9,Saturday,Summer,1,Morning Rush,224,55,169
2011-06-04,10,Saturday,Summer,1,Mid-Day,317,115,202
2011-06-04,11,Saturday,Summer,1,Mid-Day,369,120,249
2011-06-04,12,Saturday,Summer,1,Mid-Day,420,150,270
2011-06-04,13,Saturday,Summer,1,Mid-Day,456,188,268
2011-06-04,14,Saturday,Summer,1,Mid-Day,451,193,258
2011-06-04,15,Saturday,Summer,2,Mid-Day,404,180,224
2011-06-04,16,Saturday,Summer,2,Evening Rush,440,168,272
2011-06-04,17,Saturday,Summer,2,Evening Rush,344,142,202
2011-06-04,18,Saturday,Summer,2,Evening Rush,341,127,214
2011-06-04,19,Saturday,Summer,2,Evening Rush,285,79,206
2011-06-04,20,Saturday,Summer,2,Night,239,90,149
2011-06-04,21,Saturday,Summer,2,Night,185,46,139
2011-06-04,22,Saturday,Summer,1,Night,190,49,141
2011-06-04,23,Saturday,Summer,2,Night,150,29,121
2011-06-05,0,Sunday,Summer,1,Early Morning,113,23,90
2011-06-05,1,Sunday,Summer,2,Early Morning,96,26,70
2011-06-05,2,Sunday,Summer,2,Early Morning,64,16,48
2011-06-05,3,Sunday,Summer,2,Early Morning,47,22,25
2011-06-05,4,Sunday,Summer,2,Early Morning,12,4,8
2011-06-05,5,Sunday,Summer,2,Early Morning,6,1,5
2011-06-05,6,Sunday,Summer,2,Morning Rush,21,10,11
2011-06-05,7,Sunday,Summer,2,Morning Rush,27,8,19
2011-06-05,8,Sunday,Summer,2,Morning Rush,98,24,74
2011-06-05,9,Sunday,Summer,2,Morning Rush,164,53,111
2011-06-05,10,Sunday,Summer,2,Mid-Day,251,83,168
2011-06-05,11,Sunday,Summer,2,Mid-Day,335,121,214
2011-06-05,12,Sunday,Summer,2,Mid-Day,335,123,212
2011-06-05,13,Sunday,Summer,1,Mid-Day,367,154,213
2011-06-05,14,Sunday,Summer,1,Mid-Day,385,161,224
2011-06-05,15,Sunday,Summer,1,Mid-Day,417,161,256
2011-06-05,16,Sunday,Summer,1,Evening Rush,398,138,260
2011-06-05,17,Sunday,Summer,1,Evening Rush,390,126,264
2011-06-05,18,Sunday,Summer,1,Evening Rush,363,124,239
2011-06-05,19,Sunday,Summer,1,Evening Rush,357,108,249
2011-06-05,20,Sunday,Summer,1,Night,279,84,195
2011-06-05,21,Sunday,Summer,1,Night,165,54,111
2011-06-05,22,Sunday,Summer,1,Night,130,36,94
2011-06-05,23,Sunday,Summer,1,Night,86,25,61
2011-06-06,0,Monday,Summer,1,Early Morning,29,11,18
2011-06-06,1,Monday,Summer,1,Early Morning,14,9,5
2011-06-06,2,Monday,Summer,1,Early Morning,8,4,4
2011-06-06,3,Monday,Summer,1,Early Morning,5,2,3
2011-06-06,4,Monday,Summer,1,Early Morning,8,4,4
2011-06-06,5,Monday,Summer,1,Early Morning,31,7,24
2011-06-06,6,Monday,Summer,1,Morning Rush,112,11,101
2011-06-06,7,Monday,Summer,1,Morning Rush,299,18,281
2011-06-06,8,Monday,Summer,1,Morning Rush,438,28,410
2011-06-06,9,Monday,Summer,1,Morning Rush,188,26,162
2011-06-06,10,Monday,Summer,1,Mid-Day,95,31,64
2011-06-06,11,Monday,Summer,1,Mid-Day,111,39,72
2011-06-06,12,Monday,Summer,1,Mid-Day,153,25,128
2011-06-06,13,Monday,Summer,1,Mid-Day,180,28,152
2011-06-06,14,Monday,Summer,1,Mid-Day,145,46,99
2011-06-06,15,Monday,Summer,1,Mid-Day,165,38,127
2011-06-06,16,Monday,Summer,1,Evening Rush,267,34,233
2011-06-06,17,Monday,Summer,1,Evening Rush,579,63,516
2011-06-06,18,Monday,Summer,1,Evening Rush,556,56,500
2011-06-06,19,Monday,Summer,1,Evening Rush,407,64,343
2011-06-06,20,Monday,Summer,1,Night,336,59,277
2011-06-06,21,Monday,Summer,1,Night,189,29,160
2011-06-06,22,Monday,Summer,1,Night,173,36,137
2011-06-06,23,Monday,Summer,1,Night,60,5,55
2011-06-07,0,Tuesday,Summer,1,Early Morning,20,5,15
2011-06-07,1,Tuesday,Summer,1,Early Morning,4,2,2
2011-06-07,2,Tuesday,Summer,1,Early Morning,5,3,2
2011-06-07,3,Tuesday,Summer,1,Early Morning,2,1,1
2011-06-07,4,Tuesday,Summer,1,Early Morning,5,2,3
2011-06-07,5,Tuesday,Summer,1,Early Morning,32,2,30
2011-06-07,6,Tuesday,Summer,1,Morning Rush,126,10,116
2011-06-07,7,Tuesday,Summer,2,Morning Rush,334,23,311
2011-06-07,8,Tuesday,Summer,2,Morning Rush,477,45,432
2011-06-07,9,Tuesday,Summer,2,Morning Rush,217,27,190
2011-06-07,10,Tuesday,Summer,2,Mid-Day,123,37,86
2011-06-07,11,Tuesday,Summer,2,Mid-Day,151,38,113
2011-06-07,12,Tuesday,Summer,2,Mid-Day,183,42,141
2011-06-07,13,Tuesday,Summer,2,Mid-Day,196,55,141
2011-06-07,14,Tuesday,Summer,2,Mid-Day,146,34,112
2011-06-07,15,Tuesday,Summer,2,Mid-Day,183,56,127
2011-06-07,16,Tuesday,Summer,1,Evening Rush,308,55,253
2011-06-07,17,Tuesday,Summer,1,Evening Rush,539,64,475
2011-06-07,18,Tuesday,Summer,1,Evening Rush,551,72,479
2011-06-07,19,Tuesday,Summer,1,Evening Rush,424,69,355
2011-06-07,20,Tuesday,Summer,1,Night,346,45,301
2011-06-07,21,Tuesday,Summer,1,Night,218,31,187
2011-06-07,22,Tuesday,Summer,1,Night,153,27,126
2011-06-07,23,Tuesday,Summer,1,Night,90,18,72
2011-06-08,0,Wednesday,Summer,1,Early Morning,41,12,29
2011-06-08,1,Wednesday,Summer,1,Early Morning,23,3,20
2011-06-08,2,Wednesday,Summer,1,Early Morning,7,0,7
2011-06-08,3,Wednesday,Summer,1,Early Morning,3,2,1
2011-06-08,4,Wednesday,Summer,1,Early Morning,6,0,6
2011-06-08,5,Wednesday,Summer,1,Early Morning,21,0,21
2011-06-08,6,Wednesday,Summer,1,Morning Rush,116,13,103
2011-06-08,7,Wednesday,Summer,1,Morning Rush,353,24,329
2011-06-08,8,Wednesday,Summer,1,Morning Rush,481,46,435
2011-06-08,9,Wednesday,Summer,1,Morning Rush,202,34,168
2011-06-08,10,Wednesday,Summer,1,Mid-Day,90,27,63
2011-06-08,11,Wednesday,Summer,1,Mid-Day,134,28,106
2011-06-08,12,Wednesday,Summer,1,Mid-Day,149,15,134
2011-06-08,13,Wednesday,Summer,1,Mid-Day,136,20,116
2011-06-08,14,Wednesday,Summer,1,Mid-Day,155,44,111
2011-06-08,15,Wednesday,Summer,1,Mid-Day,128,28,100
2011-06-08,16,Wednesday,Summer,1,Evening Rush,233,34,199
2011-06-08,17,Wednesday,Summer,1,Evening Rush,506,80,426
2011-06-08,18,Wednesday,Summer,1,Evening Rush,459,61,398
2011-06-08,19,Wednesday,Summer,1,Evening Rush,384,61,323
2011-06-08,20,Wednesday,Summer,1,Night,280,55,225
2011-06-08,21,Wednesday,Summer,1,Night,202,34,168
2011-06-08,22,Wednesday,Summer,1,Night,176,37,139
2011-06-08,23,Wednesday,Summer,1,Night,116,18,98
2011-06-09,0,Thursday,Summer,2,Early Morning,47,7,40
2011-06-09,1,Thursday,Summer,1,Early Morning,16,3,13
2011-06-09,2,Thursday,Summer,2,Early Morning,6,0,6
2011-06-09,3,Thursday,Summer,2,Early Morning,2,0,2
2011-06-09,4,Thursday,Summer,2,Early Morning,6,2,4
2011-06-09,5,Thursday,Summer,2,Early Morning,20,1,19
2011-06-09,6,Thursday,Summer,2,Morning Rush,118,13,105
2011-06-09,7,Thursday,Summer,2,Morning Rush,314,31,283
2011-06-09,8,Thursday,Summer,2,Morning Rush,432,32,400
2011-06-09,9,Thursday,Summer,1,Morning Rush,168,20,148
2011-06-09,10,Thursday,Summer,1,Mid-Day,94,20,74
2011-06-09,11,Thursday,Summer,1,Mid-Day,118,36,82
2011-06-09,12,Thursday,Summer,1,Mid-Day,140,40,100
2011-06-09,13,Thursday,Summer,1,Mid-Day,136,18,118
2011-06-09,14,Thursday,Summer,1,Mid-Day,118,25,93
2011-06-09,15,Thursday,Summer,1,Mid-Day,104,18,86
2011-06-09,16,Thursday,Summer,1,Evening Rush,200,30,170
2011-06-09,17,Thursday,Summer,1,Evening Rush,409,54,355
2011-06-09,18,Thursday,Summer,1,Evening Rush,466,52,414
2011-06-09,19,Thursday,Summer,2,Evening Rush,326,55,271
2011-06-09,20,Thursday,Summer,2,Night,254,40,214
2011-06-09,21,Thursday,Summer,3,Night,171,29,142
2011-06-09,22,Thursday,Summer,2,Night,153,22,131
2011-06-09,23,Thursday,Summer,2,Night,97,15,82
2011-06-10,0,Friday,Summer,3,Early Morning,69,8,61
2011-06-10,1,Friday,Summer,3,Early Morning,23,5,18
2011-06-10,2,Friday,Summer,1,Early Morning,13,6,7
2011-06-10,3,Friday,Summer,1,Early Morning,6,3,3
2011-06-10,4,Friday,Summer,1,Early Morning,4,0,4
2011-06-10,5,Friday,Summer,1,Early Morning,28,0,28
2011-06-10,6,Friday,Summer,1,Morning Rush,104,10,94
2011-06-10,7,Friday,Summer,1,Morning Rush,267,25,242
2011-06-10,8,Friday,Summer,1,Morning Rush,452,29,423
2011-06-10,9,Friday,Summer,1,Morning Rush,213,37,176
2011-06-10,10,Friday,Summer,1,Mid-Day,111,23,88
2011-06-10,11,Friday,Summer,1,Mid-Day,153,46,107
2011-06-10,12,Friday,Summer,1,Mid-Day,207,40,167
2011-06-10,13,Friday,Summer,1,Mid-Day,189,40,149
2011-06-10,14,Friday,Summer,1,Mid-Day,165,44,121
2011-06-10,15,Friday,Summer,1,Mid-Day,212,49,163
2011-06-10,16,Friday,Summer,1,Evening Rush,285,46,239
2011-06-10,17,Friday,Summer,1,Evening Rush,517,63,454
2011-06-10,18,Friday,Summer,1,Evening Rush,463,96,367
2011-06-10,19,Friday,Summer,1,Evening Rush,306,61,245
2011-06-10,20,Friday,Summer,1,Night,250,53,197
2011-06-10,21,Friday,Summer,1,Night,218,55,163
2011-06-10,22,Friday,Summer,1,Night,185,40,145
2011-06-10,23,Friday,Summer,1,Night,146,36,110
2011-06-11,0,Saturday,Summer,1,Early Morning,117,28,89
2011-06-11,1,Saturday,Summer,1,Early Morning,77,10,67
2011-06-11,2,Saturday,Summer,1,Early Morning,60,10,50
2011-06-11,3,Saturday,Summer,1,Early Morning,28,10,18
2011-06-11,4,Saturday,Summer,1,Early Morning,13,4,9
2011-06-11,5,Saturday,Summer,1,Early Morning,16,4,12
2011-06-11,6,Saturday,Summer,1,Morning Rush,40,9,31
2011-06-11,7,Saturday,Summer,1,Morning Rush,68,18,50
2011-06-11,8,Saturday,Summer,1,Morning Rush,143,32,111
2011-06-11,9,Saturday,Summer,1,Morning Rush,230,59,171
2011-06-11,10,Saturday,Summer,1,Mid-Day,264,91,173
2011-06-11,11,Saturday,Summer,1,Mid-Day,325,110,215
2011-06-11,12,Saturday,Summer,1,Mid-Day,347,112,235
2011-06-11,13,Saturday,Summer,1,Mid-Day,387,150,237
2011-06-11,14,Saturday,Summer,1,Mid-Day,380,148,232
2011-06-11,15,Saturday,Summer,1,Mid-Day,374,142,232
2011-06-11,16,Saturday,Summer,2,Evening Rush,394,169,225
2011-06-11,17,Saturday,Summer,2,Evening Rush,337,147,190
2011-06-11,18,Saturday,Summer,2,Evening Rush,286,131,155
2011-06-11,19,Saturday,Summer,1,Evening Rush,264,97,167
2011-06-11,20,Saturday,Summer,1,Night,275,95,180
2011-06-11,21,Saturday,Summer,1,Night,220,76,144
2011-06-11,22,Saturday,Summer,1,Night,190,53,137
2011-06-11,23,Saturday,Summer,1,Night,131,24,107
2011-06-12,0,Sunday,Summer,1,Early Morning,119,19,100
2011-06-12,1,Sunday,Summer,1,Early Morning,93,19,74
2011-06-12,2,Sunday,Summer,1,Early Morning,66,9,57
2011-06-12,3,Sunday,Summer,1,Early Morning,28,8,20
2011-06-12,4,Sunday,Summer,1,Early Morning,14,8,6
2011-06-12,5,Sunday,Summer,1,Early Morning,10,5,5
2011-06-12,6,Sunday,Summer,1,Morning Rush,14,5,9
2011-06-12,7,Sunday,Summer,1,Morning Rush,34,7,27
2011-06-12,8,Sunday,Summer,1,Morning Rush,92,28,64
2011-06-12,9,Sunday,Summer,1,Morning Rush,182,75,107
2011-06-12,10,Sunday,Summer,1,Mid-Day,311,120,191
2011-06-12,11,Sunday,Summer,1,Mid-Day,367,131,236
2011-06-12,12,Sunday,Summer,1,Mid-Day,420,176,244
2011-06-12,13,Sunday,Summer,1,Mid-Day,373,109,264
2011-06-12,14,Sunday,Summer,1,Mid-Day,315,96,219
2011-06-12,15,Sunday,Summer,1,Mid-Day,360,142,218
2011-06-12,16,Sunday,Summer,3,Evening Rush,350,115,235
2011-06-12,17,Sunday,Summer,3,Evening Rush,252,94,158
2011-06-12,18,Sunday,Summer,1,Evening Rush,256,69,187
2011-06-12,19,Sunday,Summer,1,Evening Rush,223,67,156
2011-06-12,20,Sunday,Summer,1,Night,206,62,144
2011-06-12,21,Sunday,Summer,1,Night,140,39,101
2011-06-12,22,Sunday,Summer,1,Night,128,31,97
2011-06-12,23,Sunday,Summer,1,Night,107,33,74
2011-06-13,0,Monday,Summer,1,Early Morning,28,8,20
2011-06-13,1,Monday,Summer,1,Early Morning,16,6,10
2011-06-13,2,Monday,Summer,1,Early Morning,10,2,8
2011-06-13,3,Monday,Summer,1,Early Morning,7,1,6
2011-06-13,4,Monday,Summer,1,Early Morning,4,1,3
2011-06-13,5,Monday,Summer,1,Early Morning,29,2,27
2011-06-13,6,Monday,Summer,1,Morning Rush,105,7,98
2011-06-13,7,Monday,Summer,1,Morning Rush,328,26,302
2011-06-13,8,Monday,Summer,1,Morning Rush,476,44,432
2011-06-13,9,Monday,Summer,1,Morning Rush,224,35,189
2011-06-13,10,Monday,Summer,1,Mid-Day,118,38,80
2011-06-13,11,Monday,Summer,1,Mid-Day,159,53,106
2011-06-13,12,Monday,Summer,1,Mid-Day,196,35,161
2011-06-13,13,Monday,Summer,1,Mid-Day,227,53,174
2011-06-13,14,Monday,Summer,1,Mid-Day,200,55,145
2011-06-13,15,Monday,Summer,1,Mid-Day,185,58,127
2011-06-13,16,Monday,Summer,1,Evening Rush,326,64,262
2011-06-13,17,Monday,Summer,1,Evening Rush,601,72,529
2011-06-13,18,Monday,Summer,1,Evening Rush,586,76,510
2011-06-13,19,Monday,Summer,1,Evening Rush,423,75,348
2011-06-13,20,Monday,Summer,1,Night,331,78,253
2011-06-13,21,Monday,Summer,1,Night,218,40,178
2011-06-13,22,Monday,Summer,1,Night,134,20,114
2011-06-13,23,Monday,Summer,1,Night,89,14,75
2011-06-14,0,Tuesday,Summer,1,Early Morning,31,13,18
2011-06-14,1,Tuesday,Summer,1,Early Morning,13,3,10
2011-06-14,2,Tuesday,Summer,1,Early Morning,10,2,8
2011-06-14,3,Tuesday,Summer,1,Early Morning,2,1,1
2011-06-14,4,Tuesday,Summer,1,Early Morning,3,0,3
2011-06-14,5,Tuesday,Summer,1,Early Morning,26,3,23
2011-06-14,6,Tuesday,Summer,1,Morning Rush,113,6,107
2011-06-14,7,Tuesday,Summer,1,Morning Rush,365,19,346
2011-06-14,8,Tuesday,Summer,1,Morning Rush,486,45,441
2011-06-14,9,Tuesday,Summer,1,Morning Rush,193,19,174
2011-06-14,10,Tuesday,Summer,1,Mid-Day,130,33,97
2011-06-14,11,Tuesday,Summer,1,Mid-Day,143,40,103
2011-06-14,12,Tuesday,Summer,1,Mid-Day,169,30,139
2011-06-14,13,Tuesday,Summer,1,Mid-Day,209,33,176
2011-06-14,14,Tuesday,Summer,2,Mid-Day,159,41,118
2011-06-14,15,Tuesday,Summer,1,Mid-Day,178,42,136
2011-06-14,16,Tuesday,Summer,1,Evening Rush,330,51,279
2011-06-14,17,Tuesday,Summer,3,Evening Rush,569,85,484
2011-06-14,18,Tuesday,Summer,1,Evening Rush,538,65,473
2011-06-14,19,Tuesday,Summer,1,Evening Rush,386,51,335
2011-06-14,20,Tuesday,Summer,1,Night,297,60,237
2011-06-14,21,Tuesday,Summer,1,Night,243,37,206
2011-06-14,22,Tuesday,Summer,1,Night,188,29,159
2011-06-14,23,Tuesday,Summer,1,Night,110,19,91
2011-06-15,0,Wednesday,Summer,1,Early Morning,52,8,44
2011-06-15,1,Wednesday,Summer,1,Early Morning,14,0,14
2011-06-15,2,Wednesday,Summer,1,Early Morning,9,0,9
2011-06-15,3,Wednesday,Summer,1,Early Morning,1,0,1
2011-06-15,4,Wednesday,Summer,1,Early Morning,4,0,4
2011-06-15,5,Wednesday,Summer,1,Early Morning,21,1,20
2011-06-15,6,Wednesday,Summer,1,Morning Rush,121,11,110
2011-06-15,7,Wednesday,Summer,1,Morning Rush,370,22,348
2011-06-15,8,Wednesday,Summer,1,Morning Rush,498,53,445
2011-06-15,9,Wednesday,Summer,1,Morning Rush,207,22,185
2011-06-15,10,Wednesday,Summer,1,Mid-Day,135,27,108
2011-06-15,11,Wednesday,Summer,1,Mid-Day,164,49,115
2011-06-15,12,Wednesday,Summer,1,Mid-Day,211,33,178
2011-06-15,13,Wednesday,Summer,1,Mid-Day,189,43,146
2011-06-15,14,Wednesday,Summer,1,Mid-Day,178,50,128
2011-06-15,15,Wednesday,Summer,1,Mid-Day,164,33,131
2011-06-15,16,Wednesday,Summer,1,Evening Rush,312,47,265
2011-06-15,17,Wednesday,Summer,1,Evening Rush,638,83,555
2011-06-15,18,Wednesday,Summer,1,Evening Rush,607,80,527
2011-06-15,19,Wednesday,Summer,1,Evening Rush,416,54,362
2011-06-15,20,Wednesday,Summer,1,Night,330,57,273
2011-06-15,21,Wednesday,Summer,1,Night,257,48,209
2011-06-15,22,Wednesday,Summer,1,Night,175,31,144
2011-06-15,23,Wednesday,Summer,1,Night,107,17,90
2011-06-16,0,Thursday,Summer,1,Early Morning,47,9,38
2011-06-16,1,Thursday,Summer,1,Early Morning,17,4,13
2011-06-16,2,Thursday,Summer,1,Early Morning,5,1,4
2011-06-16,3,Thursday,Summer,2,Early Morning,4,0,4
2011-06-16,4,Thursday,Summer,2,Early Morning,6,0,6
2011-06-16,5,Thursday,Summer,1,Early Morning,25,7,18
2011-06-16,6,Thursday,Summer,3,Morning Rush,112,8,104
2011-06-16,7,Thursday,Summer,3,Morning Rush,188,16,172
2011-06-16,8,Thursday,Summer,2,Morning Rush,388,24,364
2011-06-16,9,Thursday,Summer,2,Morning Rush,261,29,232
2011-06-16,10,Thursday,Summer,2,Mid-Day,121,18,103
2011-06-16,11,Thursday,Summer,2,Mid-Day,150,33,117
2011-06-16,12,Thursday,Summer,1,Mid-Day,206,41,165
2011-06-16,13,Thursday,Summer,2,Mid-Day,151,37,114
2011-06-16,14,Thursday,Summer,2,Mid-Day,153,39,114
2011-06-16,15,Thursday,Summer,2,Mid-Day,159,32,127
2011-06-16,16,Thursday,Summer,3,Evening Rush,294,36,258
2011-06-16,17,Thursday,Summer,2,Evening Rush,272,42,230
2011-06-16,18,Thursday,Summer,1,Evening Rush,325,26,299
2011-06-16,19,Thursday,Summer,1,Evening Rush,327,58,269
2011-06-16,20,Thursday,Summer,1,Night,201,25,176
2011-06-16,21,Thursday,Summer,3,Night,188,34,154
2011-06-16,22,Thursday,Summer,3,Night,151,24,127
2011-06-16,23,Thursday,Summer,3,Night,16,2,14
2011-06-17,0,Friday,Summer,1,Early Morning,24,3,21
2011-06-17,1,Friday,Summer,1,Early Morning,23,4,19
2011-06-17,2,Friday,Summer,1,Early Morning,13,2,11
2011-06-17,3,Friday,Summer,1,Early Morning,6,1,5
2011-06-17,4,Friday,Summer,1,Early Morning,6,1,5
2011-06-17,5,Friday,Summer,1,Early Morning,13,1,12
2011-06-17,6,Friday,Summer,1,Morning Rush,97,8,89
2011-06-17,7,Friday,Summer,1,Morning Rush,250,25,225
2011-06-17,8,Friday,Summer,2,Morning Rush,454,28,426
2011-06-17,9,Friday,Summer,1,Morning Rush,224,28,196
2011-06-17,10,Friday,Summer,1,Mid-Day,170,44,126
2011-06-17,11,Friday,Summer,1,Mid-Day,181,43,138
2011-06-17,12,Friday,Summer,1,Mid-Day,243,49,194
2011-06-17,13,Friday,Summer,1,Mid-Day,204,48,156
2011-06-17,14,Friday,Summer,1,Mid-Day,215,73,142
2011-06-17,15,Friday,Summer,1,Mid-Day,243,62,181
2011-06-17,16,Friday,Summer,1,Evening Rush,355,69,286
2011-06-17,17,Friday,Summer,3,Evening Rush,552,85,467
2011-06-17,18,Friday,Summer,3,Evening Rush,450,62,388
2011-06-17,19,Friday,Summer,3,Evening Rush,328,53,275
2011-06-17,20,Friday,Summer,1,Night,232,40,192
2011-06-17,21,Friday,Summer,1,Night,208,49,159
2011-06-17,22,Friday,Summer,1,Night,175,48,127
2011-06-17,23,Friday,Summer,1,Night,178,37,141
2011-06-18,0,Saturday,Summer,1,Early Morning,104,21,83
2011-06-18,1,Saturday,Summer,1,Early Morning,95,15,80
2011-06-18,2,Saturday,Summer,1,Early Morning,53,16,37
2011-06-18,3,Saturday,Summer,1,Early Morning,20,4,16
2011-06-18,4,Saturday,Summer,1,Early Morning,5,1,4
2011-06-18,5,Saturday,Summer,1,Early Morning,7,1,6
2011-06-18,6,Saturday,Summer,1,Morning Rush,27,9,18
2011-06-18,7,Saturday,Summer,1,Morning Rush,57,12,45
2011-06-18,8,Saturday,Summer,1,Morning Rush,131,28,103
2011-06-18,9,Saturday,Summer,1,Morning Rush,218,62,156
2011-06-18,10,Saturday,Summer,1,Mid-Day,244,68,176
2011-06-18,11,Saturday,Summer,1,Mid-Day,404,134,270
2011-06-18,12,Saturday,Summer,1,Mid-Day,420,162,258
2011-06-18,13,Saturday,Summer,1,Mid-Day,327,135,192
2011-06-18,14,Saturday,Summer,2,Mid-Day,334,138,196
2011-06-18,15,Saturday,Summer,2,Mid-Day,367,153,214
2011-06-18,16,Saturday,Summer,2,Evening Rush,468,193,275
2011-06-18,17,Saturday,Summer,2,Evening Rush,449,210,239
2011-06-18,18,Saturday,Summer,2,Evening Rush,381,118,263
2011-06-18,19,Saturday,Summer,2,Evening Rush,326,99,227
2011-06-18,20,Saturday,Summer,2,Night,188,61,127
2011-06-18,21,Saturday,Summer,2,Night,183,58,125
2011-06-18,22,Saturday,Summer,2,Night,161,56,105
2011-06-18,23,Saturday,Summer,2,Night,150,53,97
2011-06-19,0,Sunday,Summer,1,Early Morning,89,18,71
2011-06-19,1,Sunday,Summer,2,Early Morning,76,17,59
2011-06-19,2,Sunday,Summer,1,Early Morning,72,13,59
2011-06-19,3,Sunday,Summer,2,Early Morning,30,14,16
2011-06-19,4,Sunday,Summer,2,Early Morning,17,7,10
2011-06-19,5,Sunday,Summer,2,Early Morning,19,7,12
2011-06-19,6,Sunday,Summer,2,Morning Rush,33,11,22
2011-06-19,7,Sunday,Summer,2,Morning Rush,71,35,36
2011-06-19,8,Sunday,Summer,3,Morning Rush,84,25,59
2011-06-19,9,Sunday,Summer,2,Morning Rush,169,58,111
2011-06-19,10,Sunday,Summer,2,Mid-Day,244,86,158
2011-06-19,11,Sunday,Summer,2,Mid-Day,377,141,236
2011-06-19,12,Sunday,Summer,2,Mid-Day,396,141,255
2011-06-19,13,Sunday,Summer,2,Mid-Day,363,149,214
2011-06-19,14,Sunday,Summer,3,Mid-Day,317,124,193
2011-06-19,15,Sunday,Summer,2,Mid-Day,362,146,216
2011-06-19,16,Sunday,Summer,2,Evening Rush,378,121,257
2011-06-19,17,Sunday,Summer,1,Evening Rush,397,159,238
2011-06-19,18,Sunday,Summer,2,Evening Rush,296,78,218
2011-06-19,19,Sunday,Summer,1,Evening Rush,311,94,217
2011-06-19,20,Sunday,Summer,1,Night,232,86,146
2011-06-19,21,Sunday,Summer,1,Night,167,57,110
2011-06-19,22,Sunday,Summer,1,Night,152,38,114
2011-06-19,23,Sunday,Summer,1,Night,92,14,78
2011-06-20,0,Monday,Summer,1,Early Morning,26,7,19
2011-06-20,1,Monday,Summer,1,Early Morning,12,9,3
2011-06-20,2,Monday,Summer,1,Early Morning,2,2,0
2011-06-20,3,Monday,Summer,3,Early Morning,1,1,0
2011-06-20,4,Monday,Summer,3,Early Morning,3,1,2
2011-06-20,5,Monday,Summer,3,Early Morning,3,0,3
2011-06-20,6,Monday,Summer,3,Morning Rush,26,1,25
2011-06-20,7,Monday,Summer,3,Morning Rush,46,0,46
2011-06-20,8,Monday,Summer,3,Morning Rush,221,12,209
2011-06-20,9,Monday,Summer,2,Morning Rush,219,19,200
2011-06-20,10,Monday,Summer,2,Mid-Day,91,33,58
2011-06-20,11,Monday,Summer,2,Mid-Day,94,27,67
2011-06-20,12,Monday,Summer,2,Mid-Day,162,33,129
2011-06-20,13,Monday,Summer,1,Mid-Day,179,50,129
2011-06-20,14,Monday,Summer,1,Mid-Day,175,45,130
2011-06-20,15,Monday,Summer,1,Mid-Day,205,66,139
2011-06-20,16,Monday,Summer,1,Evening Rush,299,61,238
2011-06-20,17,Monday,Summer,1,Evening Rush,565,81,484
2011-06-20,18,Monday,Summer,1,Evening Rush,538,64,474
2011-06-20,19,Monday,Summer,1,Evening Rush,431,62,369
2011-06-20,20,Monday,Summer,1,Night,316,52,264
2011-06-20,21,Monday,Summer,1,Night,206,39,167
2011-06-20,22,Monday,Summer,2,Night,130,24,106
2011-06-20,23,Monday,Summer,1,Night,60,10,50
2011-06-21,0,Tuesday,Fall,1,Early Morning,33,10,23
2011-06-21,1,Tuesday,Fall,3,Early Morning,14,2,12
2011-06-21,2,Tuesday,Fall,3,Early Morning,6,1,5
2011-06-21,3,Tuesday,Fall,3,Early Morning,2,0,2
2011-06-21,4,Tuesday,Fall,2,Early Morning,9,2,7
2011-06-21,5,Tuesday,Fall,2,Early Morning,25,3,22
2011-06-21,6,Tuesday,Fall,2,Morning Rush,115,8,107
2011-06-21,7,Tuesday,Fall,2,Morning Rush,309,21,288
2011-06-21,8,Tuesday,Fall,2,Morning Rush,401,33,368
2011-06-21,9,Tuesday,Fall,2,Morning Rush,275,32,243
2011-06-21,10,Tuesday,Fall,2,Mid-Day,161,41,120
2011-06-21,11,Tuesday,Fall,1,Mid-Day,171,52,119
2011-06-21,12,Tuesday,Fall,1,Mid-Day,189,40,149
2011-06-21,13,Tuesday,Fall,1,Mid-Day,207,49,158
2011-06-21,14,Tuesday,Fall,1,Mid-Day,152,44,108
2011-06-21,15,Tuesday,Fall,1,Mid-Day,170,42,128
2011-06-21,16,Tuesday,Fall,1,Evening Rush,335,62,273
2011-06-21,17,Tuesday,Fall,1,Evening Rush,572,65,507
2011-06-21,18,Tuesday,Fall,2,Evening Rush,536,67,469
2011-06-21,19,Tuesday,Fall,2,Evening Rush,425,67,358
2011-06-21,20,Tuesday,Fall,3,Night,326,72,254
2011-06-21,21,Tuesday,Fall,1,Night,229,38,191
2011-06-21,22,Tuesday,Fall,1,Night,109,12,97
2011-06-21,23,Tuesday,Fall,1,Night,64,11,53
2011-06-22,0,Wednesday,Fall,1,Early Morning,33,15,18
2011-06-22,1,Wednesday,Fall,1,Early Morning,21,2,19
2011-06-22,2,Wednesday,Fall,1,Early Morning,7,2,5
2011-06-22,3,Wednesday,Fall,1,Early Morning,7,0,7
2011-06-22,4,Wednesday,Fall,1,Early Morning,11,3,8
2011-06-22,5,Wednesday,Fall,1,Early Morning,23,2,21
2011-06-22,6,Wednesday,Fall,1,Morning Rush,122,12,110
2011-06-22,7,Wednesday,Fall,1,Morning Rush,311,23,288
2011-06-22,8,Wednesday,Fall,1,Morning Rush,423,27,396
2011-06-22,9,Wednesday,Fall,1,Morning Rush,219,14,205
2011-06-22,10,Wednesday,Fall,1,Mid-Day,135,31,104
2011-06-22,11,Wednesday,Fall,1,Mid-Day,145,37,108
2011-06-22,12,Wednesday,Fall,2,Mid-Day,188,44,144
2011-06-22,13,Wednesday,Fall,2,Mid-Day,147,34,113
2011-06-22,14,Wednesday,Fall,2,Mid-Day,145,32,113
2011-06-22,15,Wednesday,Fall,2,Mid-Day,146,32,114
2011-06-22,16,Wednesday,Fall,2,Evening Rush,258,34,224
2011-06-22,17,Wednesday,Fall,2,Evening Rush,529,67,462
2011-06-22,18,Wednesday,Fall,2,Evening Rush,513,66,447
2011-06-22,19,Wednesday,Fall,2,Evening Rush,342,62,280
2011-06-22,20,Wednesday,Fall,1,Night,282,52,230
2011-06-22,21,Wednesday,Fall,1,Night,247,31,216
2011-06-22,22,Wednesday,Fall,2,Night,148,25,123
2011-06-22,23,Wednesday,Fall,2,Night,105,14,91
2011-06-23,0,Thursday,Fall,1,Early Morning,49,5,44
2011-06-23,1,Thursday,Fall,1,Early Morning,31,5,26
2011-06-23,2,Thursday,Fall,1,Early Morning,4,0,4
2011-06-23,3,Thursday,Fall,2,Early Morning,5,1,4
2011-06-23,4,Thursday,Fall,2,Early Morning,7,0,7
2011-06-23,5,Thursday,Fall,1,Early Morning,24,2,22
2011-06-23,6,Thursday,Fall,1,Morning Rush,100,8,92
2011-06-23,7,Thursday,Fall,2,Morning Rush,327,26,301
2011-06-23,8,Thursday,Fall,2,Morning Rush,432,20,412
2011-06-23,9,Thursday,Fall,2,Morning Rush,227,33,194
2011-06-23,10,Thursday,Fall,2,Mid-Day,127,39,88
2011-06-23,11,Thursday,Fall,3,Mid-Day,136,28,108
2011-06-23,12,Thursday,Fall,2,Mid-Day,160,30,130
2011-06-23,13,Thursday,Fall,2,Mid-Day,186,37,149
2011-06-23,14,Thursday,Fall,2,Mid-Day,149,46,103
2011-06-23,15,Thursday,Fall,2,Mid-Day,189,62,127
2011-06-23,16,Thursday,Fall,2,Evening Rush,275,58,217
2011-06-23,17,Thursday,Fall,2,Evening Rush,569,74,495
2011-06-23,18,Thursday,Fall,1,Evening Rush,540,57,483
2011-06-23,19,Thursday,Fall,1,Evening Rush,400,56,344
2011-06-23,20,Thursday,Fall,1,Night,352,75,277
2011-06-23,21,Thursday,Fall,1,Night,234,46,188
2011-06-23,22,Thursday,Fall,2,Night,162,23,139
2011-06-23,23,Thursday,Fall,1,Night,105,15,90
2011-06-24,0,Friday,Fall,1,Early Morning,63,10,53
2011-06-24,1,Friday,Fall,1,Early Morning,28,8,20
2011-06-24,2,Friday,Fall,1,Early Morning,14,4,10
2011-06-24,3,Friday,Fall,1,Early Morning,5,1,4
2011-06-24,4,Friday,Fall,1,Early Morning,9,1,8
2011-06-24,5,Friday,Fall,1,Early Morning,20,2,18
2011-06-24,6,Friday,Fall,1,Morning Rush,91,4,87
2011-06-24,7,Friday,Fall,2,Morning Rush,268,21,247
2011-06-24,8,Friday,Fall,1,Morning Rush,466,27,439
2011-06-24,9,Friday,Fall,1,Morning Rush,231,28,203
2011-06-24,10,Friday,Fall,1,Mid-Day,145,43,102
2011-06-24,11,Friday,Fall,1,Mid-Day,203,56,147
2011-06-24,12,Friday,Fall,1,Mid-Day,201,51,150
2011-06-24,13,Friday,Fall,1,Mid-Day,221,43,178
2011-06-24,14,Friday,Fall,1,Mid-Day,229,67,162
2011-06-24,15,Friday,Fall,1,Mid-Day,216,69,147
2011-06-24,16,Friday,Fall,1,Evening Rush,327,80,247
2011-06-24,17,Friday,Fall,1,Evening Rush,557,85,472
2011-06-24,18,Friday,Fall,1,Evening Rush,452,87,365
2011-06-24,19,Friday,Fall,1,Evening Rush,385,92,293
2011-06-24,20,Friday,Fall,1,Night,288,66,222
2011-06-24,21,Friday,Fall,1,Night,233,50,183
2011-06-24,22,Friday,Fall,1,Night,167,41,126
2011-06-24,23,Friday,Fall,1,Night,172,33,139
2011-06-25,0,Saturday,Fall,1,Early Morning,116,19,97
2011-06-25,1,Saturday,Fall,1,Early Morning,95,20,75
2011-06-25,2,Saturday,Fall,2,Early Morning,59,8,51
2011-06-25,3,Saturday,Fall,1,Early Morning,39,18,21
2011-06-25,4,Saturday,Fall,1,Early Morning,11,7,4
2011-06-25,5,Saturday,Fall,1,Early Morning,14,6,8
2011-06-25,6,Saturday,Fall,1,Morning Rush,29,12,17
2011-06-25,7,Saturday,Fall,1,Morning Rush,42,7,35
2011-06-25,8,Saturday,Fall,1,Morning Rush,112,27,85
2011-06-25,9,Saturday,Fall,1,Morning Rush,186,47,139
2011-06-25,10,Saturday,Fall,1,Mid-Day,302,99,203
2011-06-25,11,Saturday,Fall,1,Mid-Day,331,122,209
2011-06-25,12,Saturday,Fall,1,Mid-Day,392,140,252
2011-06-25,13,Saturday,Fall,1,Mid-Day,371,140,231
2011-06-25,14,Saturday,Fall,1,Mid-Day,383,151,232
2011-06-25,15,Saturday,Fall,1,Mid-Day,392,157,235
2011-06-25,16,Saturday,Fall,1,Evening Rush,410,175,235
2011-06-25,17,Saturday,Fall,1,Evening Rush,399,152,247
2011-06-25,18,Saturday,Fall,1,Evening Rush,307,108,199
2011-06-25,19,Saturday,Fall,1,Evening Rush,375,121,254
2011-06-25,20,Saturday,Fall,1,Night,269,74,195
2011-06-25,21,Saturday,Fall,1,Night,202,62,140
2011-06-25,22,Saturday,Fall,1,Night,187,61,126
2011-06-25,23,Saturday,Fall,2,Night,179,49,130
2011-06-26,0,Sunday,Fall,1,Early Morning,115,30,85
2011-06-26,1,Sunday,Fall,1,Early Morning,90,17,73
2011-06-26,2,Sunday,Fall,1,Early Morning,87,17,70
2011-06-26,3,Sunday,Fall,1,Early Morning,34,12,22
2011-06-26,4,Sunday,Fall,1,Early Morning,11,3,8
2011-06-26,5,Sunday,Fall,1,Early Morning,12,3,9
2011-06-26,6,Sunday,Fall,1,Morning Rush,20,7,13
2011-06-26,7,Sunday,Fall,1,Morning Rush,51,24,27
2011-06-26,8,Sunday,Fall,1,Morning Rush,107,29,78
2011-06-26,9,Sunday,Fall,1,Morning Rush,206,75,131
2011-06-26,10,Sunday,Fall,1,Mid-Day,332,136,196
2011-06-26,11,Sunday,Fall,1,Mid-Day,346,127,219
2011-06-26,12,Sunday,Fall,1,Mid-Day,443,175,268
2011-06-26,13,Sunday,Fall,1,Mid-Day,442,197,245
2011-06-26,14,Sunday,Fall,1,Mid-Day,443,197,246
2011-06-26,15,Sunday,Fall,1,Mid-Day,403,174,229
2011-06-26,16,Sunday,Fall,1,Evening Rush,455,177,278
2011-06-26,17,Sunday,Fall,2,Evening Rush,421,178,243
2011-06-26,18,Sunday,Fall,2,Evening Rush,382,117,265
2011-06-26,19,Sunday,Fall,2,Evening Rush,317,89,228
2011-06-26,20,Sunday,Fall,2,Night,213,55,158
2011-06-26,21,Sunday,Fall,2,Night,183,48,135
2011-06-26,22,Sunday,Fall,1,Night,114,19,95
2011-06-26,23,Sunday,Fall,1,Night,78,14,64
2011-06-27,0,Monday,Fall,3,Early Morning,32,7,25
2011-06-27,1,Monday,Fall,2,Early Morning,15,4,11
2011-06-27,2,Monday,Fall,3,Early Morning,6,3,3
2011-06-27,3,Monday,Fall,3,Early Morning,2,0,2
2011-06-27,4,Monday,Fall,2,Early Morning,9,1,8
2011-06-27,5,Monday,Fall,2,Early Morning,22,1,21
2011-06-27,6,Monday,Fall,2,Morning Rush,94,4,90
2011-06-27,7,Monday,Fall,2,Morning Rush,261,14,247
2011-06-27,8,Monday,Fall,1,Morning Rush,447,29,418
2011-06-27,9,Monday,Fall,2,Morning Rush,187,37,150
2011-06-27,10,Monday,Fall,2,Mid-Day,150,55,95
2011-06-27,11,Monday,Fall,2,Mid-Day,150,55,95
2011-06-27,12,Monday,Fall,2,Mid-Day,170,40,130
2011-06-27,13,Monday,Fall,2,Mid-Day,164,37,127
2011-06-27,14,Monday,Fall,2,Mid-Day,158,58,100
2011-06-27,15,Monday,Fall,2,Mid-Day,202,76,126
2011-06-27,16,Monday,Fall,1,Evening Rush,275,53,222
2011-06-27,17,Monday,Fall,1,Evening Rush,604,90,514
2011-06-27,18,Monday,Fall,1,Evening Rush,591,79,512
2011-06-27,19,Monday,Fall,1,Evening Rush,396,56,340
2011-06-27,20,Monday,Fall,1,Night,305,54,251
2011-06-27,21,Monday,Fall,1,Night,242,52,190
2011-06-27,22,Monday,Fall,1,Night,145,33,112
2011-06-27,23,Monday,Fall,1,Night,81,16,65
2011-06-28,0,Tuesday,Fall,2,Early Morning,30,5,25
2011-06-28,1,Tuesday,Fall,1,Early Morning,13,5,8
2011-06-28,2,Tuesday,Fall,2,Early Morning,11,2,9
2011-06-28,3,Tuesday,Fall,2,Early Morning,2,0,2
2011-06-28,4,Tuesday,Fall,1,Early Morning,8,1,7
2011-06-28,5,Tuesday,Fall,1,Early Morning,21,1,20
2011-06-28,6,Tuesday,Fall,1,Morning Rush,124,7,117
2011-06-28,7,Tuesday,Fall,1,Morning Rush,347,27,320
2011-06-28,8,Tuesday,Fall,1,Morning Rush,456,39,417
2011-06-28,9,Tuesday,Fall,1,Morning Rush,246,38,208
2011-06-28,10,Tuesday,Fall,1,Mid-Day,157,45,112
2011-06-28,11,Tuesday,Fall,1,Mid-Day,167,49,118
2011-06-28,12,Tuesday,Fall,1,Mid-Day,202,41,161
2011-06-28,13,Tuesday,Fall,1,Mid-Day,189,33,156
2011-06-28,14,Tuesday,Fall,1,Mid-Day,160,43,117
2011-06-28,15,Tuesday,Fall,1,Mid-Day,166,39,127
2011-06-28,16,Tuesday,Fall,1,Evening Rush,261,41,220
2011-06-28,17,Tuesday,Fall,3,Evening Rush,579,70,509
2011-06-28,18,Tuesday,Fall,3,Evening Rush,504,68,436
2011-06-28,19,Tuesday,Fall,2,Evening Rush,299,44,255
2011-06-28,20,Tuesday,Fall,1,Night,296,50,246
2011-06-28,21,Tuesday,Fall,1,Night,195,31,164
2011-06-28,22,Tuesday,Fall,1,Night,134,30,104
2011-06-28,23,Tuesday,Fall,1,Night,81,23,58
2011-06-29,0,Wednesday,Fall,2,Early Morning,36,11,25
2011-06-29,1,Wednesday,Fall,1,Early Morning,28,10,18
2011-06-29,2,Wednesday,Fall,1,Early Morning,16,7,9
2011-06-29,3,Wednesday,Fall,2,Early Morning,5,2,3
2011-06-29,4,Wednesday,Fall,1,Early Morning,5,0,5
2011-06-29,5,Wednesday,Fall,1,Early Morning,22,3,19
2011-06-29,6,Wednesday,Fall,1,Morning Rush,116,12,104
2011-06-29,7,Wednesday,Fall,1,Morning Rush,336,18,318
2011-06-29,8,Wednesday,Fall,1,Morning Rush,540,41,499
2011-06-29,9,Wednesday,Fall,1,Morning Rush,221,32,189
2011-06-29,10,Wednesday,Fall,1,Mid-Day,126,31,95
2011-06-29,11,Wednesday,Fall,1,Mid-Day,170,53,117
2011-06-29,12,Wednesday,Fall,1,Mid-Day,243,55,188
2011-06-29,13,Wednesday,Fall,1,Mid-Day,231,45,186
2011-06-29,14,Wednesday,Fall,1,Mid-Day,188,50,138
2011-06-29,15,Wednesday,Fall,1,Mid-Day,189,43,146
2011-06-29,16,Wednesday,Fall,1,Evening Rush,328,60,268
2011-06-29,17,Wednesday,Fall,1,Evening Rush,570,78,492
2011-06-29,18,Wednesday,Fall,1,Evening Rush,588,78,510
2011-06-29,19,Wednesday,Fall,1,Evening Rush,401,60,341
2011-06-29,20,Wednesday,Fall,1,Night,333,69,264
2011-06-29,21,Wednesday,Fall,1,Night,221,26,195
2011-06-29,22,Wednesday,Fall,1,Night,183,32,151
2011-06-29,23,Wednesday,Fall,1,Night,129,32,97
2011-06-30,0,Thursday,Fall,1,Early Morning,54,15,39
2011-06-30,1,Thursday,Fall,1,Early Morning,32,13,19
2011-06-30,2,Thursday,Fall,1,Early Morning,8,2,6
2011-06-30,3,Thursday,Fall,1,Early Morning,9,2,7
2011-06-30,4,Thursday,Fall,1,Early Morning,6,2,4
2011-06-30,5,Thursday,Fall,1,Early Morning,25,1,24
2011-06-30,6,Thursday,Fall,1,Morning Rush,123,4,119
2011-06-30,7,Thursday,Fall,1,Morning Rush,320,29,291
2011-06-30,8,Thursday,Fall,1,Morning Rush,555,44,511
2011-06-30,9,Thursday,Fall,1,Morning Rush,260,33,227
2011-06-30,10,Thursday,Fall,1,Mid-Day,132,35,97
2011-06-30,11,Thursday,Fall,1,Mid-Day,169,47,122
2011-06-30,12,Thursday,Fall,1,Mid-Day,233,50,183
2011-06-30,13,Thursday,Fall,1,Mid-Day,232,70,162
2011-06-30,14,Thursday,Fall,1,Mid-Day,163,46,117
2011-06-30,15,Thursday,Fall,1,Mid-Day,240,64,176
2011-06-30,16,Thursday,Fall,1,Evening Rush,323,63,260
2011-06-30,17,Thursday,Fall,1,Evening Rush,594,98,496
2011-06-30,18,Thursday,Fall,1,Evening Rush,586,114,472
2011-06-30,19,Thursday,Fall,1,Evening Rush,455,89,366
2011-06-30,20,Thursday,Fall,1,Night,340,55,285
2011-06-30,21,Thursday,Fall,1,Night,323,81,242
2011-06-30,22,Thursday,Fall,1,Night,207,43,164
2011-06-30,23,Thursday,Fall,1,Night,126,27,99
2011-07-01,0,Friday,Fall,1,Early Morning,68,20,48
2011-07-01,1,Friday,Fall,1,Early Morning,31,15,16
2011-07-01,2,Friday,Fall,1,Early Morning,13,6,7
2011-07-01,3,Friday,Fall,1,Early Morning,11,5,6
2011-07-01,4,Friday,Fall,1,Early Morning,6,1,5
2011-07-01,5,Friday,Fall,1,Early Morning,30,3,27
2011-07-01,6,Friday,Fall,1,Morning Rush,108,11,97
2011-07-01,7,Friday,Fall,1,Morning Rush,243,25,218
2011-07-01,8,Friday,Fall,1,Morning Rush,492,39,453
2011-07-01,9,Friday,Fall,1,Morning Rush,260,58,202
2011-07-01,10,Friday,Fall,1,Mid-Day,170,61,109
2011-07-01,11,Friday,Fall,1,Mid-Day,214,68,146
2011-07-01,12,Friday,Fall,1,Mid-Day,263,83,180
2011-07-01,13,Friday,Fall,1,Mid-Day,292,83,209
2011-07-01,14,Friday,Fall,1,Mid-Day,303,78,225
2011-07-01,15,Friday,Fall,1,Mid-Day,381,82,299
2011-07-01,16,Friday,Fall,1,Evening Rush,427,85,342
2011-07-01,17,Friday,Fall,1,Evening Rush,461,99,362
2011-07-01,18,Friday,Fall,1,Evening Rush,422,98,324
2011-07-01,19,Friday,Fall,1,Evening Rush,318,80,238
2011-07-01,20,Friday,Fall,1,Night,269,84,185
2011-07-01,21,Friday,Fall,1,Night,218,69,149
2011-07-01,22,Friday,Fall,1,Night,222,49,173
2011-07-01,23,Friday,Fall,1,Night,140,44,96
2011-07-02,0,Saturday,Fall,1,Early Morning,115,31,84
2011-07-02,1,Saturday,Fall,1,Early Morning,78,20,58
2011-07-02,2,Saturday,Fall,1,Early Morning,52,9,43
2011-07-02,3,Saturday,Fall,1,Early Morning,26,5,21
2011-07-02,4,Saturday,Fall,1,Early Morning,11,3,8
2011-07-02,5,Saturday,Fall,1,Early Morning,14,1,13
2011-07-02,6,Saturday,Fall,1,Morning Rush,32,11,21
2011-07-02,7,Saturday,Fall,1,Morning Rush,45,10,35
2011-07-02,8,Saturday,Fall,1,Morning Rush,132,38,94
2011-07-02,9,Saturday,Fall,1,Morning Rush,179,55,124
2011-07-02,10,Saturday,Fall,1,Mid-Day,271,103,168
2011-07-02,11,Saturday,Fall,1,Mid-Day,357,144,213
2011-07-02,12,Saturday,Fall,1,Mid-Day,374,142,232
2011-07-02,13,Saturday,Fall,1,Mid-Day,404,178,226
2011-07-02,14,Saturday,Fall,1,Mid-Day,392,177,215
2011-07-02,15,Saturday,Fall,1,Mid-Day,331,168,163
2011-07-02,16,Saturday,Fall,1,Evening Rush,398,206,192
2011-07-02,17,Saturday,Fall,1,Evening Rush,349,179,170
2011-07-02,18,Saturday,Fall,1,Evening Rush,383,193,190
2011-07-02,19,Saturday,Fall,1,Evening Rush,305,156,149
2011-07-02,20,Saturday,Fall,1,Night,284,136,148
2011-07-02,21,Saturday,Fall,1,Night,232,95,137
2011-07-02,22,Saturday,Fall,1,Night,201,78,123
2011-07-02,23,Saturday,Fall,1,Night,154,66,88
2011-07-03,0,Sunday,Fall,1,Early Morning,144,47,97
2011-07-03,1,Sunday,Fall,2,Early Morning,78,23,55
2011-07-03,2,Sunday,Fall,1,Early Morning,69,19,50
2011-07-03,3,Sunday,Fall,3,Early Morning,33,8,25
2011-07-03,4,Sunday,Fall,3,Early Morning,5,3,2
2011-07-03,5,Sunday,Fall,3,Early Morning,1,0,1
2011-07-03,6,Sunday,Fall,2,Morning Rush,3,0,3
2011-07-03,7,Sunday,Fall,2,Morning Rush,25,3,22
2011-07-03,8,Sunday,Fall,1,Morning Rush,92,39,53
2011-07-03,9,Sunday,Fall,1,Morning Rush,181,82,99
2011-07-03,10,Sunday,Fall,1,Mid-Day,264,131,133
2011-07-03,11,Sunday,Fall,1,Mid-Day,390,215,175
2011-07-03,12,Sunday,Fall,1,Mid-Day,404,198,206
2011-07-03,13,Sunday,Fall,1,Mid-Day,421,248,173
2011-07-03,14,Sunday,Fall,1,Mid-Day,375,225,150
2011-07-03,15,Sunday,Fall,1,Mid-Day,376,194,182
2011-07-03,16,Sunday,Fall,1,Evening Rush,414,195,219
2011-07-03,17,Sunday,Fall,3,Evening Rush,358,181,177
2011-07-03,18,Sunday,Fall,3,Evening Rush,181,74,107
2011-07-03,19,Sunday,Fall,2,Evening Rush,183,100,83
2011-07-03,20,Sunday,Fall,3,Night,176,83,93
2011-07-03,21,Sunday,Fall,2,Night,167,75,92
2011-07-03,22,Sunday,Fall,2,Night,162,69,93
2011-07-03,23,Sunday,Fall,1,Night,147,70,77
2011-07-04,0,Monday,Fall,1,Early Morning,140,63,77
2011-07-04,1,Monday,Fall,1,Early Morning,119,43,76
2011-07-04,2,Monday,Fall,1,Early Morning,63,33,30
2011-07-04,3,Monday,Fall,1,Early Morning,26,13,13
2011-07-04,4,Monday,Fall,2,Early Morning,12,8,4
2011-07-04,5,Monday,Fall,2,Early Morning,4,1,3
2011-07-04,6,Monday,Fall,1,Morning Rush,16,5,11
2011-07-04,7,Monday,Fall,1,Morning Rush,36,17,19
2011-07-04,8,Monday,Fall,1,Morning Rush,86,42,44
2011-07-04,9,Monday,Fall,2,Morning Rush,238,142,96
2011-07-04,10,Monday,Fall,2,Mid-Day,280,166,114
2011-07-04,11,Monday,Fall,2,Mid-Day,349,177,172
2011-07-04,12,Monday,Fall,2,Mid-Day,447,237,210
2011-07-04,13,Monday,Fall,2,Mid-Day,423,242,181
2011-07-04,14,Monday,Fall,1,Mid-Day,408,235,173
2011-07-04,15,Monday,Fall,1,Mid-Day,408,224,184
2011-07-04,16,Monday,Fall,1,Evening Rush,452,236,216
2011-07-04,17,Monday,Fall,1,Evening Rush,436,240,196
2011-07-04,18,Monday,Fall,1,Evening Rush,418,222,196
2011-07-04,19,Monday,Fall,2,Evening Rush,375,170,205
2011-07-04,20,Monday,Fall,2,Night,386,195,191
2011-07-04,21,Monday,Fall,2,Night,457,195,262
2011-07-04,22,Monday,Fall,2,Night,326,115,211
2011-07-04,23,Monday,Fall,2,Night,138,44,94
2011-07-05,0,Tuesday,Fall,2,Early Morning,55,19,36
2011-07-05,1,Tuesday,Fall,1,Early Morning,39,15,24
2011-07-05,2,Tuesday,Fall,1,Early Morning,13,8,5
2011-07-05,3,Tuesday,Fall,1,Early Morning,8,1,7
2011-07-05,4,Tuesday,Fall,1,Early Morning,5,1,4
2011-07-05,5,Tuesday,Fall,1,Early Morning,20,1,19
2011-07-05,6,Tuesday,Fall,1,Morning Rush,94,3,91
2011-07-05,7,Tuesday,Fall,1,Morning Rush,270,22,248
2011-07-05,8,Tuesday,Fall,1,Morning Rush,432,41,391
2011-07-05,9,Tuesday,Fall,1,Morning Rush,227,50,177
2011-07-05,10,Tuesday,Fall,1,Mid-Day,139,55,84
2011-07-05,11,Tuesday,Fall,1,Mid-Day,172,75,97
2011-07-05,12,Tuesday,Fall,1,Mid-Day,201,71,130
2011-07-05,13,Tuesday,Fall,1,Mid-Day,203,67,136
2011-07-05,14,Tuesday,Fall,1,Mid-Day,178,66,112
2011-07-05,15,Tuesday,Fall,1,Mid-Day,162,51,111
2011-07-05,16,Tuesday,Fall,1,Evening Rush,281,79,202
2011-07-05,17,Tuesday,Fall,1,Evening Rush,545,79,466
2011-07-05,18,Tuesday,Fall,1,Evening Rush,496,70,426
2011-07-05,19,Tuesday,Fall,1,Evening Rush,368,71,297
2011-07-05,20,Tuesday,Fall,1,Night,284,59,225
2011-07-05,21,Tuesday,Fall,1,Night,245,77,168
2011-07-05,22,Tuesday,Fall,1,Night,155,31,124
2011-07-05,23,Tuesday,Fall,1,Night,73,19,54
2011-07-06,0,Wednesday,Fall,1,Early Morning,37,11,26
2011-07-06,1,Wednesday,Fall,1,Early Morning,15,4,11
2011-07-06,2,Wednesday,Fall,1,Early Morning,5,1,4
2011-07-06,3,Wednesday,Fall,1,Early Morning,6,0,6
2011-07-06,4,Wednesday,Fall,2,Early Morning,6,0,6
2011-07-06,5,Wednesday,Fall,1,Early Morning,35,5,30
2011-07-06,6,Wednesday,Fall,1,Morning Rush,121,9,112
2011-07-06,7,Wednesday,Fall,2,Morning Rush,312,24,288
2011-07-06,8,Wednesday,Fall,2,Morning Rush,428,31,397
2011-07-06,9,Wednesday,Fall,3,Morning Rush,189,31,158
2011-07-06,10,Wednesday,Fall,3,Mid-Day,43,13,30
2011-07-06,11,Wednesday,Fall,2,Mid-Day,127,24,103
2011-07-06,12,Wednesday,Fall,2,Mid-Day,152,38,114
2011-07-06,13,Wednesday,Fall,2,Mid-Day,140,33,107
2011-07-06,14,Wednesday,Fall,1,Mid-Day,163,50,113
2011-07-06,15,Wednesday,Fall,1,Mid-Day,185,55,130
2011-07-06,16,Wednesday,Fall,1,Evening Rush,275,57,218
2011-07-06,17,Wednesday,Fall,1,Evening Rush,596,79,517
2011-07-06,18,Wednesday,Fall,1,Evening Rush,563,77,486
2011-07-06,19,Wednesday,Fall,1,Evening Rush,394,71,323
2011-07-06,20,Wednesday,Fall,1,Night,312,55,257
2011-07-06,21,Wednesday,Fall,1,Night,241,66,175
2011-07-06,22,Wednesday,Fall,1,Night,186,30,156
2011-07-06,23,Wednesday,Fall,1,Night,98,20,78
2011-07-07,0,Thursday,Fall,1,Early Morning,35,6,29
2011-07-07,1,Thursday,Fall,1,Early Morning,16,2,14
2011-07-07,2,Thursday,Fall,1,Early Morning,8,1,7
2011-07-07,3,Thursday,Fall,1,Early Morning,4,2,2
2011-07-07,4,Thursday,Fall,1,Early Morning,4,0,4
2011-07-07,5,Thursday,Fall,1,Early Morning,32,2,30
2011-07-07,6,Thursday,Fall,2,Morning Rush,118,11,107
2011-07-07,7,Thursday,Fall,2,Morning Rush,292,13,279
2011-07-07,8,Thursday,Fall,2,Morning Rush,443,28,415
2011-07-07,9,Thursday,Fall,1,Morning Rush,179,25,154
2011-07-07,10,Thursday,Fall,1,Mid-Day,101,29,72
2011-07-07,11,Thursday,Fall,1,Mid-Day,142,30,112
2011-07-07,12,Thursday,Fall,1,Mid-Day,171,32,139
2011-07-07,13,Thursday,Fall,1,Mid-Day,155,48,107
2011-07-07,14,Thursday,Fall,1,Mid-Day,160,39,121
2011-07-07,15,Thursday,Fall,1,Mid-Day,166,47,119
2011-07-07,16,Thursday,Fall,1,Evening Rush,265,47,218
2011-07-07,17,Thursday,Fall,1,Evening Rush,569,80,489
2011-07-07,18,Thursday,Fall,1,Evening Rush,562,70,492
2011-07-07,19,Thursday,Fall,1,Evening Rush,365,79,286
2011-07-07,20,Thursday,Fall,1,Night,285,61,224
2011-07-07,21,Thursday,Fall,1,Night,209,39,170
2011-07-07,22,Thursday,Fall,1,Night,182,32,150
2011-07-07,23,Thursday,Fall,1,Night,129,31,98
2011-07-08,0,Friday,Fall,1,Early Morning,47,6,41
2011-07-08,1,Friday,Fall,1,Early Morning,34,9,25
2011-07-08,2,Friday,Fall,2,Early Morning,22,10,12
2011-07-08,3,Friday,Fall,1,Early Morning,6,2,4
2011-07-08,4,Friday,Fall,1,Early Morning,11,7,4
2011-07-08,5,Friday,Fall,1,Early Morning,27,3,24
2011-07-08,6,Friday,Fall,1,Morning Rush,102,11,91
2011-07-08,7,Friday,Fall,2,Morning Rush,332,30,302
2011-07-08,8,Friday,Fall,2,Morning Rush,457,36,421
2011-07-08,9,Friday,Fall,2,Morning Rush,241,30,211
2011-07-08,10,Friday,Fall,2,Mid-Day,138,30,108
2011-07-08,11,Friday,Fall,2,Mid-Day,165,61,104
2011-07-08,12,Friday,Fall,2,Mid-Day,213,49,164
2011-07-08,13,Friday,Fall,2,Mid-Day,229,54,175
2011-07-08,14,Friday,Fall,2,Mid-Day,216,53,163
2011-07-08,15,Friday,Fall,2,Mid-Day,141,39,102
2011-07-08,16,Friday,Fall,3,Evening Rush,132,27,105
2011-07-08,17,Friday,Fall,3,Evening Rush,167,6,161
2011-07-08,18,Friday,Fall,1,Evening Rush,316,35,281
2011-07-08,19,Friday,Fall,1,Evening Rush,270,45,225
2011-07-08,20,Friday,Fall,1,Night,250,30,220
2011-07-08,21,Friday,Fall,2,Night,204,46,158
2011-07-08,22,Friday,Fall,2,Night,169,33,136
2011-07-08,23,Friday,Fall,2,Night,151,40,111
2011-07-09,0,Saturday,Fall,2,Early Morning,121,31,90
2011-07-09,1,Saturday,Fall,2,Early Morning,53,5,48
2011-07-09,2,Saturday,Fall,1,Early Morning,55,12,43
2011-07-09,3,Saturday,Fall,1,Early Morning,30,7,23
2011-07-09,4,Saturday,Fall,1,Early Morning,6,2,4
2011-07-09,5,Saturday,Fall,2,Early Morning,15,4,11
2011-07-09,6,Saturday,Fall,2,Morning Rush,38,11,27
2011-07-09,7,Saturday,Fall,1,Morning Rush,71,21,50
2011-07-09,8,Saturday,Fall,1,Morning Rush,182,68,114
2011-07-09,9,Saturday,Fall,1,Morning Rush,247,77,170
2011-07-09,10,Saturday,Fall,1,Mid-Day,264,87,177
2011-07-09,11,Saturday,Fall,1,Mid-Day,290,101,189
2011-07-09,12,Saturday,Fall,1,Mid-Day,366,145,221
2011-07-09,13,Saturday,Fall,1,Mid-Day,416,167,249
2011-07-09,14,Saturday,Fall,1,Mid-Day,373,158,215
2011-07-09,15,Saturday,Fall,1,Mid-Day,402,182,220
2011-07-09,16,Saturday,Fall,1,Evening Rush,416,171,245
2011-07-09,17,Saturday,Fall,1,Evening Rush,401,160,241
2011-07-09,18,Saturday,Fall,1,Evening Rush,378,132,246
2011-07-09,19,Saturday,Fall,1,Evening Rush,306,128,178
2011-07-09,20,Saturday,Fall,1,Night,314,129,185
2011-07-09,21,Saturday,Fall,1,Night,238,83,155
2011-07-09,22,Saturday,Fall,1,Night,214,60,154
2011-07-09,23,Saturday,Fall,1,Night,140,47,93
2011-07-10,0,Sunday,Fall,1,Early Morning,154,42,112
2011-07-10,1,Sunday,Fall,1,Early Morning,113,19,94
2011-07-10,2,Sunday,Fall,1,Early Morning,96,28,68
2011-07-10,3,Sunday,Fall,1,Early Morning,25,6,19
2011-07-10,4,Sunday,Fall,1,Early Morning,5,0,5
2011-07-10,5,Sunday,Fall,1,Early Morning,17,7,10
2011-07-10,6,Sunday,Fall,1,Morning Rush,25,8,17
2011-07-10,7,Sunday,Fall,1,Morning Rush,65,27,38
2011-07-10,8,Sunday,Fall,1,Morning Rush,92,27,65
2011-07-10,9,Sunday,Fall,1,Morning Rush,169,62,107
2011-07-10,10,Sunday,Fall,1,Mid-Day,268,95,173
2011-07-10,11,Sunday,Fall,1,Mid-Day,287,110,177
2011-07-10,12,Sunday,Fall,1,Mid-Day,377,133,244
2011-07-10,13,Sunday,Fall,1,Mid-Day,367,139,228
2011-07-10,14,Sunday,Fall,1,Mid-Day,349,122,227
2011-07-10,15,Sunday,Fall,1,Mid-Day,361,142,219
2011-07-10,16,Sunday,Fall,1,Evening Rush,372,128,244
2011-07-10,17,Sunday,Fall,1,Evening Rush,363,146,217
2011-07-10,18,Sunday,Fall,1,Evening Rush,363,141,222
2011-07-10,19,Sunday,Fall,1,Evening Rush,303,120,183
2011-07-10,20,Sunday,Fall,1,Night,268,101,167
2011-07-10,21,Sunday,Fall,1,Night,227,65,162
2011-07-10,22,Sunday,Fall,1,Night,143,56,87
2011-07-10,23,Sunday,Fall,1,Night,72,19,53
2011-07-11,0,Monday,Fall,1,Early Morning,35,10,25
2011-07-11,1,Monday,Fall,1,Early Morning,10,5,5
2011-07-11,2,Monday,Fall,1,Early Morning,12,8,4
2011-07-11,3,Monday,Fall,1,Early Morning,10,2,8
2011-07-11,4,Monday,Fall,1,Early Morning,4,0,4
2011-07-11,5,Monday,Fall,1,Early Morning,26,5,21
2011-07-11,6,Monday,Fall,1,Morning Rush,121,19,102
2011-07-11,7,Monday,Fall,1,Morning Rush,317,28,289
2011-07-11,8,Monday,Fall,1,Morning Rush,420,35,385
2011-07-11,9,Monday,Fall,1,Morning Rush,208,41,167
2011-07-11,10,Monday,Fall,1,Mid-Day,117,44,73
2011-07-11,11,Monday,Fall,1,Mid-Day,128,39,89
2011-07-11,12,Monday,Fall,1,Mid-Day,148,40,108
2011-07-11,13,Monday,Fall,1,Mid-Day,141,22,119
2011-07-11,14,Monday,Fall,1,Mid-Day,134,40,94
2011-07-11,15,Monday,Fall,1,Mid-Day,146,38,108
2011-07-11,16,Monday,Fall,1,Evening Rush,239,57,182
2011-07-11,17,Monday,Fall,1,Evening Rush,514,59,455
2011-07-11,18,Monday,Fall,1,Evening Rush,472,57,415
2011-07-11,19,Monday,Fall,1,Evening Rush,373,80,293
2011-07-11,20,Monday,Fall,1,Night,236,42,194
2011-07-11,21,Monday,Fall,1,Night,130,21,109
2011-07-11,22,Monday,Fall,1,Night,90,20,70
2011-07-11,23,Monday,Fall,1,Night,55,11,44
2011-07-12,0,Tuesday,Fall,1,Early Morning,22,3,19
2011-07-12,1,Tuesday,Fall,1,Early Morning,14,6,8
2011-07-12,2,Tuesday,Fall,1,Early Morning,9,2,7
2011-07-12,3,Tuesday,Fall,2,Early Morning,8,2,6
2011-07-12,4,Tuesday,Fall,1,Early Morning,6,0,6
2011-07-12,5,Tuesday,Fall,1,Early Morning,25,4,21
2011-07-12,6,Tuesday,Fall,1,Morning Rush,115,13,102
2011-07-12,7,Tuesday,Fall,1,Morning Rush,330,29,301
2011-07-12,8,Tuesday,Fall,1,Morning Rush,417,35,382
2011-07-12,9,Tuesday,Fall,1,Morning Rush,176,27,149
2011-07-12,10,Tuesday,Fall,1,Mid-Day,123,38,85
2011-07-12,11,Tuesday,Fall,1,Mid-Day,125,39,86
2011-07-12,12,Tuesday,Fall,1,Mid-Day,163,38,125
2011-07-12,13,Tuesday,Fall,1,Mid-Day,136,32,104
2011-07-12,14,Tuesday,Fall,1,Mid-Day,124,33,91
2011-07-12,15,Tuesday,Fall,1,Mid-Day,148,37,111
2011-07-12,16,Tuesday,Fall,1,Evening Rush,202,25,177
2011-07-12,17,Tuesday,Fall,1,Evening Rush,428,48,380
2011-07-12,18,Tuesday,Fall,1,Evening Rush,511,39,472
2011-07-12,19,Tuesday,Fall,1,Evening Rush,337,42,295
2011-07-12,20,Tuesday,Fall,1,Night,308,57,251
2011-07-12,21,Tuesday,Fall,1,Night,258,49,209
2011-07-12,22,Tuesday,Fall,1,Night,194,44,150
2011-07-12,23,Tuesday,Fall,1,Night,79,20,59
2011-07-13,0,Wednesday,Fall,1,Early Morning,46,9,37
2011-07-13,1,Wednesday,Fall,1,Early Morning,12,1,11
2011-07-13,2,Wednesday,Fall,1,Early Morning,5,2,3
2011-07-13,3,Wednesday,Fall,1,Early Morning,4,0,4
2011-07-13,4,Wednesday,Fall,1,Early Morning,5,0,5
2011-07-13,5,Wednesday,Fall,1,Early Morning,26,4,22
2011-07-13,6,Wednesday,Fall,1,Morning Rush,121,18,103
2011-07-13,7,Wednesday,Fall,1,Morning Rush,313,32,281
2011-07-13,8,Wednesday,Fall,1,Morning Rush,449,31,418
2011-07-13,9,Wednesday,Fall,1,Morning Rush,186,23,163
2011-07-13,10,Wednesday,Fall,1,Mid-Day,113,33,80
2011-07-13,11,Wednesday,Fall,1,Mid-Day,165,55,110
2011-07-13,12,Wednesday,Fall,1,Mid-Day,174,40,134
2011-07-13,13,Wednesday,Fall,3,Mid-Day,158,39,119
2011-07-13,14,Wednesday,Fall,3,Mid-Day,116,27,89
2011-07-13,15,Wednesday,Fall,3,Mid-Day,46,13,33
2011-07-13,16,Wednesday,Fall,2,Evening Rush,141,23,118
2011-07-13,17,Wednesday,Fall,1,Evening Rush,488,70,418
2011-07-13,18,Wednesday,Fall,1,Evening Rush,463,51,412
2011-07-13,19,Wednesday,Fall,1,Evening Rush,419,79,340
2011-07-13,20,Wednesday,Fall,1,Night,342,61,281
2011-07-13,21,Wednesday,Fall,1,Night,250,56,194
2011-07-13,22,Wednesday,Fall,1,Night,184,48,136
2011-07-13,23,Wednesday,Fall,1,Night,116,33,83
2011-07-14,0,Thursday,Fall,1,Early Morning,46,14,32
2011-07-14,1,Thursday,Fall,1,Early Morning,25,4,21
2011-07-14,2,Thursday,Fall,1,Early Morning,10,3,7
2011-07-14,3,Thursday,Fall,1,Early Morning,6,1,5
2011-07-14,4,Thursday,Fall,1,Early Morning,6,0,6
2011-07-14,5,Thursday,Fall,1,Early Morning,28,6,22
2011-07-14,6,Thursday,Fall,1,Morning Rush,130,14,116
2011-07-14,7,Thursday,Fall,1,Morning Rush,334,23,311
2011-07-14,8,Thursday,Fall,1,Morning Rush,486,53,433
2011-07-14,9,Thursday,Fall,1,Morning Rush,224,29,195
2011-07-14,10,Thursday,Fall,1,Mid-Day,127,32,95
2011-07-14,11,Thursday,Fall,1,Mid-Day,148,38,110
2011-07-14,12,Thursday,Fall,1,Mid-Day,223,51,172
2011-07-14,13,Thursday,Fall,1,Mid-Day,177,39,138
2011-07-14,14,Thursday,Fall,1,Mid-Day,178,49,129
2011-07-14,15,Thursday,Fall,1,Mid-Day,180,42,138
2011-07-14,16,Thursday,Fall,1,Evening Rush,274,43,231
2011-07-14,17,Thursday,Fall,1,Evening Rush,595,78,517
2011-07-14,18,Thursday,Fall,1,Evening Rush,578,94,484
2011-07-14,19,Thursday,Fall,1,Evening Rush,400,67,333
2011-07-14,20,Thursday,Fall,1,Night,348,81,267
2011-07-14,21,Thursday,Fall,1,Night,261,58,203
2011-07-14,22,Thursday,Fall,1,Night,176,42,134
2011-07-14,23,Thursday,Fall,1,Night,124,27,97
2011-07-15,0,Friday,Fall,1,Early Morning,80,23,57
2011-07-15,1,Friday,Fall,1,Early Morning,20,7,13
2011-07-15,2,Friday,Fall,1,Early Morning,38,16,22
2011-07-15,3,Friday,Fall,1,Early Morning,7,1,6
2011-07-15,4,Friday,Fall,1,Early Morning,10,2,8
2011-07-15,5,Friday,Fall,1,Early Morning,23,7,16
2011-07-15,6,Friday,Fall,2,Morning Rush,120,12,108
2011-07-15,7,Friday,Fall,1,Morning Rush,274,17,257
2011-07-15,8,Friday,Fall,1,Morning Rush,564,50,514
2011-07-15,9,Friday,Fall,1,Morning Rush,207,31,176
2011-07-15,10,Friday,Fall,2,Mid-Day,166,59,107
2011-07-15,11,Friday,Fall,1,Mid-Day,210,73,137
2011-07-15,12,Friday,Fall,1,Mid-Day,238,61,177
2011-07-15,13,Friday,Fall,1,Mid-Day,247,85,162
2011-07-15,14,Friday,Fall,1,Mid-Day,265,105,160
2011-07-15,15,Friday,Fall,1,Mid-Day,237,74,163
2011-07-15,16,Friday,Fall,1,Evening Rush,361,96,265
2011-07-15,17,Friday,Fall,1,Evening Rush,587,104,483
2011-07-15,18,Friday,Fall,1,Evening Rush,496,102,394
2011-07-15,19,Friday,Fall,1,Evening Rush,394,114,280
2011-07-15,20,Friday,Fall,1,Night,343,92,251
2011-07-15,21,Friday,Fall,1,Night,261,75,186
2011-07-15,22,Friday,Fall,1,Night,223,71,152
2011-07-15,23,Friday,Fall,1,Night,167,41,126
2011-07-16,0,Saturday,Fall,1,Early Morning,110,42,68
2011-07-16,1,Saturday,Fall,1,Early Morning,75,24,51
2011-07-16,2,Saturday,Fall,1,Early Morning,58,10,48
2011-07-16,3,Saturday,Fall,1,Early Morning,26,6,20
2011-07-16,4,Saturday,Fall,1,Early Morning,16,9,7
2011-07-16,5,Saturday,Fall,1,Early Morning,10,4,6
2011-07-16,6,Saturday,Fall,1,Morning Rush,37,16,21
2011-07-16,7,Saturday,Fall,1,Morning Rush,52,14,38
2011-07-16,8,Saturday,Fall,1,Morning Rush,127,37,90
2011-07-16,9,Saturday,Fall,1,Morning Rush,222,72,150
2011-07-16,10,Saturday,Fall,1,Mid-Day,322,114,208
2011-07-16,11,Saturday,Fall,1,Mid-Day,396,171,225
2011-07-16,12,Saturday,Fall,1,Mid-Day,463,187,276
2011-07-16,13,Saturday,Fall,1,Mid-Day,497,221,276
2011-07-16,14,Saturday,Fall,1,Mid-Day,433,201,232
2011-07-16,15,Saturday,Fall,1,Mid-Day,428,205,223
2011-07-16,16,Saturday,Fall,1,Evening Rush,425,183,242
2011-07-16,17,Saturday,Fall,1,Evening Rush,475,234,241
2011-07-16,18,Saturday,Fall,1,Evening Rush,428,185,243
2011-07-16,19,Saturday,Fall,1,Evening Rush,406,164,242
2011-07-16,20,Saturday,Fall,1,Night,296,108,188
2011-07-16,21,Saturday,Fall,1,Night,252,85,167
2011-07-16,22,Saturday,Fall,1,Night,201,65,136
2011-07-16,23,Saturday,Fall,1,Night,168,61,107
2011-07-17,0,Sunday,Fall,1,Early Morning,125,34,91
2011-07-17,1,Sunday,Fall,1,Early Morning,102,16,86
2011-07-17,2,Sunday,Fall,1,Early Morning,94,28,66
2011-07-17,3,Sunday,Fall,1,Early Morning,47,21,26
2011-07-17,4,Sunday,Fall,1,Early Morning,10,4,6
2011-07-17,5,Sunday,Fall,1,Early Morning,12,4,8
2011-07-17,6,Sunday,Fall,1,Morning Rush,21,10,11
2011-07-17,7,Sunday,Fall,1,Morning Rush,50,20,30
2011-07-17,8,Sunday,Fall,1,Morning Rush,118,45,73
2011-07-17,9,Sunday,Fall,1,Morning Rush,184,74,110
2011-07-17,10,Sunday,Fall,1,Mid-Day,304,127,177
2011-07-17,11,Sunday,Fall,1,Mid-Day,391,147,244
2011-07-17,12,Sunday,Fall,1,Mid-Day,420,177,243
2011-07-17,13,Sunday,Fall,1,Mid-Day,472,200,272
2011-07-17,14,Sunday,Fall,1,Mid-Day,430,168,262
2011-07-17,15,Sunday,Fall,1,Mid-Day,324,129,195
2011-07-17,16,Sunday,Fall,1,Evening Rush,317,129,188
2011-07-17,17,Sunday,Fall,1,Evening Rush,369,133,236
2011-07-17,18,Sunday,Fall,1,Evening Rush,390,147,243
2011-07-17,19,Sunday,Fall,1,Evening Rush,379,145,234
2011-07-17,20,Sunday,Fall,1,Night,262,85,177
2011-07-17,21,Sunday,Fall,1,Night,207,59,148
2011-07-17,22,Sunday,Fall,1,Night,181,65,116
2011-07-17,23,Sunday,Fall,1,Night,93,39,54
2011-07-18,0,Monday,Fall,1,Early Morning,51,21,30
2011-07-18,1,Monday,Fall,1,Early Morning,25,17,8
2011-07-18,2,Monday,Fall,1,Early Morning,10,2,8
2011-07-18,3,Monday,Fall,1,Early Morning,7,3,4
2011-07-18,4,Monday,Fall,1,Early Morning,4,1,3
2011-07-18,5,Monday,Fall,1,Early Morning,17,2,15
2011-07-18,6,Monday,Fall,1,Morning Rush,105,10,95
2011-07-18,7,Monday,Fall,1,Morning Rush,277,22,255
2011-07-18,8,Monday,Fall,1,Morning Rush,347,18,329
2011-07-18,9,Monday,Fall,1,Morning Rush,203,33,170
2011-07-18,10,Monday,Fall,1,Mid-Day,130,52,78
2011-07-18,11,Monday,Fall,1,Mid-Day,141,42,99
2011-07-18,12,Monday,Fall,1,Mid-Day,165,39,126
2011-07-18,13,Monday,Fall,1,Mid-Day,152,27,125
2011-07-18,14,Monday,Fall,1,Mid-Day,138,32,106
2011-07-18,15,Monday,Fall,1,Mid-Day,164,53,111
2011-07-18,16,Monday,Fall,1,Evening Rush,265,45,220
2011-07-18,17,Monday,Fall,1,Evening Rush,545,72,473
2011-07-18,18,Monday,Fall,1,Evening Rush,558,80,478
2011-07-18,19,Monday,Fall,1,Evening Rush,398,63,335
2011-07-18,20,Monday,Fall,1,Night,323,91,232
2011-07-18,21,Monday,Fall,1,Night,202,48,154
2011-07-18,22,Monday,Fall,1,Night,140,36,104
2011-07-18,23,Monday,Fall,1,Night,91,32,59
2011-07-19,0,Tuesday,Fall,1,Early Morning,51,25,26
2011-07-19,1,Tuesday,Fall,2,Early Morning,13,7,6
2011-07-19,2,Tuesday,Fall,1,Early Morning,13,9,4
2011-07-19,3,Tuesday,Fall,1,Early Morning,3,2,1
2011-07-19,4,Tuesday,Fall,1,Early Morning,5,1,4
2011-07-19,5,Tuesday,Fall,2,Early Morning,19,0,19
2011-07-19,6,Tuesday,Fall,2,Morning Rush,134,8,126
2011-07-19,7,Tuesday,Fall,2,Morning Rush,315,28,287
2011-07-19,8,Tuesday,Fall,2,Morning Rush,412,31,381
2011-07-19,9,Tuesday,Fall,2,Morning Rush,199,22,177
2011-07-19,10,Tuesday,Fall,2,Mid-Day,141,29,112
2011-07-19,11,Tuesday,Fall,1,Mid-Day,127,29,98
2011-07-19,12,Tuesday,Fall,1,Mid-Day,153,26,127
2011-07-19,13,Tuesday,Fall,1,Mid-Day,172,33,139
2011-07-19,14,Tuesday,Fall,1,Mid-Day,152,41,111
2011-07-19,15,Tuesday,Fall,1,Mid-Day,158,48,110
2011-07-19,16,Tuesday,Fall,1,Evening Rush,277,61,216
2011-07-19,17,Tuesday,Fall,1,Evening Rush,513,68,445
2011-07-19,18,Tuesday,Fall,1,Evening Rush,530,80,450
2011-07-19,19,Tuesday,Fall,1,Evening Rush,388,54,334
2011-07-19,20,Tuesday,Fall,1,Night,277,48,229
2011-07-19,21,Tuesday,Fall,1,Night,241,47,194
2011-07-19,22,Tuesday,Fall,1,Night,156,36,120
2011-07-19,23,Tuesday,Fall,3,Night,92,19,73
2011-07-20,0,Wednesday,Fall,1,Early Morning,40,11,29
2011-07-20,1,Wednesday,Fall,1,Early Morning,11,4,7
2011-07-20,2,Wednesday,Fall,1,Early Morning,9,2,7
2011-07-20,3,Wednesday,Fall,1,Early Morning,6,2,4
2011-07-20,4,Wednesday,Fall,1,Early Morning,4,0,4
2011-07-20,5,Wednesday,Fall,1,Early Morning,23,4,19
2011-07-20,6,Wednesday,Fall,2,Morning Rush,116,5,111
2011-07-20,7,Wednesday,Fall,2,Morning Rush,303,27,276
2011-07-20,8,Wednesday,Fall,1,Morning Rush,438,34,404
2011-07-20,9,Wednesday,Fall,1,Morning Rush,209,28,181
2011-07-20,10,Wednesday,Fall,1,Mid-Day,110,34,76
2011-07-20,11,Wednesday,Fall,1,Mid-Day,142,26,116
2011-07-20,12,Wednesday,Fall,1,Mid-Day,149,28,121
2011-07-20,13,Wednesday,Fall,1,Mid-Day,120,23,97
2011-07-20,14,Wednesday,Fall,1,Mid-Day,127,44,83
2011-07-20,15,Wednesday,Fall,1,Mid-Day,138,36,102
2011-07-20,16,Wednesday,Fall,1,Evening Rush,234,30,204
2011-07-20,17,Wednesday,Fall,1,Evening Rush,455,50,405
2011-07-20,18,Wednesday,Fall,1,Evening Rush,497,68,429
2011-07-20,19,Wednesday,Fall,1,Evening Rush,382,59,323
2011-07-20,20,Wednesday,Fall,1,Night,309,45,264
2011-07-20,21,Wednesday,Fall,1,Night,242,33,209
2011-07-20,22,Wednesday,Fall,1,Night,169,25,144
2011-07-20,23,Wednesday,Fall,1,Night,99,26,73
2011-07-21,0,Thursday,Fall,2,Early Morning,42,13,29
2011-07-21,1,Thursday,Fall,2,Early Morning,21,5,16
2011-07-21,2,Thursday,Fall,2,Early Morning,6,2,4
2011-07-21,3,Thursday,Fall,2,Early Morning,6,1,5
2011-07-21,4,Thursday,Fall,2,Early Morning,4,0,4
2011-07-21,5,Thursday,Fall,2,Early Morning,18,2,16
2011-07-21,6,Thursday,Fall,2,Morning Rush,117,6,111
2011-07-21,7,Thursday,Fall,2,Morning Rush,274,23,251
2011-07-21,8,Thursday,Fall,2,Morning Rush,381,23,358
2011-07-21,9,Thursday,Fall,2,Morning Rush,200,34,166
2011-07-21,10,Thursday,Fall,2,Mid-Day,78,31,47
2011-07-21,11,Thursday,Fall,2,Mid-Day,106,27,79
2011-07-21,12,Thursday,Fall,1,Mid-Day,135,29,106
2011-07-21,13,Thursday,Fall,1,Mid-Day,102,21,81
2011-07-21,14,Thursday,Fall,1,Mid-Day,147,50,97
2011-07-21,15,Thursday,Fall,1,Mid-Day,133,40,93
2011-07-21,16,Thursday,Fall,1,Evening Rush,210,43,167
2011-07-21,17,Thursday,Fall,1,Evening Rush,414,40,374
2011-07-21,18,Thursday,Fall,1,Evening Rush,382,39,343
2011-07-21,19,Thursday,Fall,1,Evening Rush,284,51,233
2011-07-21,20,Thursday,Fall,1,Night,237,38,199
2011-07-21,21,Thursday,Fall,1,Night,225,38,187
2011-07-21,22,Thursday,Fall,1,Night,149,36,113
2011-07-21,23,Thursday,Fall,1,Night,113,40,73
2011-07-22,0,Friday,Fall,1,Early Morning,60,9,51
2011-07-22,1,Friday,Fall,1,Early Morning,24,7,17
2011-07-22,2,Friday,Fall,1,Early Morning,14,0,14
2011-07-22,3,Friday,Fall,1,Early Morning,7,1,6
2011-07-22,4,Friday,Fall,1,Early Morning,13,8,5
2011-07-22,5,Friday,Fall,1,Early Morning,19,2,17
2011-07-22,6,Friday,Fall,1,Morning Rush,96,13,83
2011-07-22,7,Friday,Fall,2,Morning Rush,252,20,232
2011-07-22,8,Friday,Fall,2,Morning Rush,322,30,292
2011-07-22,9,Friday,Fall,1,Morning Rush,208,31,177
2011-07-22,10,Friday,Fall,1,Mid-Day,115,32,83
2011-07-22,11,Friday,Fall,1,Mid-Day,109,23,86
2011-07-22,12,Friday,Fall,1,Mid-Day,115,20,95
2011-07-22,13,Friday,Fall,1,Mid-Day,123,25,98
2011-07-22,14,Friday,Fall,1,Mid-Day,101,24,77
2011-07-22,15,Friday,Fall,1,Mid-Day,133,32,101
2011-07-22,16,Friday,Fall,3,Evening Rush,182,29,153
2011-07-22,17,Friday,Fall,1,Evening Rush,306,35,271
2011-07-22,18,Friday,Fall,1,Evening Rush,284,34,250
2011-07-22,19,Friday,Fall,2,Evening Rush,250,40,210
2011-07-22,20,Friday,Fall,1,Night,212,46,166
2011-07-22,21,Friday,Fall,1,Night,190,38,152
2011-07-22,22,Friday,Fall,2,Night,149,44,105
2011-07-22,23,Friday,Fall,1,Night,103,19,84
2011-07-23,0,Saturday,Fall,1,Early Morning,101,16,85
2011-07-23,1,Saturday,Fall,1,Early Morning,70,13,57
2011-07-23,2,Saturday,Fall,1,Early Morning,61,13,48
2011-07-23,3,Saturday,Fall,1,Early Morning,22,6,16
2011-07-23,4,Saturday,Fall,1,Early Morning,9,5,4
2011-07-23,5,Saturday,Fall,1,Early Morning,7,1,6
2011-07-23,6,Saturday,Fall,1,Morning Rush,25,6,19
2011-07-23,7,Saturday,Fall,1,Morning Rush,45,7,38
2011-07-23,8,Saturday,Fall,1,Morning Rush,109,24,85
2011-07-23,9,Saturday,Fall,1,Morning Rush,132,30,102
2011-07-23,10,Saturday,Fall,1,Mid-Day,198,61,137
2011-07-23,11,Saturday,Fall,1,Mid-Day,216,62,154
2011-07-23,12,Saturday,Fall,1,Mid-Day,235,71,164
2011-07-23,13,Saturday,Fall,1,Mid-Day,245,78,167
2011-07-23,14,Saturday,Fall,1,Mid-Day,236,84,152
2011-07-23,15,Saturday,Fall,1,Mid-Day,215,78,137
2011-07-23,16,Saturday,Fall,1,Evening Rush,221,70,151
2011-07-23,17,Saturday,Fall,1,Evening Rush,197,70,127
2011-07-23,18,Saturday,Fall,1,Evening Rush,196,62,134
2011-07-23,19,Saturday,Fall,2,Evening Rush,217,80,137
2011-07-23,20,Saturday,Fall,1,Night,145,47,98
2011-07-23,21,Saturday,Fall,1,Night,154,39,115
2011-07-23,22,Saturday,Fall,1,Night,125,37,88
2011-07-23,23,Saturday,Fall,1,Night,104,27,77
2011-07-24,0,Sunday,Fall,1,Early Morning,119,42,77
2011-07-24,1,Sunday,Fall,1,Early Morning,96,33,63
2011-07-24,2,Sunday,Fall,1,Early Morning,60,12,48
2011-07-24,3,Sunday,Fall,1,Early Morning,37,17,20
2011-07-24,4,Sunday,Fall,1,Early Morning,6,1,5
2011-07-24,5,Sunday,Fall,1,Early Morning,8,5,3
2011-07-24,6,Sunday,Fall,2,Morning Rush,22,9,13
2011-07-24,7,Sunday,Fall,1,Morning Rush,35,6,29
2011-07-24,8,Sunday,Fall,1,Morning Rush,104,22,82
2011-07-24,9,Sunday,Fall,1,Morning Rush,154,42,112
2011-07-24,10,Sunday,Fall,1,Mid-Day,226,61,165
2011-07-24,11,Sunday,Fall,1,Mid-Day,243,74,169
2011-07-24,12,Sunday,Fall,1,Mid-Day,246,85,161
2011-07-24,13,Sunday,Fall,1,Mid-Day,252,90,162
2011-07-24,14,Sunday,Fall,1,Mid-Day,283,79,204
2011-07-24,15,Sunday,Fall,1,Mid-Day,238,68,170
2011-07-24,16,Sunday,Fall,1,Evening Rush,249,62,187
2011-07-24,17,Sunday,Fall,1,Evening Rush,249,75,174
2011-07-24,18,Sunday,Fall,1,Evening Rush,243,67,176
2011-07-24,19,Sunday,Fall,1,Evening Rush,240,70,170
2011-07-24,20,Sunday,Fall,1,Night,195,52,143
2011-07-24,21,Sunday,Fall,1,Night,153,42,111
2011-07-24,22,Sunday,Fall,1,Night,98,23,75
2011-07-24,23,Sunday,Fall,2,Night,50,13,37
2011-07-25,0,Monday,Fall,2,Early Morning,34,17,17
2011-07-25,1,Monday,Fall,2,Early Morning,12,4,8
2011-07-25,2,Monday,Fall,2,Early Morning,6,3,3
2011-07-25,3,Monday,Fall,1,Early Morning,4,2,2
2011-07-25,4,Monday,Fall,1,Early Morning,6,0,6
2011-07-25,5,Monday,Fall,1,Early Morning,24,2,22
2011-07-25,6,Monday,Fall,2,Morning Rush,107,7,100
2011-07-25,7,Monday,Fall,2,Morning Rush,277,20,257
2011-07-25,8,Monday,Fall,2,Morning Rush,387,34,353
2011-07-25,9,Monday,Fall,1,Morning Rush,135,11,124
2011-07-25,10,Monday,Fall,1,Mid-Day,84,30,54
2011-07-25,11,Monday,Fall,2,Mid-Day,107,24,83
2011-07-25,12,Monday,Fall,2,Mid-Day,67,17,50
2011-07-25,13,Monday,Fall,2,Mid-Day,78,14,64
2011-07-25,14,Monday,Fall,2,Mid-Day,90,28,62
2011-07-25,15,Monday,Fall,1,Mid-Day,112,16,96
2011-07-25,16,Monday,Fall,1,Evening Rush,198,37,161
2011-07-25,17,Monday,Fall,1,Evening Rush,485,48,437
2011-07-25,18,Monday,Fall,1,Evening Rush,533,60,473
2011-07-25,19,Monday,Fall,1,Evening Rush,386,62,324
2011-07-25,20,Monday,Fall,1,Night,302,55,247
2011-07-25,21,Monday,Fall,1,Night,194,41,153
2011-07-25,22,Monday,Fall,1,Night,125,13,112
2011-07-25,23,Monday,Fall,1,Night,87,23,64
2011-07-26,0,Tuesday,Fall,1,Early Morning,28,8,20
2011-07-26,1,Tuesday,Fall,1,Early Morning,12,6,6
2011-07-26,2,Tuesday,Fall,1,Early Morning,7,1,6
2011-07-26,3,Tuesday,Fall,1,Early Morning,4,2,2
2011-07-26,4,Tuesday,Fall,1,Early Morning,6,0,6
2011-07-26,5,Tuesday,Fall,1,Early Morning,27,3,24
2011-07-26,6,Tuesday,Fall,1,Morning Rush,110,2,108
2011-07-26,7,Tuesday,Fall,1,Morning Rush,318,30,288
2011-07-26,8,Tuesday,Fall,1,Morning Rush,424,32,392
2011-07-26,9,Tuesday,Fall,1,Morning Rush,187,25,162
2011-07-26,10,Tuesday,Fall,1,Mid-Day,138,42,96
2011-07-26,11,Tuesday,Fall,1,Mid-Day,151,49,102
2011-07-26,12,Tuesday,Fall,1,Mid-Day,147,25,122
2011-07-26,13,Tuesday,Fall,1,Mid-Day,182,43,139
2011-07-26,14,Tuesday,Fall,1,Mid-Day,147,46,101
2011-07-26,15,Tuesday,Fall,1,Mid-Day,163,49,114
2011-07-26,16,Tuesday,Fall,1,Evening Rush,254,41,213
2011-07-26,17,Tuesday,Fall,1,Evening Rush,537,72,465
2011-07-26,18,Tuesday,Fall,1,Evening Rush,546,68,478
2011-07-26,19,Tuesday,Fall,1,Evening Rush,398,69,329
2011-07-26,20,Tuesday,Fall,1,Night,290,47,243
2011-07-26,21,Tuesday,Fall,1,Night,267,45,222
2011-07-26,22,Tuesday,Fall,1,Night,158,27,131
2011-07-26,23,Tuesday,Fall,1,Night,89,18,71
2011-07-27,0,Wednesday,Fall,2,Early Morning,45,19,26
2011-07-27,1,Wednesday,Fall,1,Early Morning,10,1,9
2011-07-27,2,Wednesday,Fall,1,Early Morning,6,1,5
2011-07-27,3,Wednesday,Fall,1,Early Morning,4,0,4
2011-07-27,4,Wednesday,Fall,1,Early Morning,4,1,3
2011-07-27,5,Wednesday,Fall,1,Early Morning,18,0,18
2011-07-27,6,Wednesday,Fall,1,Morning Rush,123,4,119
2011-07-27,7,Wednesday,Fall,1,Morning Rush,347,34,313
2011-07-27,8,Wednesday,Fall,1,Morning Rush,433,28,405
2011-07-27,9,Wednesday,Fall,1,Morning Rush,216,27,189
2011-07-27,10,Wednesday,Fall,1,Mid-Day,114,32,82
2011-07-27,11,Wednesday,Fall,1,Mid-Day,136,42,94
2011-07-27,12,Wednesday,Fall,1,Mid-Day,169,37,132
2011-07-27,13,Wednesday,Fall,1,Mid-Day,180,29,151
2011-07-27,14,Wednesday,Fall,1,Mid-Day,127,20,107
2011-07-27,15,Wednesday,Fall,1,Mid-Day,140,37,103
2011-07-27,16,Wednesday,Fall,1,Evening Rush,268,40,228
2011-07-27,17,Wednesday,Fall,1,Evening Rush,572,81,491
2011-07-27,18,Wednesday,Fall,1,Evening Rush,541,78,463
2011-07-27,19,Wednesday,Fall,1,Evening Rush,375,87,288
2011-07-27,20,Wednesday,Fall,1,Night,294,55,239
2011-07-27,21,Wednesday,Fall,1,Night,245,49,196
2011-07-27,22,Wednesday,Fall,1,Night,180,37,143
2011-07-27,23,Wednesday,Fall,1,Night,109,16,93
2011-07-28,0,Thursday,Fall,1,Early Morning,45,14,31
2011-07-28,1,Thursday,Fall,1,Early Morning,29,3,26
2011-07-28,2,Thursday,Fall,1,Early Morning,7,2,5
2011-07-28,3,Thursday,Fall,1,Early Morning,5,0,5
2011-07-28,4,Thursday,Fall,1,Early Morning,6,0,6
2011-07-28,5,Thursday,Fall,1,Early Morning,27,1,26
2011-07-28,6,Thursday,Fall,1,Morning Rush,116,6,110
2011-07-28,7,Thursday,Fall,1,Morning Rush,305,27,278
2011-07-28,8,Thursday,Fall,1,Morning Rush,456,47,409
2011-07-28,9,Thursday,Fall,1,Morning Rush,210,21,189
2011-07-28,10,Thursday,Fall,1,Mid-Day,116,30,86
2011-07-28,11,Thursday,Fall,1,Mid-Day,154,41,113
2011-07-28,12,Thursday,Fall,1,Mid-Day,186,35,151
2011-07-28,13,Thursday,Fall,1,Mid-Day,152,26,126
2011-07-28,14,Thursday,Fall,2,Mid-Day,138,27,111
2011-07-28,15,Thursday,Fall,1,Mid-Day,146,22,124
2011-07-28,16,Thursday,Fall,1,Evening Rush,256,42,214
2011-07-28,17,Thursday,Fall,1,Evening Rush,468,45,423
2011-07-28,18,Thursday,Fall,1,Evening Rush,483,55,428
2011-07-28,19,Thursday,Fall,1,Evening Rush,322,37,285
2011-07-28,20,Thursday,Fall,1,Night,270,41,229
2011-07-28,21,Thursday,Fall,1,Night,196,31,165
2011-07-28,22,Thursday,Fall,1,Night,174,25,149
2011-07-28,23,Thursday,Fall,1,Night,123,28,95
2011-07-29,0,Friday,Fall,1,Early Morning,57,12,45
2011-07-29,1,Friday,Fall,1,Early Morning,34,12,22
2011-07-29,2,Friday,Fall,1,Early Morning,13,3,10
2011-07-29,3,Friday,Fall,1,Early Morning,11,2,9
2011-07-29,4,Friday,Fall,1,Early Morning,6,2,4
2011-07-29,5,Friday,Fall,1,Early Morning,27,4,23
2011-07-29,6,Friday,Fall,2,Morning Rush,90,7,83
2011-07-29,7,Friday,Fall,2,Morning Rush,254,26,228
2011-07-29,8,Friday,Fall,2,Morning Rush,384,30,354
2011-07-29,9,Friday,Fall,1,Morning Rush,179,28,151
2011-07-29,10,Friday,Fall,1,Mid-Day,106,37,69
2011-07-29,11,Friday,Fall,1,Mid-Day,161,43,118
2011-07-29,12,Friday,Fall,1,Mid-Day,135,40,95
2011-07-29,13,Friday,Fall,1,Mid-Day,156,42,114
2011-07-29,14,Friday,Fall,1,Mid-Day,148,34,114
2011-07-29,15,Friday,Fall,1,Mid-Day,169,40,129
2011-07-29,16,Friday,Fall,1,Evening Rush,233,35,198
2011-07-29,17,Friday,Fall,1,Evening Rush,421,47,374
2011-07-29,18,Friday,Fall,1,Evening Rush,362,49,313
2011-07-29,19,Friday,Fall,1,Evening Rush,241,22,219
2011-07-29,20,Friday,Fall,1,Night,206,53,153
2011-07-29,21,Friday,Fall,1,Night,163,29,134
2011-07-29,22,Friday,Fall,1,Night,174,47,127
2011-07-29,23,Friday,Fall,1,Night,116,26,90
2011-07-30,0,Saturday,Fall,1,Early Morning,133,60,73
2011-07-30,1,Saturday,Fall,1,Early Morning,90,15,75
2011-07-30,2,Saturday,Fall,1,Early Morning,42,11,31
2011-07-30,3,Saturday,Fall,1,Early Morning,43,18,25
2011-07-30,4,Saturday,Fall,1,Early Morning,10,4,6
2011-07-30,5,Saturday,Fall,1,Early Morning,13,4,9
2011-07-30,6,Saturday,Fall,1,Morning Rush,24,6,18
2011-07-30,7,Saturday,Fall,1,Morning Rush,42,3,39
2011-07-30,8,Saturday,Fall,1,Morning Rush,114,27,87
2011-07-30,9,Saturday,Fall,1,Morning Rush,174,49,125
2011-07-30,10,Saturday,Fall,1,Mid-Day,261,79,182
2011-07-30,11,Saturday,Fall,1,Mid-Day,317,111,206
2011-07-30,12,Saturday,Fall,1,Mid-Day,341,111,230
2011-07-30,13,Saturday,Fall,1,Mid-Day,308,125,183
2011-07-30,14,Saturday,Fall,1,Mid-Day,305,112,193
2011-07-30,15,Saturday,Fall,1,Mid-Day,302,113,189
2011-07-30,16,Saturday,Fall,1,Evening Rush,302,126,176
2011-07-30,17,Saturday,Fall,1,Evening Rush,302,93,209
2011-07-30,18,Saturday,Fall,1,Evening Rush,299,92,207
2011-07-30,19,Saturday,Fall,1,Evening Rush,256,101,155
2011-07-30,20,Saturday,Fall,1,Night,206,74,132
2011-07-30,21,Saturday,Fall,1,Night,205,82,123
2011-07-30,22,Saturday,Fall,1,Night,209,80,129
2011-07-30,23,Saturday,Fall,1,Night,177,63,114
2011-07-31,0,Sunday,Fall,1,Early Morning,113,33,80
2011-07-31,1,Sunday,Fall,1,Early Morning,79,8,71
2011-07-31,2,Sunday,Fall,1,Early Morning,67,19,48
2011-07-31,3,Sunday,Fall,1,Early Morning,50,24,26
2011-07-31,4,Sunday,Fall,1,Early Morning,13,6,7
2011-07-31,5,Sunday,Fall,1,Early Morning,8,4,4
2011-07-31,6,Sunday,Fall,1,Morning Rush,13,5,8
2011-07-31,7,Sunday,Fall,1,Morning Rush,45,19,26
2011-07-31,8,Sunday,Fall,1,Morning Rush,142,54,88
2011-07-31,9,Sunday,Fall,1,Morning Rush,183,55,128
2011-07-31,10,Sunday,Fall,1,Mid-Day,254,91,163
2011-07-31,11,Sunday,Fall,1,Mid-Day,275,112,163
2011-07-31,12,Sunday,Fall,1,Mid-Day,338,146,192
2011-07-31,13,Sunday,Fall,1,Mid-Day,294,142,152
2011-07-31,14,Sunday,Fall,1,Mid-Day,326,130,196
2011-07-31,15,Sunday,Fall,1,Mid-Day,293,109,184
2011-07-31,16,Sunday,Fall,1,Evening Rush,306,98,208
2011-07-31,17,Sunday,Fall,1,Evening Rush,320,114,206
2011-07-31,18,Sunday,Fall,1,Evening Rush,304,91,213
2011-07-31,19,Sunday,Fall,1,Evening Rush,274,87,187
2011-07-31,20,Sunday,Fall,1,Night,275,70,205
2011-07-31,21,Sunday,Fall,1,Night,164,68,96
2011-07-31,22,Sunday,Fall,1,Night,96,25,71
2011-07-31,23,Sunday,Fall,1,Night,70,14,56
2011-08-01,0,Monday,Fall,1,Early Morning,29,7,22
2011-08-01,1,Monday,Fall,1,Early Morning,17,5,12
2011-08-01,2,Monday,Fall,1,Early Morning,11,4,7
2011-08-01,3,Monday,Fall,1,Early Morning,4,0,4
2011-08-01,4,Monday,Fall,1,Early Morning,4,2,2
2011-08-01,5,Monday,Fall,1,Early Morning,26,2,24
2011-08-01,6,Monday,Fall,1,Morning Rush,100,3,97
2011-08-01,7,Monday,Fall,1,Morning Rush,282,24,258
2011-08-01,8,Monday,Fall,1,Morning Rush,382,35,347
2011-08-01,9,Monday,Fall,1,Morning Rush,166,27,139
2011-08-01,10,Monday,Fall,1,Mid-Day,97,27,70
2011-08-01,11,Monday,Fall,1,Mid-Day,119,53,66
2011-08-01,12,Monday,Fall,1,Mid-Day,168,53,115
2011-08-01,13,Monday,Fall,1,Mid-Day,150,38,112
2011-08-01,14,Monday,Fall,1,Mid-Day,123,37,86
2011-08-01,15,Monday,Fall,1,Mid-Day,129,52,77
2011-08-01,16,Monday,Fall,1,Evening Rush,231,34,197
2011-08-01,17,Monday,Fall,1,Evening Rush,514,69,445
2011-08-01,18,Monday,Fall,1,Evening Rush,543,68,475
2011-08-01,19,Monday,Fall,1,Evening Rush,413,63,350
2011-08-01,20,Monday,Fall,1,Night,305,49,256
2011-08-01,21,Monday,Fall,1,Night,220,42,178
2011-08-01,22,Monday,Fall,1,Night,137,21,116
2011-08-01,23,Monday,Fall,1,Night,96,14,82
2011-08-02,0,Tuesday,Fall,1,Early Morning,29,11,18
2011-08-02,1,Tuesday,Fall,1,Early Morning,12,4,8
2011-08-02,2,Tuesday,Fall,1,Early Morning,8,2,6
2011-08-02,3,Tuesday,Fall,1,Early Morning,5,0,5
2011-08-02,4,Tuesday,Fall,1,Early Morning,10,0,10
2011-08-02,5,Tuesday,Fall,1,Early Morning,21,4,17
2011-08-02,6,Tuesday,Fall,1,Morning Rush,117,12,105
2011-08-02,7,Tuesday,Fall,1,Morning Rush,335,15,320
2011-08-02,8,Tuesday,Fall,1,Morning Rush,435,37,398
2011-08-02,9,Tuesday,Fall,1,Morning Rush,213,31,182
2011-08-02,10,Tuesday,Fall,1,Mid-Day,140,50,90
2011-08-02,11,Tuesday,Fall,1,Mid-Day,128,32,96
2011-08-02,12,Tuesday,Fall,1,Mid-Day,157,45,112
2011-08-02,13,Tuesday,Fall,1,Mid-Day,203,50,153
2011-08-02,14,Tuesday,Fall,1,Mid-Day,159,45,114
2011-08-02,15,Tuesday,Fall,1,Mid-Day,168,48,120
2011-08-02,16,Tuesday,Fall,1,Evening Rush,274,58,216
2011-08-02,17,Tuesday,Fall,2,Evening Rush,556,63,493
2011-08-02,18,Tuesday,Fall,2,Evening Rush,556,65,491
2011-08-02,19,Tuesday,Fall,2,Evening Rush,454,85,369
2011-08-02,20,Tuesday,Fall,2,Night,288,40,248
2011-08-02,21,Tuesday,Fall,1,Night,254,53,201
2011-08-02,22,Tuesday,Fall,2,Night,191,22,169
2011-08-02,23,Tuesday,Fall,2,Night,132,29,103
2011-08-03,0,Wednesday,Fall,2,Early Morning,43,11,32
2011-08-03,1,Wednesday,Fall,2,Early Morning,16,7,9
2011-08-03,2,Wednesday,Fall,2,Early Morning,11,2,9
2011-08-03,3,Wednesday,Fall,2,Early Morning,4,0,4
2011-08-03,4,Wednesday,Fall,2,Early Morning,7,0,7
2011-08-03,5,Wednesday,Fall,2,Early Morning,24,2,22
2011-08-03,6,Wednesday,Fall,3,Morning Rush,110,9,101
2011-08-03,7,Wednesday,Fall,2,Morning Rush,271,19,252
2011-08-03,8,Wednesday,Fall,2,Morning Rush,437,29,408
2011-08-03,9,Wednesday,Fall,2,Morning Rush,195,23,172
2011-08-03,10,Wednesday,Fall,3,Mid-Day,68,9,59
2011-08-03,11,Wednesday,Fall,2,Mid-Day,122,29,93
2011-08-03,12,Wednesday,Fall,3,Mid-Day,161,19,142
2011-08-03,13,Wednesday,Fall,2,Mid-Day,144,37,107
2011-08-03,14,Wednesday,Fall,2,Mid-Day,147,43,104
2011-08-03,15,Wednesday,Fall,2,Mid-Day,118,31,87
2011-08-03,16,Wednesday,Fall,3,Evening Rush,150,21,129
2011-08-03,17,Wednesday,Fall,2,Evening Rush,425,47,378
2011-08-03,18,Wednesday,Fall,3,Evening Rush,492,49,443
2011-08-03,19,Wednesday,Fall,3,Evening Rush,321,51,270
2011-08-03,20,Wednesday,Fall,3,Night,87,7,80
2011-08-03,21,Wednesday,Fall,2,Night,88,7,81
2011-08-03,22,Wednesday,Fall,3,Night,77,11,66
2011-08-03,23,Wednesday,Fall,2,Night,56,4,52
2011-08-04,0,Thursday,Fall,2,Early Morning,17,2,15
2011-08-04,1,Thursday,Fall,2,Early Morning,17,3,14
2011-08-04,2,Thursday,Fall,2,Early Morning,7,2,5
2011-08-04,3,Thursday,Fall,3,Early Morning,3,0,3
2011-08-04,4,Thursday,Fall,2,Early Morning,7,0,7
2011-08-04,5,Thursday,Fall,2,Early Morning,20,3,17
2011-08-04,6,Thursday,Fall,2,Morning Rush,97,7,90
2011-08-04,7,Thursday,Fall,2,Morning Rush,282,11,271
2011-08-04,8,Thursday,Fall,2,Morning Rush,398,29,369
2011-08-04,9,Thursday,Fall,1,Morning Rush,187,25,162
2011-08-04,10,Thursday,Fall,1,Mid-Day,113,24,89
2011-08-04,11,Thursday,Fall,2,Mid-Day,149,37,112
2011-08-04,12,Thursday,Fall,2,Mid-Day,205,53,152
2011-08-04,13,Thursday,Fall,1,Mid-Day,205,63,142
2011-08-04,14,Thursday,Fall,1,Mid-Day,167,53,114
2011-08-04,15,Thursday,Fall,1,Mid-Day,165,50,115
2011-08-04,16,Thursday,Fall,1,Evening Rush,290,70,220
2011-08-04,17,Thursday,Fall,1,Evening Rush,555,91,464
2011-08-04,18,Thursday,Fall,1,Evening Rush,523,88,435
2011-08-04,19,Thursday,Fall,1,Evening Rush,366,65,301
2011-08-04,20,Thursday,Fall,2,Night,286,41,245
2011-08-04,21,Thursday,Fall,2,Night,211,25,186
2011-08-04,22,Thursday,Fall,1,Night,174,33,141
2011-08-04,23,Thursday,Fall,1,Night,132,24,108
2011-08-05,0,Friday,Fall,1,Early Morning,54,13,41
2011-08-05,1,Friday,Fall,1,Early Morning,19,3,16
2011-08-05,2,Friday,Fall,1,Early Morning,19,5,14
2011-08-05,3,Friday,Fall,1,Early Morning,6,0,6
2011-08-05,4,Friday,Fall,1,Early Morning,7,1,6
2011-08-05,5,Friday,Fall,1,Early Morning,16,0,16
2011-08-05,6,Friday,Fall,1,Morning Rush,101,7,94
2011-08-05,7,Friday,Fall,1,Morning Rush,270,23,247
2011-08-05,8,Friday,Fall,1,Morning Rush,454,39,415
2011-08-05,9,Friday,Fall,1,Morning Rush,226,43,183
2011-08-05,10,Friday,Fall,1,Mid-Day,163,50,113
2011-08-05,11,Friday,Fall,2,Mid-Day,147,44,103
2011-08-05,12,Friday,Fall,1,Mid-Day,216,57,159
2011-08-05,13,Friday,Fall,1,Mid-Day,204,40,164
2011-08-05,14,Friday,Fall,2,Mid-Day,245,81,164
2011-08-05,15,Friday,Fall,1,Mid-Day,210,50,160
2011-08-05,16,Friday,Fall,1,Evening Rush,330,76,254
2011-08-05,17,Friday,Fall,1,Evening Rush,550,84,466
2011-08-05,18,Friday,Fall,1,Evening Rush,466,105,361
2011-08-05,19,Friday,Fall,1,Evening Rush,372,90,282
2011-08-05,20,Friday,Fall,1,Night,291,70,221
2011-08-05,21,Friday,Fall,1,Night,173,54,119
2011-08-05,22,Friday,Fall,1,Night,188,51,137
2011-08-05,23,Friday,Fall,1,Night,139,37,102
2011-08-06,0,Saturday,Fall,1,Early Morning,133,29,104
2011-08-06,1,Saturday,Fall,1,Early Morning,67,17,50
2011-08-06,2,Saturday,Fall,1,Early Morning,53,14,39
2011-08-06,3,Saturday,Fall,2,Early Morning,42,14,28
2011-08-06,4,Saturday,Fall,2,Early Morning,10,5,5
2011-08-06,5,Saturday,Fall,1,Early Morning,6,2,4
2011-08-06,6,Saturday,Fall,1,Morning Rush,27,5,22
2011-08-06,7,Saturday,Fall,1,Morning Rush,63,14,49
2011-08-06,8,Saturday,Fall,1,Morning Rush,121,27,94
2011-08-06,9,Saturday,Fall,1,Morning Rush,215,60,155
2011-08-06,10,Saturday,Fall,2,Mid-Day,290,91,199
2011-08-06,11,Saturday,Fall,1,Mid-Day,349,138,211
2011-08-06,12,Saturday,Fall,1,Mid-Day,382,130,252
2011-08-06,13,Saturday,Fall,2,Mid-Day,441,176,265
2011-08-06,14,Saturday,Fall,1,Mid-Day,380,176,204
2011-08-06,15,Saturday,Fall,2,Mid-Day,362,130,232
2011-08-06,16,Saturday,Fall,3,Evening Rush,343,155,188
2011-08-06,17,Saturday,Fall,3,Evening Rush,149,61,88
2011-08-06,18,Saturday,Fall,2,Evening Rush,211,81,130
2011-08-06,19,Saturday,Fall,3,Evening Rush,171,57,114
2011-08-06,20,Saturday,Fall,3,Night,137,58,79
2011-08-06,21,Saturday,Fall,2,Night,114,28,86
2011-08-06,22,Saturday,Fall,2,Night,120,24,96
2011-08-06,23,Saturday,Fall,3,Night,108,29,79
2011-08-07,0,Sunday,Fall,2,Early Morning,80,14,66
2011-08-07,1,Sunday,Fall,2,Early Morning,73,10,63
2011-08-07,2,Sunday,Fall,2,Early Morning,66,18,48
2011-08-07,3,Sunday,Fall,2,Early Morning,32,9,23
2011-08-07,4,Sunday,Fall,1,Early Morning,6,1,5
2011-08-07,5,Sunday,Fall,1,Early Morning,5,1,4
2011-08-07,6,Sunday,Fall,1,Morning Rush,13,3,10
2011-08-07,7,Sunday,Fall,1,Morning Rush,39,11,28
2011-08-07,8,Sunday,Fall,1,Morning Rush,89,23,66
2011-08-07,9,Sunday,Fall,1,Morning Rush,184,82,102
2011-08-07,10,Sunday,Fall,1,Mid-Day,266,88,178
2011-08-07,11,Sunday,Fall,1,Mid-Day,269,113,156
2011-08-07,12,Sunday,Fall,1,Mid-Day,370,161,209
2011-08-07,13,Sunday,Fall,1,Mid-Day,324,118,206
2011-08-07,14,Sunday,Fall,1,Mid-Day,322,130,192
2011-08-07,15,Sunday,Fall,3,Mid-Day,326,118,208
2011-08-07,16,Sunday,Fall,3,Evening Rush,193,74,119
2011-08-07,17,Sunday,Fall,3,Evening Rush,194,63,131
2011-08-07,18,Sunday,Fall,1,Evening Rush,229,74,155
2011-08-07,19,Sunday,Fall,1,Evening Rush,228,68,160
2011-08-07,20,Sunday,Fall,1,Night,183,50,133
2011-08-07,21,Sunday,Fall,1,Night,136,36,100
2011-08-07,22,Sunday,Fall,1,Night,103,21,82
2011-08-07,23,Sunday,Fall,1,Night,55,12,43
2011-08-08,0,Monday,Fall,1,Early Morning,30,13,17
2011-08-08,1,Monday,Fall,1,Early Morning,12,4,8
2011-08-08,2,Monday,Fall,1,Early Morning,7,4,3
2011-08-08,3,Monday,Fall,1,Early Morning,1,1,0
2011-08-08,4,Monday,Fall,1,Early Morning,10,2,8
2011-08-08,5,Monday,Fall,1,Early Morning,15,1,14
2011-08-08,6,Monday,Fall,1,Morning Rush,95,8,87
2011-08-08,7,Monday,Fall,1,Morning Rush,267,18,249
2011-08-08,8,Monday,Fall,1,Morning Rush,349,29,320
2011-08-08,9,Monday,Fall,1,Morning Rush,183,37,146
2011-08-08,10,Monday,Fall,1,Mid-Day,124,62,62
2011-08-08,11,Monday,Fall,1,Mid-Day,179,90,89
2011-08-08,12,Monday,Fall,1,Mid-Day,182,48,134
2011-08-08,13,Monday,Fall,1,Mid-Day,151,43,108
2011-08-08,14,Monday,Fall,1,Mid-Day,150,41,109
2011-08-08,15,Monday,Fall,1,Mid-Day,126,40,86
2011-08-08,16,Monday,Fall,1,Evening Rush,282,64,218
2011-08-08,17,Monday,Fall,1,Evening Rush,527,67,460
2011-08-08,18,Monday,Fall,1,Evening Rush,529,64,465
2011-08-08,19,Monday,Fall,1,Evening Rush,416,64,352
2011-08-08,20,Monday,Fall,1,Night,286,71,215
2011-08-08,21,Monday,Fall,1,Night,186,30,156
2011-08-08,22,Monday,Fall,1,Night,147,26,121
2011-08-08,23,Monday,Fall,1,Night,72,19,53
2011-08-09,0,Tuesday,Fall,1,Early Morning,35,10,25
2011-08-09,1,Tuesday,Fall,1,Early Morning,14,5,9
2011-08-09,2,Tuesday,Fall,1,Early Morning,12,9,3
2011-08-09,3,Tuesday,Fall,1,Early Morning,3,0,3
2011-08-09,4,Tuesday,Fall,1,Early Morning,7,1,6
2011-08-09,5,Tuesday,Fall,1,Early Morning,30,5,25
2011-08-09,6,Tuesday,Fall,1,Morning Rush,101,6,95
2011-08-09,7,Tuesday,Fall,1,Morning Rush,343,30,313
2011-08-09,8,Tuesday,Fall,1,Morning Rush,392,40,352
2011-08-09,9,Tuesday,Fall,2,Morning Rush,175,34,141
2011-08-09,10,Tuesday,Fall,2,Mid-Day,144,55,89
2011-08-09,11,Tuesday,Fall,1,Mid-Day,149,61,88
2011-08-09,12,Tuesday,Fall,1,Mid-Day,185,60,125
2011-08-09,13,Tuesday,Fall,1,Mid-Day,175,48,127
2011-08-09,14,Tuesday,Fall,1,Mid-Day,148,53,95
2011-08-09,15,Tuesday,Fall,1,Mid-Day,164,58,106
2011-08-09,16,Tuesday,Fall,1,Evening Rush,285,57,228
2011-08-09,17,Tuesday,Fall,1,Evening Rush,532,79,453
2011-08-09,18,Tuesday,Fall,1,Evening Rush,585,97,488
2011-08-09,19,Tuesday,Fall,1,Evening Rush,371,69,302
2011-08-09,20,Tuesday,Fall,1,Night,292,34,258
2011-08-09,21,Tuesday,Fall,1,Night,230,46,184
2011-08-09,22,Tuesday,Fall,1,Night,155,28,127
2011-08-09,23,Tuesday,Fall,1,Night,75,22,53
2011-08-10,0,Wednesday,Fall,1,Early Morning,37,19,18
2011-08-10,1,Wednesday,Fall,1,Early Morning,17,7,10
2011-08-10,2,Wednesday,Fall,1,Early Morning,11,1,10
2011-08-10,3,Wednesday,Fall,1,Early Morning,4,1,3
2011-08-10,4,Wednesday,Fall,1,Early Morning,5,1,4
2011-08-10,5,Wednesday,Fall,1,Early Morning,32,2,30
2011-08-10,6,Wednesday,Fall,1,Morning Rush,119,9,110
2011-08-10,7,Wednesday,Fall,1,Morning Rush,305,16,289
2011-08-10,8,Wednesday,Fall,1,Morning Rush,399,38,361
2011-08-10,9,Wednesday,Fall,1,Morning Rush,180,32,148
2011-08-10,10,Wednesday,Fall,1,Mid-Day,113,41,72
2011-08-10,11,Wednesday,Fall,1,Mid-Day,149,54,95
2011-08-10,12,Wednesday,Fall,1,Mid-Day,240,74,166
2011-08-10,13,Wednesday,Fall,1,Mid-Day,191,41,150
2011-08-10,14,Wednesday,Fall,1,Mid-Day,178,62,116
2011-08-10,15,Wednesday,Fall,1,Mid-Day,194,53,141
2011-08-10,16,Wednesday,Fall,1,Evening Rush,282,76,206
2011-08-10,17,Wednesday,Fall,1,Evening Rush,584,71,513
2011-08-10,18,Wednesday,Fall,1,Evening Rush,559,70,489
2011-08-10,19,Wednesday,Fall,1,Evening Rush,413,79,334
2011-08-10,20,Wednesday,Fall,1,Night,312,59,253
2011-08-10,21,Wednesday,Fall,1,Night,209,47,162
2011-08-10,22,Wednesday,Fall,1,Night,139,17,122
2011-08-10,23,Wednesday,Fall,1,Night,108,14,94
2011-08-11,0,Thursday,Fall,1,Early Morning,46,6,40
2011-08-11,1,Thursday,Fall,1,Early Morning,26,9,17
2011-08-11,2,Thursday,Fall,1,Early Morning,11,3,8
2011-08-11,3,Thursday,Fall,1,Early Morning,9,2,7
2011-08-11,4,Thursday,Fall,1,Early Morning,5,1,4
2011-08-11,5,Thursday,Fall,1,Early Morning,25,2,23
2011-08-11,6,Thursday,Fall,1,Morning Rush,106,5,101
2011-08-11,7,Thursday,Fall,1,Morning Rush,307,15,292
2011-08-11,8,Thursday,Fall,1,Morning Rush,390,29,361
2011-08-11,9,Thursday,Fall,1,Morning Rush,197,31,166
2011-08-11,10,Thursday,Fall,1,Mid-Day,132,36,96
2011-08-11,11,Thursday,Fall,1,Mid-Day,187,59,128
2011-08-11,12,Thursday,Fall,1,Mid-Day,214,50,164
2011-08-11,13,Thursday,Fall,1,Mid-Day,217,51,166
2011-08-11,14,Thursday,Fall,1,Mid-Day,142,39,103
2011-08-11,15,Thursday,Fall,1,Mid-Day,178,52,126
2011-08-11,16,Thursday,Fall,1,Evening Rush,298,57,241
2011-08-11,17,Thursday,Fall,1,Evening Rush,582,96,486
2011-08-11,18,Thursday,Fall,1,Evening Rush,571,74,497
2011-08-11,19,Thursday,Fall,1,Evening Rush,371,48,323
2011-08-11,20,Thursday,Fall,1,Night,288,56,232
2011-08-11,21,Thursday,Fall,1,Night,206,35,171
2011-08-11,22,Thursday,Fall,1,Night,157,34,123
2011-08-11,23,Thursday,Fall,1,Night,127,22,105
2011-08-12,0,Friday,Fall,1,Early Morning,65,12,53
2011-08-12,1,Friday,Fall,1,Early Morning,23,4,19
2011-08-12,2,Friday,Fall,1,Early Morning,15,0,15
2011-08-12,3,Friday,Fall,1,Early Morning,9,0,9
2011-08-12,4,Friday,Fall,1,Early Morning,5,0,5
2011-08-12,5,Friday,Fall,1,Early Morning,26,2,24
2011-08-12,6,Friday,Fall,1,Morning Rush,76,3,73
2011-08-12,7,Friday,Fall,1,Morning Rush,264,17,247
2011-08-12,8,Friday,Fall,1,Morning Rush,426,29,397
2011-08-12,9,Friday,Fall,1,Morning Rush,205,27,178
2011-08-12,10,Friday,Fall,1,Mid-Day,130,44,86
2011-08-12,11,Friday,Fall,1,Mid-Day,156,48,108
2011-08-12,12,Friday,Fall,1,Mid-Day,222,55,167
2011-08-12,13,Friday,Fall,1,Mid-Day,253,74,179
2011-08-12,14,Friday,Fall,1,Mid-Day,186,51,135
2011-08-12,15,Friday,Fall,1,Mid-Day,249,59,190
2011-08-12,16,Friday,Fall,1,Evening Rush,334,68,266
2011-08-12,17,Friday,Fall,1,Evening Rush,516,93,423
2011-08-12,18,Friday,Fall,1,Evening Rush,465,89,376
2011-08-12,19,Friday,Fall,1,Evening Rush,385,101,284
2011-08-12,20,Friday,Fall,1,Night,287,77,210
2011-08-12,21,Friday,Fall,1,Night,226,73,153
2011-08-12,22,Friday,Fall,1,Night,231,74,157
2011-08-12,23,Friday,Fall,1,Night,151,51,100
2011-08-13,0,Saturday,Fall,1,Early Morning,84,15,69
2011-08-13,1,Saturday,Fall,2,Early Morning,77,13,64
2011-08-13,2,Saturday,Fall,1,Early Morning,74,16,58
2011-08-13,3,Saturday,Fall,1,Early Morning,27,9,18
2011-08-13,4,Saturday,Fall,2,Early Morning,10,5,5
2011-08-13,5,Saturday,Fall,1,Early Morning,18,3,15
2011-08-13,6,Saturday,Fall,1,Morning Rush,22,3,19
2011-08-13,7,Saturday,Fall,2,Morning Rush,44,10,34
2011-08-13,8,Saturday,Fall,2,Morning Rush,118,28,90
2011-08-13,9,Saturday,Fall,2,Morning Rush,208,70,138
2011-08-13,10,Saturday,Fall,2,Mid-Day,260,97,163
2011-08-13,11,Saturday,Fall,2,Mid-Day,314,122,192
2011-08-13,12,Saturday,Fall,2,Mid-Day,421,175,246
2011-08-13,13,Saturday,Fall,2,Mid-Day,153,61,92
2011-08-13,14,Saturday,Fall,1,Mid-Day,259,113,146
2011-08-13,15,Saturday,Fall,3,Mid-Day,358,150,208
2011-08-13,16,Saturday,Fall,2,Evening Rush,281,148,133
2011-08-13,17,Saturday,Fall,2,Evening Rush,269,97,172
2011-08-13,18,Saturday,Fall,1,Evening Rush,292,123,169
2011-08-13,19,Saturday,Fall,2,Evening Rush,237,67,170
2011-08-13,20,Saturday,Fall,2,Night,183,78,105
2011-08-13,21,Saturday,Fall,2,Night,167,40,127
2011-08-13,22,Saturday,Fall,2,Night,154,36,118
2011-08-13,23,Saturday,Fall,2,Night,120,25,95
2011-08-14,0,Sunday,Fall,3,Early Morning,90,19,71
2011-08-14,1,Sunday,Fall,3,Early Morning,73,16,57
2011-08-14,2,Sunday,Fall,3,Early Morning,62,13,49
2011-08-14,3,Sunday,Fall,2,Early Morning,27,5,22
2011-08-14,4,Sunday,Fall,3,Early Morning,3,1,2
2011-08-14,5,Sunday,Fall,2,Early Morning,10,1,9
2011-08-14,6,Sunday,Fall,2,Morning Rush,6,2,4
2011-08-14,7,Sunday,Fall,2,Morning Rush,24,4,20
2011-08-14,8,Sunday,Fall,2,Morning Rush,41,20,21
2011-08-14,9,Sunday,Fall,3,Morning Rush,103,27,76
2011-08-14,10,Sunday,Fall,1,Mid-Day,183,67,116
2011-08-14,11,Sunday,Fall,1,Mid-Day,198,81,117
2011-08-14,12,Sunday,Fall,2,Mid-Day,281,98,183
2011-08-14,13,Sunday,Fall,1,Mid-Day,377,144,233
2011-08-14,14,Sunday,Fall,1,Mid-Day,370,126,244
2011-08-14,15,Sunday,Fall,1,Mid-Day,331,128,203
2011-08-14,16,Sunday,Fall,1,Evening Rush,292,116,176
2011-08-14,17,Sunday,Fall,1,Evening Rush,329,133,196
2011-08-14,18,Sunday,Fall,1,Evening Rush,347,125,222
2011-08-14,19,Sunday,Fall,1,Evening Rush,259,75,184
2011-08-14,20,Sunday,Fall,1,Night,193,67,126
2011-08-14,21,Sunday,Fall,3,Night,155,51,104
2011-08-14,22,Sunday,Fall,3,Night,39,14,25
2011-08-14,23,Sunday,Fall,3,Night,27,5,22
2011-08-15,0,Monday,Fall,3,Early Morning,25,7,18
2011-08-15,1,Monday,Fall,2,Early Morning,10,1,9
2011-08-15,2,Monday,Fall,2,Early Morning,3,0,3
2011-08-15,3,Monday,Fall,1,Early Morning,7,1,6
2011-08-15,4,Monday,Fall,1,Early Morning,5,1,4
2011-08-15,5,Monday,Fall,2,Early Morning,17,3,14
2011-08-15,6,Monday,Fall,1,Morning Rush,90,3,87
2011-08-15,7,Monday,Fall,1,Morning Rush,258,10,248
2011-08-15,8,Monday,Fall,1,Morning Rush,355,29,326
2011-08-15,9,Monday,Fall,1,Morning Rush,222,52,170
2011-08-15,10,Monday,Fall,1,Mid-Day,141,54,87
2011-08-15,11,Monday,Fall,2,Mid-Day,153,41,112
2011-08-15,12,Monday,Fall,1,Mid-Day,178,62,116
2011-08-15,13,Monday,Fall,1,Mid-Day,193,53,140
2011-08-15,14,Monday,Fall,1,Mid-Day,151,56,95
2011-08-15,15,Monday,Fall,3,Mid-Day,182,49,133
2011-08-15,16,Monday,Fall,1,Evening Rush,283,58,225
2011-08-15,17,Monday,Fall,1,Evening Rush,530,59,471
2011-08-15,18,Monday,Fall,1,Evening Rush,483,70,413
2011-08-15,19,Monday,Fall,1,Evening Rush,397,54,343
2011-08-15,20,Monday,Fall,1,Night,285,45,240
2011-08-15,21,Monday,Fall,1,Night,184,34,150
2011-08-15,22,Monday,Fall,1,Night,98,22,76
2011-08-15,23,Monday,Fall,1,Night,88,11,77
2011-08-16,0,Tuesday,Fall,1,Early Morning,31,8,23
2011-08-16,1,Tuesday,Fall,1,Early Morning,16,4,12
2011-08-16,2,Tuesday,Fall,1,Early Morning,4,1,3
2011-08-16,3,Tuesday,Fall,1,Early Morning,6,1,5
2011-08-16,4,Tuesday,Fall,1,Early Morning,5,0,5
2011-08-16,5,Tuesday,Fall,1,Early Morning,30,1,29
2011-08-16,6,Tuesday,Fall,1,Morning Rush,119,4,115
2011-08-16,7,Tuesday,Fall,1,Morning Rush,346,18,328
2011-08-16,8,Tuesday,Fall,1,Morning Rush,441,24,417
2011-08-16,9,Tuesday,Fall,1,Morning Rush,198,27,171
2011-08-16,10,Tuesday,Fall,1,Mid-Day,111,28,83
2011-08-16,11,Tuesday,Fall,1,Mid-Day,150,40,110
2011-08-16,12,Tuesday,Fall,1,Mid-Day,162,42,120
2011-08-16,13,Tuesday,Fall,1,Mid-Day,192,45,147
2011-08-16,14,Tuesday,Fall,1,Mid-Day,182,65,117
2011-08-16,15,Tuesday,Fall,1,Mid-Day,159,36,123
2011-08-16,16,Tuesday,Fall,1,Evening Rush,303,55,248
2011-08-16,17,Tuesday,Fall,1,Evening Rush,600,75,525
2011-08-16,18,Tuesday,Fall,1,Evening Rush,570,54,516
2011-08-16,19,Tuesday,Fall,1,Evening Rush,376,56,320
2011-08-16,20,Tuesday,Fall,1,Night,280,48,232
2011-08-16,21,Tuesday,Fall,1,Night,215,38,177
2011-08-16,22,Tuesday,Fall,1,Night,152,31,121
2011-08-16,23,Tuesday,Fall,1,Night,77,20,57
2011-08-17,0,Wednesday,Fall,1,Early Morning,24,8,16
2011-08-17,1,Wednesday,Fall,1,Early Morning,14,2,12
2011-08-17,2,Wednesday,Fall,1,Early Morning,6,0,6
2011-08-17,3,Wednesday,Fall,1,Early Morning,5,1,4
2011-08-17,4,Wednesday,Fall,1,Early Morning,5,0,5
2011-08-17,5,Wednesday,Fall,1,Early Morning,28,0,28
2011-08-17,6,Wednesday,Fall,1,Morning Rush,105,4,101
2011-08-17,7,Wednesday,Fall,1,Morning Rush,308,12,296
2011-08-17,8,Wednesday,Fall,1,Morning Rush,487,35,452
2011-08-17,9,Wednesday,Fall,1,Morning Rush,209,31,178
2011-08-17,10,Wednesday,Fall,1,Mid-Day,118,27,91
2011-08-17,11,Wednesday,Fall,1,Mid-Day,128,20,108
2011-08-17,12,Wednesday,Fall,1,Mid-Day,189,26,163
2011-08-17,13,Wednesday,Fall,1,Mid-Day,176,38,138
2011-08-17,14,Wednesday,Fall,1,Mid-Day,192,54,138
2011-08-17,15,Wednesday,Fall,1,Mid-Day,159,42,117
2011-08-17,16,Wednesday,Fall,1,Evening Rush,300,62,238
2011-08-17,17,Wednesday,Fall,1,Evening Rush,552,46,506
2011-08-17,18,Wednesday,Fall,1,Evening Rush,556,86,470
2011-08-17,19,Wednesday,Fall,1,Evening Rush,347,50,297
2011-08-17,20,Wednesday,Fall,1,Night,280,37,243
2011-08-17,21,Wednesday,Fall,1,Night,230,38,192
2011-08-17,22,Wednesday,Fall,1,Night,171,29,142
2011-08-17,23,Wednesday,Fall,1,Night,105,20,85
2011-08-18,0,Thursday,Fall,1,Early Morning,56,18,38
2011-08-18,1,Thursday,Fall,2,Early Morning,24,13,11
2011-08-18,2,Thursday,Fall,1,Early Morning,6,2,4
2011-08-18,3,Thursday,Fall,1,Early Morning,6,0,6
2011-08-18,4,Thursday,Fall,1,Early Morning,9,0,9
2011-08-18,5,Thursday,Fall,1,Early Morning,27,0,27
2011-08-18,6,Thursday,Fall,2,Morning Rush,103,6,97
2011-08-18,7,Thursday,Fall,1,Morning Rush,308,19,289
2011-08-18,8,Thursday,Fall,1,Morning Rush,420,27,393
2011-08-18,9,Thursday,Fall,1,Morning Rush,228,42,186
2011-08-18,10,Thursday,Fall,1,Mid-Day,129,37,92
2011-08-18,11,Thursday,Fall,1,Mid-Day,141,44,97
2011-08-18,12,Thursday,Fall,1,Mid-Day,173,34,139
2011-08-18,13,Thursday,Fall,1,Mid-Day,187,33,154
2011-08-18,14,Thursday,Fall,1,Mid-Day,182,67,115
2011-08-18,15,Thursday,Fall,1,Mid-Day,174,56,118
2011-08-18,16,Thursday,Fall,1,Evening Rush,245,49,196
2011-08-18,17,Thursday,Fall,3,Evening Rush,409,44,365
2011-08-18,18,Thursday,Fall,3,Evening Rush,274,48,226
2011-08-18,19,Thursday,Fall,1,Evening Rush,141,26,115
2011-08-18,20,Thursday,Fall,1,Night,165,24,141
2011-08-18,21,Thursday,Fall,2,Night,149,12,137
2011-08-18,22,Thursday,Fall,2,Night,135,18,117
2011-08-18,23,Thursday,Fall,2,Night,114,20,94
2011-08-19,0,Friday,Fall,3,Early Morning,62,9,53
2011-08-19,1,Friday,Fall,3,Early Morning,20,1,19
2011-08-19,2,Friday,Fall,3,Early Morning,8,0,8
2011-08-19,3,Friday,Fall,1,Early Morning,3,2,1
2011-08-19,4,Friday,Fall,1,Early Morning,8,1,7
2011-08-19,5,Friday,Fall,1,Early Morning,17,1,16
2011-08-19,6,Friday,Fall,1,Morning Rush,93,2,91
2011-08-19,7,Friday,Fall,2,Morning Rush,263,12,251
2011-08-19,8,Friday,Fall,2,Morning Rush,398,30,368
2011-08-19,9,Friday,Fall,1,Morning Rush,218,31,187
2011-08-19,10,Friday,Fall,1,Mid-Day,165,57,108
2011-08-19,11,Friday,Fall,2,Mid-Day,165,45,120
2011-08-19,12,Friday,Fall,2,Mid-Day,222,54,168
2011-08-19,13,Friday,Fall,2,Mid-Day,232,63,169
2011-08-19,14,Friday,Fall,1,Mid-Day,220,78,142
2011-08-19,15,Friday,Fall,1,Mid-Day,222,66,156
2011-08-19,16,Friday,Fall,1,Evening Rush,327,66,261
2011-08-19,17,Friday,Fall,1,Evening Rush,527,85,442
2011-08-19,18,Friday,Fall,1,Evening Rush,425,88,337
2011-08-19,19,Friday,Fall,3,Evening Rush,165,33,132
2011-08-19,20,Friday,Fall,3,Night,58,12,46
2011-08-19,21,Friday,Fall,1,Night,107,18,89
2011-08-19,22,Friday,Fall,1,Night,122,25,97
2011-08-19,23,Friday,Fall,2,Night,106,18,88
2011-08-20,0,Saturday,Fall,1,Early Morning,128,21,107
2011-08-20,1,Saturday,Fall,1,Early Morning,47,12,35
2011-08-20,2,Saturday,Fall,1,Early Morning,69,10,59
2011-08-20,3,Saturday,Fall,1,Early Morning,51,9,42
2011-08-20,4,Saturday,Fall,2,Early Morning,7,1,6
2011-08-20,5,Saturday,Fall,1,Early Morning,8,0,8
2011-08-20,6,Saturday,Fall,2,Morning Rush,24,6,18
2011-08-20,7,Saturday,Fall,1,Morning Rush,44,8,36
2011-08-20,8,Saturday,Fall,1,Morning Rush,133,27,106
2011-08-20,9,Saturday,Fall,1,Morning Rush,190,51,139
2011-08-20,10,Saturday,Fall,1,Mid-Day,306,114,192
2011-08-20,11,Saturday,Fall,1,Mid-Day,338,115,223
2011-08-20,12,Saturday,Fall,1,Mid-Day,409,156,253
2011-08-20,13,Saturday,Fall,1,Mid-Day,378,158,220
2011-08-20,14,Saturday,Fall,1,Mid-Day,375,147,228
2011-08-20,15,Saturday,Fall,1,Mid-Day,390,175,215
2011-08-20,16,Saturday,Fall,1,Evening Rush,373,151,222
2011-08-20,17,Saturday,Fall,1,Evening Rush,383,180,203
2011-08-20,18,Saturday,Fall,1,Evening Rush,394,169,225
2011-08-20,19,Saturday,Fall,1,Evening Rush,291,109,182
2011-08-20,20,Saturday,Fall,1,Night,248,78,170
2011-08-20,21,Saturday,Fall,1,Night,225,81,144
2011-08-20,22,Saturday,Fall,2,Night,223,77,146
2011-08-20,23,Saturday,Fall,1,Night,157,59,98
2011-08-21,0,Sunday,Fall,1,Early Morning,74,6,68
2011-08-21,1,Sunday,Fall,1,Early Morning,86,17,69
2011-08-21,2,Sunday,Fall,1,Early Morning,64,13,51
2011-08-21,3,Sunday,Fall,1,Early Morning,51,25,26
2011-08-21,4,Sunday,Fall,1,Early Morning,6,1,5
2011-08-21,5,Sunday,Fall,1,Early Morning,8,0,8
2011-08-21,6,Sunday,Fall,1,Morning Rush,14,4,10
2011-08-21,7,Sunday,Fall,1,Morning Rush,31,12,19
2011-08-21,8,Sunday,Fall,1,Morning Rush,92,30,62
2011-08-21,9,Sunday,Fall,1,Morning Rush,231,80,151
2011-08-21,10,Sunday,Fall,1,Mid-Day,274,97,177
2011-08-21,11,Sunday,Fall,1,Mid-Day,313,132,181
2011-08-21,12,Sunday,Fall,1,Mid-Day,374,135,239
2011-08-21,13,Sunday,Fall,1,Mid-Day,310,94,216
2011-08-21,14,Sunday,Fall,3,Mid-Day,235,78,157
2011-08-21,15,Sunday,Fall,1,Mid-Day,68,17,51
2011-08-21,16,Sunday,Fall,1,Evening Rush,258,97,161
2011-08-21,17,Sunday,Fall,1,Evening Rush,270,91,179
2011-08-21,18,Sunday,Fall,1,Evening Rush,311,96,215
2011-08-21,19,Sunday,Fall,1,Evening Rush,282,81,201
2011-08-21,20,Sunday,Fall,1,Night,181,41,140
2011-08-21,21,Sunday,Fall,1,Night,138,45,93
2011-08-21,22,Sunday,Fall,2,Night,134,37,97
2011-08-21,23,Sunday,Fall,1,Night,68,20,48
2011-08-22,0,Monday,Fall,1,Early Morning,40,18,22
2011-08-22,1,Monday,Fall,1,Early Morning,21,8,13
2011-08-22,2,Monday,Fall,2,Early Morning,8,2,6
2011-08-22,3,Monday,Fall,3,Early Morning,5,0,5
2011-08-22,4,Monday,Fall,1,Early Morning,12,2,10
2011-08-22,5,Monday,Fall,1,Early Morning,24,1,23
2011-08-22,6,Monday,Fall,1,Morning Rush,112,6,106
2011-08-22,7,Monday,Fall,1,Morning Rush,281,11,270
2011-08-22,8,Monday,Fall,1,Morning Rush,351,20,331
2011-08-22,9,Monday,Fall,1,Morning Rush,187,36,151
2011-08-22,10,Monday,Fall,1,Mid-Day,121,36,85
2011-08-22,11,Monday,Fall,1,Mid-Day,131,46,85
2011-08-22,12,Monday,Fall,1,Mid-Day,207,54,153
2011-08-22,13,Monday,Fall,1,Mid-Day,205,47,158
2011-08-22,14,Monday,Fall,1,Mid-Day,225,88,137
2011-08-22,15,Monday,Fall,1,Mid-Day,199,72,127
2011-08-22,16,Monday,Fall,1,Evening Rush,320,66,254
2011-08-22,17,Monday,Fall,1,Evening Rush,591,82,509
2011-08-22,18,Monday,Fall,1,Evening Rush,609,72,537
2011-08-22,19,Monday,Fall,1,Evening Rush,416,66,350
2011-08-22,20,Monday,Fall,1,Night,268,21,247
2011-08-22,21,Monday,Fall,1,Night,208,28,180
2011-08-22,22,Monday,Fall,1,Night,153,32,121
2011-08-22,23,Monday,Fall,1,Night,64,19,45
2011-08-23,0,Tuesday,Fall,1,Early Morning,35,13,22
2011-08-23,1,Tuesday,Fall,1,Early Morning,19,6,13
2011-08-23,2,Tuesday,Fall,1,Early Morning,6,2,4
2011-08-23,3,Tuesday,Fall,1,Early Morning,6,2,4
2011-08-23,4,Tuesday,Fall,1,Early Morning,5,0,5
2011-08-23,5,Tuesday,Fall,1,Early Morning,36,1,35
2011-08-23,6,Tuesday,Fall,1,Morning Rush,114,3,111
2011-08-23,7,Tuesday,Fall,1,Morning Rush,344,11,333
2011-08-23,8,Tuesday,Fall,2,Morning Rush,504,43,461
2011-08-23,9,Tuesday,Fall,2,Morning Rush,225,34,191
2011-08-23,10,Tuesday,Fall,1,Mid-Day,148,56,92
2011-08-23,11,Tuesday,Fall,1,Mid-Day,186,62,124
2011-08-23,12,Tuesday,Fall,1,Mid-Day,237,60,177
2011-08-23,13,Tuesday,Fall,1,Mid-Day,234,70,164
2011-08-23,14,Tuesday,Fall,1,Mid-Day,651,149,502
2011-08-23,15,Tuesday,Fall,1,Mid-Day,601,178,423
2011-08-23,16,Tuesday,Fall,1,Evening Rush,444,133,311
2011-08-23,17,Tuesday,Fall,1,Evening Rush,472,133,339
2011-08-23,18,Tuesday,Fall,1,Evening Rush,519,98,421
2011-08-23,19,Tuesday,Fall,1,Evening Rush,367,70,297
2011-08-23,20,Tuesday,Fall,1,Night,260,54,206
2011-08-23,21,Tuesday,Fall,1,Night,211,38,173
2011-08-23,22,Tuesday,Fall,1,Night,191,46,145
2011-08-23,23,Tuesday,Fall,1,Night,80,19,61
2011-08-24,0,Wednesday,Fall,1,Early Morning,38,9,29
2011-08-24,1,Wednesday,Fall,1,Early Morning,24,7,17
2011-08-24,2,Wednesday,Fall,1,Early Morning,6,2,4
2011-08-24,3,Wednesday,Fall,1,Early Morning,1,0,1
2011-08-24,4,Wednesday,Fall,1,Early Morning,7,0,7
2011-08-24,5,Wednesday,Fall,1,Early Morning,27,1,26
2011-08-24,6,Wednesday,Fall,1,Morning Rush,108,3,105
2011-08-24,7,Wednesday,Fall,1,Morning Rush,308,11,297
2011-08-24,8,Wednesday,Fall,1,Morning Rush,468,32,436
2011-08-24,9,Wednesday,Fall,1,Morning Rush,213,44,169
2011-08-24,10,Wednesday,Fall,1,Mid-Day,146,51,95
2011-08-24,11,Wednesday,Fall,1,Mid-Day,185,57,128
2011-08-24,12,Wednesday,Fall,1,Mid-Day,235,60,175
2011-08-24,13,Wednesday,Fall,1,Mid-Day,236,56,180
2011-08-24,14,Wednesday,Fall,1,Mid-Day,204,77,127
2011-08-24,15,Wednesday,Fall,1,Mid-Day,204,63,141
2011-08-24,16,Wednesday,Fall,1,Evening Rush,271,49,222
2011-08-24,17,Wednesday,Fall,1,Evening Rush,567,83,484
2011-08-24,18,Wednesday,Fall,1,Evening Rush,621,102,519
2011-08-24,19,Wednesday,Fall,1,Evening Rush,440,93,347
2011-08-24,20,Wednesday,Fall,1,Night,334,45,289
2011-08-24,21,Wednesday,Fall,1,Night,236,47,189
2011-08-24,22,Wednesday,Fall,1,Night,181,41,140
2011-08-24,23,Wednesday,Fall,1,Night,70,16,54
2011-08-25,0,Thursday,Fall,1,Early Morning,52,11,41
2011-08-25,1,Thursday,Fall,1,Early Morning,15,4,11
2011-08-25,2,Thursday,Fall,1,Early Morning,5,3,2
2011-08-25,3,Thursday,Fall,1,Early Morning,4,2,2
2011-08-25,4,Thursday,Fall,1,Early Morning,7,1,6
2011-08-25,5,Thursday,Fall,1,Early Morning,26,1,25
2011-08-25,6,Thursday,Fall,1,Morning Rush,102,1,101
2011-08-25,7,Thursday,Fall,2,Morning Rush,313,17,296
2011-08-25,8,Thursday,Fall,2,Morning Rush,484,23,461
2011-08-25,9,Thursday,Fall,2,Morning Rush,162,21,141
2011-08-25,10,Thursday,Fall,2,Mid-Day,142,37,105
2011-08-25,11,Thursday,Fall,3,Mid-Day,151,39,112
2011-08-25,12,Thursday,Fall,3,Mid-Day,41,9,32
2011-08-25,13,Thursday,Fall,1,Mid-Day,37,7,30
2011-08-25,14,Thursday,Fall,2,Mid-Day,113,27,86
2011-08-25,15,Thursday,Fall,2,Mid-Day,132,28,104
2011-08-25,16,Thursday,Fall,1,Evening Rush,121,16,105
2011-08-25,17,Thursday,Fall,1,Evening Rush,312,28,284
2011-08-25,18,Thursday,Fall,2,Evening Rush,408,31,377
2011-08-25,19,Thursday,Fall,2,Evening Rush,272,31,241
2011-08-25,20,Thursday,Fall,1,Night,225,33,192
2011-08-25,21,Thursday,Fall,1,Night,187,29,158
2011-08-25,22,Thursday,Fall,1,Night,147,21,126
2011-08-25,23,Thursday,Fall,1,Night,84,15,69
2011-08-26,0,Friday,Fall,1,Early Morning,51,9,42
2011-08-26,1,Friday,Fall,1,Early Morning,23,10,13
2011-08-26,2,Friday,Fall,1,Early Morning,20,4,16
2011-08-26,3,Friday,Fall,1,Early Morning,11,3,8
2011-08-26,4,Friday,Fall,1,Early Morning,8,2,6
2011-08-26,5,Friday,Fall,2,Early Morning,26,3,23
2011-08-26,6,Friday,Fall,1,Morning Rush,105,5,100
2011-08-26,7,Friday,Fall,1,Morning Rush,266,3,263
2011-08-26,8,Friday,Fall,1,Morning Rush,404,17,387
2011-08-26,9,Friday,Fall,1,Morning Rush,230,39,191
2011-08-26,10,Friday,Fall,1,Mid-Day,123,34,89
2011-08-26,11,Friday,Fall,2,Mid-Day,214,63,151
2011-08-26,12,Friday,Fall,2,Mid-Day,243,70,173
2011-08-26,13,Friday,Fall,2,Mid-Day,237,72,165
2011-08-26,14,Friday,Fall,1,Mid-Day,219,55,164
2011-08-26,15,Friday,Fall,2,Mid-Day,249,53,196
2011-08-26,16,Friday,Fall,1,Evening Rush,343,50,293
2011-08-26,17,Friday,Fall,1,Evening Rush,489,56,433
2011-08-26,18,Friday,Fall,2,Evening Rush,410,40,370
2011-08-26,19,Friday,Fall,1,Evening Rush,290,55,235
2011-08-26,20,Friday,Fall,1,Night,222,39,183
2011-08-26,21,Friday,Fall,1,Night,190,38,152
2011-08-26,22,Friday,Fall,1,Night,152,26,126
2011-08-26,23,Friday,Fall,1,Night,136,22,114
2011-08-27,0,Saturday,Fall,1,Early Morning,145,33,112
2011-08-27,1,Saturday,Fall,1,Early Morning,64,13,51
2011-08-27,2,Saturday,Fall,1,Early Morning,77,18,59
2011-08-27,3,Saturday,Fall,2,Early Morning,30,8,22
2011-08-27,4,Saturday,Fall,2,Early Morning,4,1,3
2011-08-27,5,Saturday,Fall,2,Early Morning,12,1,11
2011-08-27,6,Saturday,Fall,2,Morning Rush,18,3,15
2011-08-27,7,Saturday,Fall,2,Morning Rush,28,2,26
2011-08-27,8,Saturday,Fall,2,Morning Rush,76,14,62
2011-08-27,9,Saturday,Fall,2,Morning Rush,156,28,128
2011-08-27,10,Saturday,Fall,2,Mid-Day,205,51,154
2011-08-27,11,Saturday,Fall,3,Mid-Day,88,15,73
2011-08-27,12,Saturday,Fall,3,Mid-Day,76,11,65
2011-08-27,13,Saturday,Fall,3,Mid-Day,43,10,33
2011-08-27,14,Saturday,Fall,3,Mid-Day,23,4,19
2011-08-27,15,Saturday,Fall,3,Mid-Day,30,2,28
2011-08-27,16,Saturday,Fall,3,Evening Rush,24,10,14
2011-08-27,17,Saturday,Fall,3,Evening Rush,16,2,14
2011-08-28,7,Sunday,Fall,3,Morning Rush,1,0,1
2011-08-28,8,Sunday,Fall,3,Morning Rush,8,2,6
2011-08-28,9,Sunday,Fall,1,Morning Rush,53,7,46
2011-08-28,10,Sunday,Fall,1,Mid-Day,142,27,115
2011-08-28,11,Sunday,Fall,1,Mid-Day,237,59,178
2011-08-28,12,Sunday,Fall,1,Mid-Day,306,88,218
2011-08-28,13,Sunday,Fall,1,Mid-Day,431,129,302
2011-08-28,14,Sunday,Fall,1,Mid-Day,447,157,290
2011-08-28,15,Sunday,Fall,1,Mid-Day,469,155,314
2011-08-28,16,Sunday,Fall,1,Evening Rush,491,196,295
2011-08-28,17,Sunday,Fall,1,Evening Rush,398,145,253
2011-08-28,18,Sunday,Fall,1,Evening Rush,402,145,257
2011-08-28,19,Sunday,Fall,1,Evening Rush,387,140,247
2011-08-28,20,Sunday,Fall,1,Night,214,64,150
2011-08-28,21,Sunday,Fall,1,Night,186,60,126
2011-08-28,22,Sunday,Fall,1,Night,98,25,73
2011-08-28,23,Sunday,Fall,1,Night,64,16,48
2011-08-29,0,Monday,Fall,1,Early Morning,34,13,21
2011-08-29,1,Monday,Fall,1,Early Morning,20,5,15
2011-08-29,2,Monday,Fall,1,Early Morning,13,8,5
2011-08-29,3,Monday,Fall,1,Early Morning,6,1,5
2011-08-29,4,Monday,Fall,1,Early Morning,3,0,3
2011-08-29,5,Monday,Fall,1,Early Morning,17,0,17
2011-08-29,6,Monday,Fall,1,Morning Rush,102,3,99
2011-08-29,7,Monday,Fall,1,Morning Rush,284,11,273
2011-08-29,8,Monday,Fall,1,Morning Rush,404,20,384
2011-08-29,9,Monday,Fall,1,Morning Rush,188,22,166
2011-08-29,10,Monday,Fall,1,Mid-Day,115,42,73
2011-08-29,11,Monday,Fall,1,Mid-Day,138,38,100
2011-08-29,12,Monday,Fall,2,Mid-Day,207,48,159
2011-08-29,13,Monday,Fall,2,Mid-Day,218,48,170
2011-08-29,14,Monday,Fall,1,Mid-Day,182,55,127
2011-08-29,15,Monday,Fall,1,Mid-Day,220,56,164
2011-08-29,16,Monday,Fall,1,Evening Rush,282,56,226
2011-08-29,17,Monday,Fall,2,Evening Rush,591,67,524
2011-08-29,18,Monday,Fall,1,Evening Rush,547,60,487
2011-08-29,19,Monday,Fall,1,Evening Rush,367,50,317
2011-08-29,20,Monday,Fall,1,Night,277,50,227
2011-08-29,21,Monday,Fall,1,Night,202,34,168
2011-08-29,22,Monday,Fall,1,Night,142,23,119
2011-08-29,23,Monday,Fall,1,Night,75,19,56
2011-08-30,0,Tuesday,Fall,1,Early Morning,27,10,17
2011-08-30,1,Tuesday,Fall,1,Early Morning,13,6,7
2011-08-30,2,Tuesday,Fall,1,Early Morning,10,2,8
2011-08-30,3,Tuesday,Fall,1,Early Morning,4,2,2
2011-08-30,4,Tuesday,Fall,1,Early Morning,6,0,6
2011-08-30,5,Tuesday,Fall,1,Early Morning,28,1,27
2011-08-30,6,Tuesday,Fall,1,Morning Rush,119,4,115
2011-08-30,7,Tuesday,Fall,1,Morning Rush,357,19,338
2011-08-30,8,Tuesday,Fall,1,Morning Rush,493,34,459
2011-08-30,9,Tuesday,Fall,1,Morning Rush,218,38,180
2011-08-30,10,Tuesday,Fall,1,Mid-Day,137,28,109
2011-08-30,11,Tuesday,Fall,1,Mid-Day,175,60,115
2011-08-30,12,Tuesday,Fall,1,Mid-Day,237,65,172
2011-08-30,13,Tuesday,Fall,1,Mid-Day,229,59,170
2011-08-30,14,Tuesday,Fall,1,Mid-Day,209,58,151
2011-08-30,15,Tuesday,Fall,1,Mid-Day,196,34,162
2011-08-30,16,Tuesday,Fall,1,Evening Rush,337,42,295
2011-08-30,17,Tuesday,Fall,1,Evening Rush,611,62,549
2011-08-30,18,Tuesday,Fall,1,Evening Rush,576,60,516
2011-08-30,19,Tuesday,Fall,1,Evening Rush,465,68,397
2011-08-30,20,Tuesday,Fall,1,Night,298,39,259
2011-08-30,21,Tuesday,Fall,1,Night,223,43,180
2011-08-30,22,Tuesday,Fall,1,Night,143,22,121
2011-08-30,23,Tuesday,Fall,1,Night,93,19,74
2011-08-31,0,Wednesday,Fall,1,Early Morning,32,8,24
2011-08-31,1,Wednesday,Fall,1,Early Morning,15,2,13
2011-08-31,2,Wednesday,Fall,1,Early Morning,6,1,5
2011-08-31,3,Wednesday,Fall,1,Early Morning,6,2,4
2011-08-31,4,Wednesday,Fall,1,Early Morning,5,0,5
2011-08-31,5,Wednesday,Fall,1,Early Morning,27,2,25
2011-08-31,6,Wednesday,Fall,1,Morning Rush,111,4,107
2011-08-31,7,Wednesday,Fall,1,Morning Rush,328,12,316
2011-08-31,8,Wednesday,Fall,1,Morning Rush,467,27,440
2011-08-31,9,Wednesday,Fall,1,Morning Rush,244,27,217
2011-08-31,10,Wednesday,Fall,1,Mid-Day,138,33,105
2011-08-31,11,Wednesday,Fall,1,Mid-Day,171,28,143
2011-08-31,12,Wednesday,Fall,1,Mid-Day,260,68,192
2011-08-31,13,Wednesday,Fall,1,Mid-Day,221,39,182
2011-08-31,14,Wednesday,Fall,1,Mid-Day,196,48,148
2011-08-31,15,Wednesday,Fall,1,Mid-Day,172,34,138
2011-08-31,16,Wednesday,Fall,1,Evening Rush,309,46,263
2011-08-31,17,Wednesday,Fall,1,Evening Rush,608,83,525
2011-08-31,18,Wednesday,Fall,1,Evening Rush,565,70,495
2011-08-31,19,Wednesday,Fall,1,Evening Rush,446,53,393
2011-08-31,20,Wednesday,Fall,1,Night,289,30,259
2011-08-31,21,Wednesday,Fall,1,Night,201,27,174
2011-08-31,22,Wednesday,Fall,1,Night,157,20,137
2011-08-31,23,Wednesday,Fall,1,Night,84,24,60
2011-09-01,0,Thursday,Fall,1,Early Morning,51,18,33
2011-09-01,1,Thursday,Fall,1,Early Morning,21,7,14
2011-09-01,2,Thursday,Fall,1,Early Morning,25,14,11
2011-09-01,3,Thursday,Fall,1,Early Morning,14,7,7
2011-09-01,4,Thursday,Fall,1,Early Morning,7,0,7
2011-09-01,5,Thursday,Fall,1,Early Morning,23,1,22
2011-09-01,6,Thursday,Fall,1,Morning Rush,105,2,103
2011-09-01,7,Thursday,Fall,1,Morning Rush,342,7,335
2011-09-01,8,Thursday,Fall,1,Morning Rush,498,31,467
2011-09-01,9,Thursday,Fall,1,Morning Rush,207,29,178
2011-09-01,10,Thursday,Fall,1,Mid-Day,138,46,92
2011-09-01,11,Thursday,Fall,1,Mid-Day,192,51,141
2011-09-01,12,Thursday,Fall,2,Mid-Day,229,64,165
2011-09-01,13,Thursday,Fall,2,Mid-Day,219,50,169
2011-09-01,14,Thursday,Fall,3,Mid-Day,198,54,144
2011-09-01,15,Thursday,Fall,1,Mid-Day,174,39,135
2011-09-01,16,Thursday,Fall,1,Evening Rush,308,55,253
2011-09-01,17,Thursday,Fall,1,Evening Rush,628,61,567
2011-09-01,18,Thursday,Fall,1,Evening Rush,531,69,462
2011-09-01,19,Thursday,Fall,1,Evening Rush,443,79,364
2011-09-01,20,Thursday,Fall,1,Night,280,33,247
2011-09-01,21,Thursday,Fall,2,Night,177,17,160
2011-09-01,22,Thursday,Fall,2,Night,179,34,145
2011-09-01,23,Thursday,Fall,1,Night,126,15,111
2011-09-02,0,Friday,Fall,1,Early Morning,64,6,58
2011-09-02,1,Friday,Fall,3,Early Morning,32,4,28
2011-09-02,2,Friday,Fall,3,Early Morning,20,9,11
2011-09-02,3,Friday,Fall,2,Early Morning,8,4,4
2011-09-02,4,Friday,Fall,1,Early Morning,4,2,2
2011-09-02,5,Friday,Fall,2,Early Morning,20,0,20
2011-09-02,6,Friday,Fall,1,Morning Rush,76,3,73
2011-09-02,7,Friday,Fall,1,Morning Rush,259,6,253
2011-09-02,8,Friday,Fall,1,Morning Rush,456,22,434
2011-09-02,9,Friday,Fall,2,Morning Rush,220,30,190
2011-09-02,10,Friday,Fall,2,Mid-Day,140,34,106
2011-09-02,11,Friday,Fall,2,Mid-Day,192,51,141
2011-09-02,12,Friday,Fall,2,Mid-Day,260,82,178
2011-09-02,13,Friday,Fall,2,Mid-Day,279,72,207
2011-09-02,14,Friday,Fall,2,Mid-Day,283,75,208
2011-09-02,15,Friday,Fall,2,Mid-Day,346,69,277
2011-09-02,16,Friday,Fall,2,Evening Rush,381,82,299
2011-09-02,17,Friday,Fall,2,Evening Rush,455,78,377
2011-09-02,18,Friday,Fall,2,Evening Rush,355,50,305
2011-09-02,19,Friday,Fall,1,Evening Rush,287,67,220
2011-09-02,20,Friday,Fall,1,Night,196,38,158
2011-09-02,21,Friday,Fall,2,Night,149,28,121
2011-09-02,22,Friday,Fall,2,Night,147,33,114
2011-09-02,23,Friday,Fall,2,Night,98,30,68
2011-09-03,0,Saturday,Fall,2,Early Morning,87,22,65
2011-09-03,1,Saturday,Fall,2,Early Morning,74,17,57
2011-09-03,2,Saturday,Fall,2,Early Morning,41,15,26
2011-09-03,3,Saturday,Fall,1,Early Morning,35,17,18
2011-09-03,4,Saturday,Fall,1,Early Morning,7,3,4
2011-09-03,5,Saturday,Fall,1,Early Morning,12,3,9
2011-09-03,6,Saturday,Fall,1,Morning Rush,23,4,19
2011-09-03,7,Saturday,Fall,1,Morning Rush,38,5,33
2011-09-03,8,Saturday,Fall,1,Morning Rush,89,24,65
2011-09-03,9,Saturday,Fall,2,Morning Rush,201,83,118
2011-09-03,10,Saturday,Fall,3,Mid-Day,258,90,168
2011-09-03,11,Saturday,Fall,3,Mid-Day,194,66,128
2011-09-03,12,Saturday,Fall,1,Mid-Day,257,97,160
2011-09-03,13,Saturday,Fall,1,Mid-Day,353,153,200
2011-09-03,14,Saturday,Fall,2,Mid-Day,380,204,176
2011-09-03,15,Saturday,Fall,1,Mid-Day,388,187,201
2011-09-03,16,Saturday,Fall,1,Evening Rush,374,186,188
2011-09-03,17,Saturday,Fall,1,Evening Rush,371,170,201
2011-09-03,18,Saturday,Fall,1,Evening Rush,339,160,179
2011-09-03,19,Saturday,Fall,1,Evening Rush,295,147,148
2011-09-03,20,Saturday,Fall,1,Night,219,99,120
2011-09-03,21,Saturday,Fall,1,Night,164,71,93
2011-09-03,22,Saturday,Fall,1,Night,162,66,96
2011-09-03,23,Saturday,Fall,1,Night,123,46,77
2011-09-04,0,Sunday,Fall,1,Early Morning,109,33,76
2011-09-04,1,Sunday,Fall,1,Early Morning,75,37,38
2011-09-04,2,Sunday,Fall,1,Early Morning,60,17,43
2011-09-04,3,Sunday,Fall,1,Early Morning,43,20,23
2011-09-04,4,Sunday,Fall,1,Early Morning,4,0,4
2011-09-04,5,Sunday,Fall,1,Early Morning,6,1,5
2011-09-04,6,Sunday,Fall,1,Morning Rush,3,0,3
2011-09-04,7,Sunday,Fall,1,Morning Rush,30,10,20
2011-09-04,8,Sunday,Fall,1,Morning Rush,70,21,49
2011-09-04,9,Sunday,Fall,1,Morning Rush,189,87,102
2011-09-04,10,Sunday,Fall,1,Mid-Day,297,150,147
2011-09-04,11,Sunday,Fall,1,Mid-Day,337,174,163
2011-09-04,12,Sunday,Fall,1,Mid-Day,435,214,221
2011-09-04,13,Sunday,Fall,2,Mid-Day,419,245,174
2011-09-04,14,Sunday,Fall,1,Mid-Day,361,205,156
2011-09-04,15,Sunday,Fall,1,Mid-Day,410,218,192
2011-09-04,16,Sunday,Fall,1,Evening Rush,337,196,141
2011-09-04,17,Sunday,Fall,1,Evening Rush,376,204,172
2011-09-04,18,Sunday,Fall,1,Evening Rush,356,187,169
2011-09-04,19,Sunday,Fall,1,Evening Rush,328,178,150
2011-09-04,20,Sunday,Fall,1,Night,229,104,125
2011-09-04,21,Sunday,Fall,1,Night,207,104,103
2011-09-04,22,Sunday,Fall,2,Night,155,70,85
2011-09-04,23,Sunday,Fall,2,Night,104,46,58
2011-09-05,0,Monday,Fall,2,Early Morning,97,31,66
2011-09-05,1,Monday,Fall,2,Early Morning,54,19,35
2011-09-05,2,Monday,Fall,2,Early Morning,39,17,22
2011-09-05,3,Monday,Fall,2,Early Morning,16,4,12
2011-09-05,4,Monday,Fall,2,Early Morning,8,3,5
2011-09-05,5,Monday,Fall,2,Early Morning,6,2,4
2011-09-05,6,Monday,Fall,2,Morning Rush,11,6,5
2011-09-05,7,Monday,Fall,1,Morning Rush,41,11,30
2011-09-05,8,Monday,Fall,2,Morning Rush,101,45,56
2011-09-05,9,Monday,Fall,3,Morning Rush,152,63,89
2011-09-05,10,Monday,Fall,2,Mid-Day,244,107,137
2011-09-05,11,Monday,Fall,2,Mid-Day,308,101,207
2011-09-05,12,Monday,Fall,2,Mid-Day,353,141,212
2011-09-05,13,Monday,Fall,2,Mid-Day,389,154,235
2011-09-05,14,Monday,Fall,1,Mid-Day,357,145,212
2011-09-05,15,Monday,Fall,2,Mid-Day,253,111,142
2011-09-05,16,Monday,Fall,2,Evening Rush,284,92,192
2011-09-05,17,Monday,Fall,2,Evening Rush,114,37,77
2011-09-05,18,Monday,Fall,1,Evening Rush,123,31,92
2011-09-05,19,Monday,Fall,3,Evening Rush,175,52,123
2011-09-05,20,Monday,Fall,3,Night,82,26,56
2011-09-05,21,Monday,Fall,2,Night,60,20,40
2011-09-05,22,Monday,Fall,2,Night,64,15,49
2011-09-05,23,Monday,Fall,3,Night,20,3,17
2011-09-06,0,Tuesday,Fall,3,Early Morning,8,1,7
2011-09-06,2,Tuesday,Fall,3,Early Morning,2,0,2
2011-09-06,3,Tuesday,Fall,3,Early Morning,1,1,0
2011-09-06,4,Tuesday,Fall,2,Early Morning,4,1,3
2011-09-06,5,Tuesday,Fall,3,Early Morning,21,1,20
2011-09-06,6,Tuesday,Fall,2,Morning Rush,72,0,72
2011-09-06,7,Tuesday,Fall,2,Morning Rush,172,6,166
2011-09-06,8,Tuesday,Fall,3,Morning Rush,364,15,349
2011-09-06,9,Tuesday,Fall,2,Morning Rush,185,18,167
2011-09-06,10,Tuesday,Fall,3,Mid-Day,106,16,90
2011-09-06,11,Tuesday,Fall,3,Mid-Day,89,11,78
2011-09-06,12,Tuesday,Fall,3,Mid-Day,67,16,51
2011-09-06,13,Tuesday,Fall,3,Mid-Day,29,5,24
2011-09-06,14,Tuesday,Fall,3,Mid-Day,24,3,21
2011-09-06,15,Tuesday,Fall,3,Mid-Day,89,18,71
2011-09-06,16,Tuesday,Fall,3,Evening Rush,106,11,95
2011-09-06,17,Tuesday,Fall,2,Evening Rush,291,15,276
2011-09-06,18,Tuesday,Fall,2,Evening Rush,373,22,351
2011-09-06,19,Tuesday,Fall,2,Evening Rush,281,12,269
2011-09-06,20,Tuesday,Fall,3,Night,163,13,150
2011-09-06,21,Tuesday,Fall,3,Night,121,12,109
2011-09-06,22,Tuesday,Fall,2,Night,84,5,79
2011-09-06,23,Tuesday,Fall,3,Night,58,2,56
2011-09-07,0,Wednesday,Fall,2,Early Morning,13,1,12
2011-09-07,1,Wednesday,Fall,3,Early Morning,5,2,3
2011-09-07,2,Wednesday,Fall,2,Early Morning,6,2,4
2011-09-07,3,Wednesday,Fall,3,Early Morning,2,1,1
2011-09-07,4,Wednesday,Fall,3,Early Morning,4,0,4
2011-09-07,5,Wednesday,Fall,2,Early Morning,16,1,15
2011-09-07,6,Wednesday,Fall,3,Morning Rush,75,1,74
2011-09-07,7,Wednesday,Fall,3,Morning Rush,86,3,83
2011-09-07,8,Wednesday,Fall,3,Morning Rush,328,9,319
2011-09-07,9,Wednesday,Fall,3,Morning Rush,190,14,176
2011-09-07,10,Wednesday,Fall,3,Mid-Day,66,3,63
2011-09-07,11,Wednesday,Fall,3,Mid-Day,10,1,9
2011-09-07,12,Wednesday,Fall,3,Mid-Day,22,1,21
2011-09-07,13,Wednesday,Fall,3,Mid-Day,11,2,9
2011-09-07,14,Wednesday,Fall,3,Mid-Day,25,1,24
2011-09-07,15,Wednesday,Fall,3,Mid-Day,58,3,55
2011-09-07,16,Wednesday,Fall,1,Evening Rush,144,7,137
2011-09-07,17,Wednesday,Fall,3,Evening Rush,285,21,264
2011-09-07,18,Wednesday,Fall,3,Evening Rush,237,18,219
2011-09-07,19,Wednesday,Fall,2,Evening Rush,226,14,212
2011-09-07,20,Wednesday,Fall,3,Night,96,3,93
2011-09-07,21,Wednesday,Fall,3,Night,38,4,34
2011-09-07,22,Wednesday,Fall,3,Night,29,3,26
2011-09-07,23,Wednesday,Fall,3,Night,24,3,21
2011-09-08,0,Thursday,Fall,3,Early Morning,14,3,11
2011-09-08,1,Thursday,Fall,3,Early Morning,4,0,4
2011-09-08,3,Thursday,Fall,3,Early Morning,2,0,2
2011-09-08,4,Thursday,Fall,2,Early Morning,3,0,3
2011-09-08,5,Thursday,Fall,3,Early Morning,14,1,13
2011-09-08,6,Thursday,Fall,3,Morning Rush,56,1,55
2011-09-08,7,Thursday,Fall,3,Morning Rush,179,7,172
2011-09-08,8,Thursday,Fall,3,Morning Rush,195,7,188
2011-09-08,9,Thursday,Fall,2,Morning Rush,69,4,65
2011-09-08,10,Thursday,Fall,2,Mid-Day,65,8,57
2011-09-08,11,Thursday,Fall,2,Mid-Day,98,16,82
2011-09-08,12,Thursday,Fall,2,Mid-Day,102,17,85
2011-09-08,13,Thursday,Fall,2,Mid-Day,126,14,112
2011-09-08,14,Thursday,Fall,2,Mid-Day,120,15,105
2011-09-08,15,Thursday,Fall,3,Mid-Day,139,24,115
2011-09-08,16,Thursday,Fall,3,Evening Rush,156,5,151
2011-09-08,17,Thursday,Fall,3,Evening Rush,113,11,102
2011-09-08,18,Thursday,Fall,3,Evening Rush,68,2,66
2011-09-08,19,Thursday,Fall,3,Evening Rush,52,1,51
2011-09-08,20,Thursday,Fall,2,Night,89,6,83
2011-09-08,21,Thursday,Fall,3,Night,82,6,76
2011-09-08,22,Thursday,Fall,3,Night,70,5,65
2011-09-08,23,Thursday,Fall,3,Night,26,0,26
2011-09-09,0,Friday,Fall,3,Early Morning,16,1,15
2011-09-09,1,Friday,Fall,2,Early Morning,8,0,8
2011-09-09,2,Friday,Fall,2,Early Morning,8,1,7
2011-09-09,3,Friday,Fall,2,Early Morning,2,1,1
2011-09-09,4,Friday,Fall,3,Early Morning,3,0,3
2011-09-09,5,Friday,Fall,2,Early Morning,14,0,14
2011-09-09,6,Friday,Fall,2,Morning Rush,57,3,54
2011-09-09,7,Friday,Fall,3,Morning Rush,108,4,104
2011-09-09,8,Friday,Fall,3,Morning Rush,288,12,276
2011-09-09,9,Friday,Fall,3,Morning Rush,136,5,131
2011-09-09,10,Friday,Fall,2,Mid-Day,29,2,27
2011-09-09,11,Friday,Fall,2,Mid-Day,72,6,66
2011-09-09,12,Friday,Fall,1,Mid-Day,75,4,71
2011-09-09,13,Friday,Fall,1,Mid-Day,122,14,108
2011-09-09,14,Friday,Fall,1,Mid-Day,148,29,119
2011-09-09,15,Friday,Fall,1,Mid-Day,188,27,161
2011-09-09,16,Friday,Fall,1,Evening Rush,285,41,244
2011-09-09,17,Friday,Fall,1,Evening Rush,505,54,451
2011-09-09,18,Friday,Fall,1,Evening Rush,410,33,377
2011-09-09,19,Friday,Fall,1,Evening Rush,349,33,316
2011-09-09,20,Friday,Fall,1,Night,210,30,180
2011-09-09,21,Friday,Fall,1,Night,203,49,154
2011-09-09,22,Friday,Fall,1,Night,160,33,127
2011-09-09,23,Friday,Fall,1,Night,148,35,113
2011-09-10,0,Saturday,Fall,1,Early Morning,116,32,84
2011-09-10,1,Saturday,Fall,2,Early Morning,83,16,67
2011-09-10,2,Saturday,Fall,2,Early Morning,64,18,46
2011-09-10,3,Saturday,Fall,1,Early Morning,37,8,29
2011-09-10,4,Saturday,Fall,1,Early Morning,7,3,4
2011-09-10,5,Saturday,Fall,1,Early Morning,8,2,6
2011-09-10,6,Saturday,Fall,1,Morning Rush,6,0,6
2011-09-10,7,Saturday,Fall,1,Morning Rush,52,9,43
2011-09-10,8,Saturday,Fall,1,Morning Rush,119,16,103
2011-09-10,9,Saturday,Fall,1,Morning Rush,207,39,168
2011-09-10,10,Saturday,Fall,1,Mid-Day,318,85,233
2011-09-10,11,Saturday,Fall,1,Mid-Day,360,108,252
2011-09-10,12,Saturday,Fall,1,Mid-Day,404,144,260
2011-09-10,13,Saturday,Fall,1,Mid-Day,370,131,239
2011-09-10,14,Saturday,Fall,1,Mid-Day,359,129,230
2011-09-10,15,Saturday,Fall,1,Mid-Day,480,217,263
2011-09-10,16,Saturday,Fall,1,Evening Rush,431,170,261
2011-09-10,17,Saturday,Fall,1,Evening Rush,460,185,275
2011-09-10,18,Saturday,Fall,1,Evening Rush,360,119,241
2011-09-10,19,Saturday,Fall,1,Evening Rush,315,101,214
2011-09-10,20,Saturday,Fall,1,Night,245,78,167
2011-09-10,21,Saturday,Fall,1,Night,230,59,171
2011-09-10,22,Saturday,Fall,1,Night,175,49,126
2011-09-10,23,Saturday,Fall,2,Night,139,32,107
2011-09-11,0,Sunday,Fall,1,Early Morning,108,29,79
2011-09-11,1,Sunday,Fall,2,Early Morning,88,22,66
2011-09-11,2,Sunday,Fall,2,Early Morning,76,16,60
2011-09-11,3,Sunday,Fall,2,Early Morning,45,15,30
2011-09-11,4,Sunday,Fall,1,Early Morning,9,3,6
2011-09-11,5,Sunday,Fall,1,Early Morning,39,15,24
2011-09-11,6,Sunday,Fall,1,Morning Rush,20,4,16
2011-09-11,7,Sunday,Fall,1,Morning Rush,37,9,28
2011-09-11,8,Sunday,Fall,1,Morning Rush,94,25,69
2011-09-11,9,Sunday,Fall,1,Morning Rush,227,59,168
2011-09-11,10,Sunday,Fall,1,Mid-Day,334,120,214
2011-09-11,11,Sunday,Fall,1,Mid-Day,402,144,258
2011-09-11,12,Sunday,Fall,1,Mid-Day,411,113,298
2011-09-11,13,Sunday,Fall,1,Mid-Day,350,119,231
2011-09-11,14,Sunday,Fall,1,Mid-Day,342,120,222
2011-09-11,15,Sunday,Fall,1,Mid-Day,404,134,270
2011-09-11,16,Sunday,Fall,1,Evening Rush,483,180,303
2011-09-11,17,Sunday,Fall,1,Evening Rush,380,152,228
2011-09-11,18,Sunday,Fall,1,Evening Rush,339,110,229
2011-09-11,19,Sunday,Fall,1,Evening Rush,333,101,232
2011-09-11,20,Sunday,Fall,1,Night,226,65,161
2011-09-11,21,Sunday,Fall,1,Night,159,45,114
2011-09-11,22,Sunday,Fall,1,Night,95,21,74
2011-09-11,23,Sunday,Fall,3,Night,45,12,33
2011-09-12,0,Monday,Fall,1,Early Morning,16,5,11
2011-09-12,1,Monday,Fall,1,Early Morning,12,1,11
2011-09-12,2,Monday,Fall,1,Early Morning,2,2,0
2011-09-12,4,Monday,Fall,1,Early Morning,4,0,4
2011-09-12,5,Monday,Fall,1,Early Morning,24,1,23
2011-09-12,6,Monday,Fall,1,Morning Rush,109,1,108
2011-09-12,7,Monday,Fall,1,Morning Rush,312,12,300
2011-09-12,8,Monday,Fall,1,Morning Rush,408,26,382
2011-09-12,9,Monday,Fall,1,Morning Rush,176,21,155
2011-09-12,10,Monday,Fall,1,Mid-Day,129,40,89
2011-09-12,11,Monday,Fall,1,Mid-Day,165,34,131
2011-09-12,12,Monday,Fall,1,Mid-Day,184,37,147
2011-09-12,13,Monday,Fall,1,Mid-Day,163,43,120
2011-09-12,14,Monday,Fall,1,Mid-Day,189,60,129
2011-09-12,15,Monday,Fall,1,Mid-Day,212,60,152
2011-09-12,16,Monday,Fall,1,Evening Rush,298,60,238
2011-09-12,17,Monday,Fall,1,Evening Rush,590,75,515
2011-09-12,18,Monday,Fall,1,Evening Rush,571,56,515
2011-09-12,19,Monday,Fall,1,Evening Rush,436,63,373
2011-09-12,20,Monday,Fall,1,Night,299,41,258
2011-09-12,21,Monday,Fall,1,Night,195,29,166
2011-09-12,22,Monday,Fall,1,Night,150,16,134
2011-09-12,23,Monday,Fall,1,Night,69,7,62
2011-09-13,0,Tuesday,Fall,1,Early Morning,26,7,19
2011-09-13,1,Tuesday,Fall,1,Early Morning,10,4,6
2011-09-13,2,Tuesday,Fall,1,Early Morning,2,2,0
2011-09-13,3,Tuesday,Fall,1,Early Morning,4,2,2
2011-09-13,4,Tuesday,Fall,1,Early Morning,8,2,6
2011-09-13,5,Tuesday,Fall,1,Early Morning,20,1,19
2011-09-13,6,Tuesday,Fall,1,Morning Rush,122,6,116
2011-09-13,7,Tuesday,Fall,1,Morning Rush,362,14,348
2011-09-13,8,Tuesday,Fall,1,Morning Rush,425,26,399
2011-09-13,9,Tuesday,Fall,1,Morning Rush,214,35,179
2011-09-13,10,Tuesday,Fall,1,Mid-Day,135,42,93
2011-09-13,11,Tuesday,Fall,1,Mid-Day,153,33,120
2011-09-13,12,Tuesday,Fall,1,Mid-Day,187,43,144
2011-09-13,13,Tuesday,Fall,1,Mid-Day,184,48,136
2011-09-13,14,Tuesday,Fall,1,Mid-Day,190,51,139
2011-09-13,15,Tuesday,Fall,1,Mid-Day,180,35,145
2011-09-13,16,Tuesday,Fall,1,Evening Rush,292,41,251
2011-09-13,17,Tuesday,Fall,1,Evening Rush,579,72,507
2011-09-13,18,Tuesday,Fall,1,Evening Rush,539,67,472
2011-09-13,19,Tuesday,Fall,1,Evening Rush,396,55,341
2011-09-13,20,Tuesday,Fall,1,Night,272,31,241
2011-09-13,21,Tuesday,Fall,1,Night,245,45,200
2011-09-13,22,Tuesday,Fall,1,Night,144,24,120
2011-09-13,23,Tuesday,Fall,1,Night,74,15,59
2011-09-14,0,Wednesday,Fall,1,Early Morning,33,5,28
2011-09-14,1,Wednesday,Fall,1,Early Morning,8,1,7
2011-09-14,2,Wednesday,Fall,1,Early Morning,5,1,4
2011-09-14,3,Wednesday,Fall,1,Early Morning,8,1,7
2011-09-14,4,Wednesday,Fall,1,Early Morning,9,1,8
2011-09-14,5,Wednesday,Fall,1,Early Morning,31,1,30
2011-09-14,6,Wednesday,Fall,1,Morning Rush,145,7,138
2011-09-14,7,Wednesday,Fall,1,Morning Rush,370,20,350
2011-09-14,8,Wednesday,Fall,1,Morning Rush,429,33,396
2011-09-14,9,Wednesday,Fall,1,Morning Rush,202,19,183
2011-09-14,10,Wednesday,Fall,1,Mid-Day,142,27,115
2011-09-14,11,Wednesday,Fall,1,Mid-Day,164,43,121
2011-09-14,12,Wednesday,Fall,1,Mid-Day,212,56,156
2011-09-14,13,Wednesday,Fall,1,Mid-Day,178,39,139
2011-09-14,14,Wednesday,Fall,1,Mid-Day,124,19,105
2011-09-14,15,Wednesday,Fall,1,Mid-Day,176,30,146
2011-09-14,16,Wednesday,Fall,1,Evening Rush,277,36,241
2011-09-14,17,Wednesday,Fall,1,Evening Rush,599,87,512
2011-09-14,18,Wednesday,Fall,1,Evening Rush,586,83,503
2011-09-14,19,Wednesday,Fall,2,Evening Rush,381,44,337
2011-09-14,20,Wednesday,Fall,2,Night,261,40,221
2011-09-14,21,Wednesday,Fall,2,Night,213,24,189
2011-09-14,22,Wednesday,Fall,2,Night,160,20,140
2011-09-14,23,Wednesday,Fall,2,Night,72,10,62
2011-09-15,0,Thursday,Fall,1,Early Morning,37,3,34
2011-09-15,1,Thursday,Fall,1,Early Morning,20,0,20
2011-09-15,2,Thursday,Fall,1,Early Morning,5,0,5
2011-09-15,3,Thursday,Fall,1,Early Morning,8,3,5
2011-09-15,4,Thursday,Fall,1,Early Morning,7,2,5
2011-09-15,5,Thursday,Fall,1,Early Morning,31,1,30
2011-09-15,6,Thursday,Fall,2,Morning Rush,124,5,119
2011-09-15,7,Thursday,Fall,2,Morning Rush,338,17,321
2011-09-15,8,Thursday,Fall,1,Morning Rush,391,27,364
2011-09-15,9,Thursday,Fall,2,Morning Rush,209,23,186
2011-09-15,10,Thursday,Fall,2,Mid-Day,121,25,96
2011-09-15,11,Thursday,Fall,2,Mid-Day,159,39,120
2011-09-15,12,Thursday,Fall,2,Mid-Day,179,31,148
2011-09-15,13,Thursday,Fall,2,Mid-Day,189,38,151
2011-09-15,14,Thursday,Fall,2,Mid-Day,170,36,134
2011-09-15,15,Thursday,Fall,2,Mid-Day,135,25,110
2011-09-15,16,Thursday,Fall,2,Evening Rush,222,29,193
2011-09-15,17,Thursday,Fall,3,Evening Rush,261,31,230
2011-09-15,18,Thursday,Fall,3,Evening Rush,244,22,222
2011-09-15,19,Thursday,Fall,1,Evening Rush,232,20,212
2011-09-15,20,Thursday,Fall,1,Night,248,25,223
2011-09-15,21,Thursday,Fall,1,Night,145,11,134
2011-09-15,22,Thursday,Fall,1,Night,115,7,108
2011-09-15,23,Thursday,Fall,1,Night,69,8,61
2011-09-16,0,Friday,Fall,1,Early Morning,48,5,43
2011-09-16,1,Friday,Fall,1,Early Morning,26,7,19
2011-09-16,2,Friday,Fall,1,Early Morning,10,3,7
2011-09-16,3,Friday,Fall,1,Early Morning,6,2,4
2011-09-16,4,Friday,Fall,1,Early Morning,4,1,3
2011-09-16,5,Friday,Fall,1,Early Morning,32,2,30
2011-09-16,6,Friday,Fall,1,Morning Rush,93,6,87
2011-09-16,7,Friday,Fall,1,Morning Rush,299,16,283
2011-09-16,8,Friday,Fall,1,Morning Rush,409,23,386
2011-09-16,9,Friday,Fall,1,Morning Rush,210,21,189
2011-09-16,10,Friday,Fall,2,Mid-Day,140,36,104
2011-09-16,11,Friday,Fall,2,Mid-Day,179,40,139
2011-09-16,12,Friday,Fall,2,Mid-Day,251,39,212
2011-09-16,13,Friday,Fall,2,Mid-Day,223,55,168
2011-09-16,14,Friday,Fall,2,Mid-Day,225,49,176
2011-09-16,15,Friday,Fall,2,Mid-Day,203,38,165
2011-09-16,16,Friday,Fall,2,Evening Rush,358,67,291
2011-09-16,17,Friday,Fall,2,Evening Rush,566,86,480
2011-09-16,18,Friday,Fall,2,Evening Rush,482,55,427
2011-09-16,19,Friday,Fall,2,Evening Rush,315,59,256
2011-09-16,20,Friday,Fall,2,Night,225,41,184
2011-09-16,21,Friday,Fall,2,Night,163,39,124
2011-09-16,22,Friday,Fall,1,Night,167,32,135
2011-09-16,23,Friday,Fall,1,Night,126,20,106
2011-09-17,0,Saturday,Fall,1,Early Morning,108,28,80
2011-09-17,1,Saturday,Fall,1,Early Morning,80,28,52
2011-09-17,2,Saturday,Fall,1,Early Morning,79,18,61
2011-09-17,3,Saturday,Fall,1,Early Morning,28,7,21
2011-09-17,4,Saturday,Fall,1,Early Morning,5,1,4
2011-09-17,5,Saturday,Fall,1,Early Morning,5,2,3
2011-09-17,6,Saturday,Fall,2,Morning Rush,22,5,17
2011-09-17,7,Saturday,Fall,2,Morning Rush,37,4,33
2011-09-17,8,Saturday,Fall,2,Morning Rush,108,27,81
2011-09-17,9,Saturday,Fall,2,Morning Rush,177,32,145
2011-09-17,10,Saturday,Fall,2,Mid-Day,249,72,177
2011-09-17,11,Saturday,Fall,2,Mid-Day,367,119,248
2011-09-17,12,Saturday,Fall,2,Mid-Day,372,115,257
2011-09-17,13,Saturday,Fall,2,Mid-Day,349,124,225
2011-09-17,14,Saturday,Fall,2,Mid-Day,297,123,174
2011-09-17,15,Saturday,Fall,2,Mid-Day,354,148,206
2011-09-17,16,Saturday,Fall,1,Evening Rush,305,116,189
2011-09-17,17,Saturday,Fall,1,Evening Rush,359,141,218
2011-09-17,18,Saturday,Fall,2,Evening Rush,329,95,234
2011-09-17,19,Saturday,Fall,1,Evening Rush,256,70,186
2011-09-17,20,Saturday,Fall,1,Night,176,43,133
2011-09-17,21,Saturday,Fall,2,Night,170,49,121
2011-09-17,22,Saturday,Fall,1,Night,143,31,112
2011-09-17,23,Saturday,Fall,1,Night,136,36,100
2011-09-18,0,Sunday,Fall,1,Early Morning,112,24,88
2011-09-18,1,Sunday,Fall,1,Early Morning,79,13,66
2011-09-18,2,Sunday,Fall,1,Early Morning,89,21,68
2011-09-18,3,Sunday,Fall,1,Early Morning,36,11,25
2011-09-18,4,Sunday,Fall,1,Early Morning,1,1,0
2011-09-18,5,Sunday,Fall,1,Early Morning,6,1,5
2011-09-18,6,Sunday,Fall,1,Morning Rush,12,2,10
2011-09-18,7,Sunday,Fall,1,Morning Rush,44,15,29
2011-09-18,8,Sunday,Fall,1,Morning Rush,69,16,53
2011-09-18,9,Sunday,Fall,1,Morning Rush,140,46,94
2011-09-18,10,Sunday,Fall,1,Mid-Day,260,82,178
2011-09-18,11,Sunday,Fall,1,Mid-Day,317,116,201
2011-09-18,12,Sunday,Fall,1,Mid-Day,364,135,229
2011-09-18,13,Sunday,Fall,1,Mid-Day,376,162,214
2011-09-18,14,Sunday,Fall,2,Mid-Day,311,127,184
2011-09-18,15,Sunday,Fall,2,Mid-Day,365,132,233
2011-09-18,16,Sunday,Fall,2,Evening Rush,369,134,235
2011-09-18,17,Sunday,Fall,2,Evening Rush,325,95,230
2011-09-18,18,Sunday,Fall,2,Evening Rush,289,66,223
2011-09-18,19,Sunday,Fall,2,Evening Rush,245,54,191
2011-09-18,20,Sunday,Fall,2,Night,180,44,136
2011-09-18,21,Sunday,Fall,2,Night,147,37,110
2011-09-18,22,Sunday,Fall,2,Night,84,9,75
2011-09-18,23,Sunday,Fall,1,Night,54,10,44
2011-09-19,0,Monday,Fall,2,Early Morning,37,14,23
2011-09-19,1,Monday,Fall,2,Early Morning,10,3,7
2011-09-19,2,Monday,Fall,2,Early Morning,13,6,7
2011-09-19,3,Monday,Fall,2,Early Morning,5,1,4
2011-09-19,4,Monday,Fall,2,Early Morning,8,2,6
2011-09-19,5,Monday,Fall,2,Early Morning,28,2,26
2011-09-19,6,Monday,Fall,1,Morning Rush,113,6,107
2011-09-19,7,Monday,Fall,2,Morning Rush,332,20,312
2011-09-19,8,Monday,Fall,2,Morning Rush,420,29,391
2011-09-19,9,Monday,Fall,2,Morning Rush,215,32,183
2011-09-19,10,Monday,Fall,2,Mid-Day,105,21,84
2011-09-19,11,Monday,Fall,2,Mid-Day,139,41,98
2011-09-19,12,Monday,Fall,2,Mid-Day,189,51,138
2011-09-19,13,Monday,Fall,2,Mid-Day,177,53,124
2011-09-19,14,Monday,Fall,2,Mid-Day,188,45,143
2011-09-19,15,Monday,Fall,2,Mid-Day,187,44,143
2011-09-19,16,Monday,Fall,2,Evening Rush,263,55,208
2011-09-19,17,Monday,Fall,2,Evening Rush,568,85,483
2011-09-19,18,Monday,Fall,2,Evening Rush,540,56,484
2011-09-19,19,Monday,Fall,2,Evening Rush,374,41,333
2011-09-19,20,Monday,Fall,2,Night,231,27,204
2011-09-19,21,Monday,Fall,2,Night,200,19,181
2011-09-19,22,Monday,Fall,2,Night,129,25,104
2011-09-19,23,Monday,Fall,2,Night,68,13,55
2011-09-20,0,Tuesday,Fall,2,Early Morning,25,4,21
2011-09-20,1,Tuesday,Fall,2,Early Morning,14,3,11
2011-09-20,2,Tuesday,Fall,2,Early Morning,5,1,4
2011-09-20,3,Tuesday,Fall,2,Early Morning,3,0,3
2011-09-20,4,Tuesday,Fall,1,Early Morning,6,2,4
2011-09-20,5,Tuesday,Fall,2,Early Morning,22,1,21
2011-09-20,6,Tuesday,Fall,2,Morning Rush,114,3,111
2011-09-20,7,Tuesday,Fall,2,Morning Rush,329,23,306
2011-09-20,8,Tuesday,Fall,3,Morning Rush,209,13,196
2011-09-20,9,Tuesday,Fall,3,Morning Rush,69,5,64
2011-09-20,10,Tuesday,Fall,3,Mid-Day,30,4,26
2011-09-20,11,Tuesday,Fall,3,Mid-Day,56,8,48
2011-09-20,12,Tuesday,Fall,2,Mid-Day,60,13,47
2011-09-20,13,Tuesday,Fall,2,Mid-Day,103,22,81
2011-09-20,14,Tuesday,Fall,2,Mid-Day,112,27,85
2011-09-20,15,Tuesday,Fall,2,Mid-Day,192,34,158
2011-09-20,16,Tuesday,Fall,2,Evening Rush,264,23,241
2011-09-20,17,Tuesday,Fall,1,Evening Rush,511,66,445
2011-09-20,18,Tuesday,Fall,1,Evening Rush,492,39,453
2011-09-20,19,Tuesday,Fall,1,Evening Rush,337,43,294
2011-09-20,20,Tuesday,Fall,1,Night,253,41,212
2011-09-20,21,Tuesday,Fall,1,Night,206,29,177
2011-09-20,22,Tuesday,Fall,1,Night,148,23,125
2011-09-20,23,Tuesday,Fall,1,Night,81,11,70
2011-09-21,0,Wednesday,Fall,1,Early Morning,27,7,20
2011-09-21,1,Wednesday,Fall,1,Early Morning,17,0,17
2011-09-21,2,Wednesday,Fall,1,Early Morning,6,1,5
2011-09-21,3,Wednesday,Fall,2,Early Morning,6,0,6
2011-09-21,4,Wednesday,Fall,2,Early Morning,7,2,5
2011-09-21,5,Wednesday,Fall,2,Early Morning,31,1,30
2011-09-21,6,Wednesday,Fall,2,Morning Rush,117,5,112
2011-09-21,7,Wednesday,Fall,2,Morning Rush,330,18,312
2011-09-21,8,Wednesday,Fall,2,Morning Rush,462,18,444
2011-09-21,9,Wednesday,Fall,2,Morning Rush,208,21,187
2011-09-21,10,Wednesday,Fall,2,Mid-Day,133,30,103
2011-09-21,11,Wednesday,Fall,2,Mid-Day,180,42,138
2011-09-21,12,Wednesday,Fall,2,Mid-Day,193,42,151
2011-09-21,13,Wednesday,Fall,2,Mid-Day,181,37,144
2011-09-21,14,Wednesday,Fall,2,Mid-Day,179,40,139
2011-09-21,15,Wednesday,Fall,2,Mid-Day,185,43,142
2011-09-21,16,Wednesday,Fall,2,Evening Rush,281,51,230
2011-09-21,17,Wednesday,Fall,3,Evening Rush,536,61,475
2011-09-21,18,Wednesday,Fall,3,Evening Rush,408,24,384
2011-09-21,19,Wednesday,Fall,3,Evening Rush,283,30,253
2011-09-21,20,Wednesday,Fall,3,Night,160,11,149
2011-09-21,21,Wednesday,Fall,2,Night,200,25,175
2011-09-21,22,Wednesday,Fall,2,Night,127,15,112
2011-09-21,23,Wednesday,Fall,1,Night,95,15,80
2011-09-22,0,Thursday,Fall,1,Early Morning,41,11,30
2011-09-22,1,Thursday,Fall,2,Early Morning,11,5,6
2011-09-22,2,Thursday,Fall,2,Early Morning,10,2,8
2011-09-22,3,Thursday,Fall,2,Early Morning,12,5,7
2011-09-22,4,Thursday,Fall,2,Early Morning,2,0,2
2011-09-22,5,Thursday,Fall,2,Early Morning,30,2,28
2011-09-22,6,Thursday,Fall,2,Morning Rush,101,7,94
2011-09-22,7,Thursday,Fall,2,Morning Rush,311,16,295
2011-09-22,8,Thursday,Fall,2,Morning Rush,415,26,389
2011-09-22,9,Thursday,Fall,2,Morning Rush,203,35,168
2011-09-22,10,Thursday,Fall,2,Mid-Day,120,19,101
2011-09-22,11,Thursday,Fall,2,Mid-Day,165,23,142
2011-09-22,12,Thursday,Fall,2,Mid-Day,176,25,151
2011-09-22,13,Thursday,Fall,2,Mid-Day,193,38,155
2011-09-22,14,Thursday,Fall,2,Mid-Day,183,41,142
2011-09-22,15,Thursday,Fall,2,Mid-Day,181,32,149
2011-09-22,16,Thursday,Fall,2,Evening Rush,301,39,262
2011-09-22,17,Thursday,Fall,2,Evening Rush,563,50,513
2011-09-22,18,Thursday,Fall,2,Evening Rush,551,50,501
2011-09-22,19,Thursday,Fall,2,Evening Rush,420,32,388
2011-09-22,20,Thursday,Fall,2,Night,285,35,250
2011-09-22,21,Thursday,Fall,2,Night,221,27,194
2011-09-22,22,Thursday,Fall,2,Night,187,21,166
2011-09-22,23,Thursday,Fall,2,Night,113,14,99
2011-09-23,0,Friday,Winter,2,Early Morning,52,11,41
2011-09-23,1,Friday,Winter,2,Early Morning,31,2,29
2011-09-23,2,Friday,Winter,2,Early Morning,20,6,14
2011-09-23,3,Friday,Winter,2,Early Morning,8,3,5
2011-09-23,4,Friday,Winter,3,Early Morning,13,6,7
2011-09-23,5,Friday,Winter,2,Early Morning,22,2,20
2011-09-23,6,Friday,Winter,2,Morning Rush,104,5,99
2011-09-23,7,Friday,Winter,3,Morning Rush,254,14,240
2011-09-23,8,Friday,Winter,3,Morning Rush,317,20,297
2011-09-23,9,Friday,Winter,3,Morning Rush,111,3,108
2011-09-23,10,Friday,Winter,3,Mid-Day,35,7,28
2011-09-23,11,Friday,Winter,3,Mid-Day,21,1,20
2011-09-23,12,Friday,Winter,3,Mid-Day,29,1,28
2011-09-23,13,Friday,Winter,3,Mid-Day,34,7,27
2011-09-23,14,Friday,Winter,3,Mid-Day,24,3,21
2011-09-23,15,Friday,Winter,3,Mid-Day,61,9,52
2011-09-23,16,Friday,Winter,3,Evening Rush,56,5,51
2011-09-23,17,Friday,Winter,2,Evening Rush,99,13,86
2011-09-23,18,Friday,Winter,1,Evening Rush,234,14,220
2011-09-23,19,Friday,Winter,1,Evening Rush,248,16,232
2011-09-23,20,Friday,Winter,1,Night,179,21,158
2011-09-23,21,Friday,Winter,1,Night,138,17,121
2011-09-23,22,Friday,Winter,1,Night,157,31,126
2011-09-23,23,Friday,Winter,2,Night,148,41,107
2011-09-24,0,Saturday,Winter,1,Early Morning,93,7,86
2011-09-24,1,Saturday,Winter,2,Early Morning,79,18,61
2011-09-24,2,Saturday,Winter,2,Early Morning,68,14,54
2011-09-24,3,Saturday,Winter,1,Early Morning,31,4,27
2011-09-24,4,Saturday,Winter,1,Early Morning,8,1,7
2011-09-24,5,Saturday,Winter,2,Early Morning,5,2,3
2011-09-24,6,Saturday,Winter,2,Morning Rush,18,6,12
2011-09-24,7,Saturday,Winter,2,Morning Rush,46,12,34
2011-09-24,8,Saturday,Winter,2,Morning Rush,121,19,102
2011-09-24,9,Saturday,Winter,2,Morning Rush,175,41,134
2011-09-24,10,Saturday,Winter,2,Mid-Day,293,90,203
2011-09-24,11,Saturday,Winter,2,Mid-Day,386,118,268
2011-09-24,12,Saturday,Winter,2,Mid-Day,407,141,266
2011-09-24,13,Saturday,Winter,1,Mid-Day,460,170,290
2011-09-24,14,Saturday,Winter,2,Mid-Day,390,164,226
2011-09-24,15,Saturday,Winter,2,Mid-Day,452,168,284
2011-09-24,16,Saturday,Winter,2,Evening Rush,449,167,282
2011-09-24,17,Saturday,Winter,1,Evening Rush,426,180,246
2011-09-24,18,Saturday,Winter,1,Evening Rush,400,157,243
2011-09-24,19,Saturday,Winter,1,Evening Rush,308,77,231
2011-09-24,20,Saturday,Winter,1,Night,243,77,166
2011-09-24,21,Saturday,Winter,1,Night,222,66,156
2011-09-24,22,Saturday,Winter,2,Night,193,50,143
2011-09-24,23,Saturday,Winter,2,Night,150,27,123
2011-09-25,0,Sunday,Winter,2,Early Morning,173,37,136
2011-09-25,1,Sunday,Winter,2,Early Morning,124,31,93
2011-09-25,2,Sunday,Winter,3,Early Morning,106,27,79
2011-09-25,3,Sunday,Winter,3,Early Morning,59,20,39
2011-09-25,4,Sunday,Winter,3,Early Morning,8,3,5
2011-09-25,5,Sunday,Winter,1,Early Morning,3,1,2
2011-09-25,6,Sunday,Winter,2,Morning Rush,17,4,13
2011-09-25,7,Sunday,Winter,2,Morning Rush,38,15,23
2011-09-25,8,Sunday,Winter,2,Morning Rush,86,27,59
2011-09-25,9,Sunday,Winter,2,Morning Rush,155,55,100
2011-09-25,10,Sunday,Winter,2,Mid-Day,275,85,190
2011-09-25,11,Sunday,Winter,2,Mid-Day,361,131,230
2011-09-25,12,Sunday,Winter,2,Mid-Day,413,143,270
2011-09-25,13,Sunday,Winter,2,Mid-Day,369,122,247
2011-09-25,14,Sunday,Winter,2,Mid-Day,347,116,231
2011-09-25,15,Sunday,Winter,2,Mid-Day,353,119,234
2011-09-25,16,Sunday,Winter,1,Evening Rush,464,144,320
2011-09-25,17,Sunday,Winter,1,Evening Rush,420,145,275
2011-09-25,18,Sunday,Winter,1,Evening Rush,404,125,279
2011-09-25,19,Sunday,Winter,1,Evening Rush,329,87,242
2011-09-25,20,Sunday,Winter,1,Night,186,51,135
2011-09-25,21,Sunday,Winter,1,Night,137,24,113
2011-09-25,22,Sunday,Winter,1,Night,104,20,84
2011-09-25,23,Sunday,Winter,2,Night,79,12,67
2011-09-26,0,Monday,Winter,2,Early Morning,29,6,23
2011-09-26,1,Monday,Winter,2,Early Morning,17,3,14
2011-09-26,2,Monday,Winter,2,Early Morning,8,4,4
2011-09-26,3,Monday,Winter,2,Early Morning,5,0,5
2011-09-26,4,Monday,Winter,2,Early Morning,6,2,4
2011-09-26,5,Monday,Winter,2,Early Morning,25,0,25
2011-09-26,6,Monday,Winter,2,Morning Rush,113,6,107
2011-09-26,7,Monday,Winter,2,Morning Rush,332,17,315
2011-09-26,8,Monday,Winter,2,Morning Rush,355,29,326
2011-09-26,9,Monday,Winter,2,Morning Rush,205,44,161
2011-09-26,10,Monday,Winter,2,Mid-Day,154,37,117
2011-09-26,11,Monday,Winter,1,Mid-Day,159,43,116
2011-09-26,12,Monday,Winter,2,Mid-Day,209,48,161
2011-09-26,13,Monday,Winter,2,Mid-Day,187,48,139
2011-09-26,14,Monday,Winter,1,Mid-Day,154,44,110
2011-09-26,15,Monday,Winter,1,Mid-Day,209,52,157
2011-09-26,16,Monday,Winter,1,Evening Rush,313,74,239
2011-09-26,17,Monday,Winter,1,Evening Rush,570,61,509
2011-09-26,18,Monday,Winter,1,Evening Rush,553,63,490
2011-09-26,19,Monday,Winter,1,Evening Rush,383,36,347
2011-09-26,20,Monday,Winter,1,Night,251,24,227
2011-09-26,21,Monday,Winter,1,Night,182,18,164
2011-09-26,22,Monday,Winter,1,Night,136,14,122
2011-09-26,23,Monday,Winter,1,Night,75,11,64
2011-09-27,0,Tuesday,Winter,1,Early Morning,37,9,28
2011-09-27,1,Tuesday,Winter,1,Early Morning,10,4,6
2011-09-27,2,Tuesday,Winter,1,Early Morning,11,7,4
2011-09-27,3,Tuesday,Winter,2,Early Morning,10,5,5
2011-09-27,4,Tuesday,Winter,3,Early Morning,8,5,3
2011-09-27,5,Tuesday,Winter,3,Early Morning,24,0,24
2011-09-27,6,Tuesday,Winter,2,Morning Rush,124,8,116
2011-09-27,7,Tuesday,Winter,2,Morning Rush,249,15,234
2011-09-27,8,Tuesday,Winter,2,Morning Rush,427,27,400
2011-09-27,9,Tuesday,Winter,3,Morning Rush,193,20,173
2011-09-27,10,Tuesday,Winter,3,Mid-Day,122,21,101
2011-09-27,11,Tuesday,Winter,2,Mid-Day,123,26,97
2011-09-27,12,Tuesday,Winter,2,Mid-Day,162,33,129
2011-09-27,13,Tuesday,Winter,2,Mid-Day,151,29,122
2011-09-27,14,Tuesday,Winter,2,Mid-Day,152,29,123
2011-09-27,15,Tuesday,Winter,2,Mid-Day,205,35,170
2011-09-27,16,Tuesday,Winter,2,Evening Rush,258,33,225
2011-09-27,17,Tuesday,Winter,2,Evening Rush,530,50,480
2011-09-27,18,Tuesday,Winter,2,Evening Rush,356,31,325
2011-09-27,19,Tuesday,Winter,2,Evening Rush,320,26,294
2011-09-27,20,Tuesday,Winter,1,Night,238,17,221
2011-09-27,21,Tuesday,Winter,1,Night,196,17,179
2011-09-27,22,Tuesday,Winter,1,Night,121,19,102
2011-09-27,23,Tuesday,Winter,1,Night,93,11,82
2011-09-28,0,Wednesday,Winter,1,Early Morning,36,7,29
2011-09-28,1,Wednesday,Winter,1,Early Morning,14,1,13
2011-09-28,2,Wednesday,Winter,1,Early Morning,9,0,9
2011-09-28,3,Wednesday,Winter,2,Early Morning,3,0,3
2011-09-28,4,Wednesday,Winter,1,Early Morning,4,1,3
2011-09-28,5,Wednesday,Winter,2,Early Morning,22,2,20
2011-09-28,6,Wednesday,Winter,3,Morning Rush,114,3,111
2011-09-28,7,Wednesday,Winter,3,Morning Rush,185,8,177
2011-09-28,8,Wednesday,Winter,3,Morning Rush,287,17,270
2011-09-28,9,Wednesday,Winter,3,Morning Rush,155,14,141
2011-09-28,10,Wednesday,Winter,2,Mid-Day,129,20,109
2011-09-28,11,Wednesday,Winter,2,Mid-Day,151,24,127
2011-09-28,12,Wednesday,Winter,2,Mid-Day,184,25,159
2011-09-28,13,Wednesday,Winter,1,Mid-Day,162,24,138
2011-09-28,14,Wednesday,Winter,1,Mid-Day,170,25,145
2011-09-28,15,Wednesday,Winter,1,Mid-Day,181,35,146
2011-09-28,16,Wednesday,Winter,1,Evening Rush,280,39,241
2011-09-28,17,Wednesday,Winter,1,Evening Rush,591,64,527
2011-09-28,18,Wednesday,Winter,3,Evening Rush,524,65,459
2011-09-28,19,Wednesday,Winter,3,Evening Rush,372,57,315
2011-09-28,20,Wednesday,Winter,3,Night,102,11,91
2011-09-28,21,Wednesday,Winter,3,Night,74,7,67
2011-09-28,22,Wednesday,Winter,1,Night,87,19,68
2011-09-28,23,Wednesday,Winter,1,Night,71,12,59
2011-09-29,0,Thursday,Winter,1,Early Morning,40,7,33
2011-09-29,1,Thursday,Winter,2,Early Morning,23,3,20
2011-09-29,2,Thursday,Winter,2,Early Morning,2,0,2
2011-09-29,3,Thursday,Winter,2,Early Morning,8,0,8
2011-09-29,4,Thursday,Winter,2,Early Morning,7,2,5
2011-09-29,5,Thursday,Winter,2,Early Morning,22,0,22
2011-09-29,6,Thursday,Winter,2,Morning Rush,111,5,106
2011-09-29,7,Thursday,Winter,1,Morning Rush,283,14,269
2011-09-29,8,Thursday,Winter,1,Morning Rush,431,29,402
2011-09-29,9,Thursday,Winter,1,Morning Rush,225,27,198
2011-09-29,10,Thursday,Winter,1,Mid-Day,127,24,103
2011-09-29,11,Thursday,Winter,1,Mid-Day,158,36,122
2011-09-29,12,Thursday,Winter,1,Mid-Day,195,38,157
2011-09-29,13,Thursday,Winter,1,Mid-Day,211,36,175
2011-09-29,14,Thursday,Winter,1,Mid-Day,167,33,134
2011-09-29,15,Thursday,Winter,1,Mid-Day,227,42,185
2011-09-29,16,Thursday,Winter,1,Evening Rush,291,64,227
2011-09-29,17,Thursday,Winter,1,Evening Rush,589,62,527
2011-09-29,18,Thursday,Winter,1,Evening Rush,584,84,500
2011-09-29,19,Thursday,Winter,1,Evening Rush,384,36,348
2011-09-29,20,Thursday,Winter,1,Night,273,39,234
2011-09-29,21,Thursday,Winter,1,Night,225,30,195
2011-09-29,22,Thursday,Winter,1,Night,175,25,150
2011-09-29,23,Thursday,Winter,1,Night,81,17,64
2011-09-30,0,Friday,Winter,1,Early Morning,60,7,53
2011-09-30,1,Friday,Winter,1,Early Morning,23,5,18
2011-09-30,2,Friday,Winter,1,Early Morning,15,6,9
2011-09-30,3,Friday,Winter,1,Early Morning,3,0,3
2011-09-30,4,Friday,Winter,1,Early Morning,8,2,6
2011-09-30,5,Friday,Winter,1,Early Morning,26,3,23
2011-09-30,6,Friday,Winter,1,Morning Rush,98,0,98
2011-09-30,7,Friday,Winter,1,Morning Rush,297,14,283
2011-09-30,8,Friday,Winter,1,Morning Rush,456,31,425
2011-09-30,9,Friday,Winter,1,Morning Rush,237,23,214
2011-09-30,10,Friday,Winter,1,Mid-Day,168,46,122
2011-09-30,11,Friday,Winter,1,Mid-Day,217,49,168
2011-09-30,12,Friday,Winter,2,Mid-Day,254,59,195
2011-09-30,13,Friday,Winter,2,Mid-Day,266,72,194
2011-09-30,14,Friday,Winter,2,Mid-Day,266,93,173
2011-09-30,15,Friday,Winter,1,Mid-Day,245,52,193
2011-09-30,16,Friday,Winter,1,Evening Rush,360,62,298
2011-09-30,17,Friday,Winter,1,Evening Rush,591,94,497
2011-09-30,18,Friday,Winter,1,Evening Rush,511,62,449
2011-09-30,19,Friday,Winter,1,Evening Rush,374,42,332
2011-09-30,20,Friday,Winter,1,Night,230,28,202
2011-09-30,21,Friday,Winter,1,Night,206,27,179
2011-09-30,22,Friday,Winter,1,Night,159,30,129
2011-09-30,23,Friday,Winter,1,Night,132,23,109
2011-10-01,0,Saturday,Winter,1,Early Morning,130,24,106
2011-10-01,1,Saturday,Winter,1,Early Morning,58,11,47
2011-10-01,2,Saturday,Winter,1,Early Morning,67,21,46
2011-10-01,3,Saturday,Winter,1,Early Morning,25,8,17
2011-10-01,4,Saturday,Winter,1,Early Morning,8,2,6
2011-10-01,5,Saturday,Winter,2,Early Morning,5,1,4
2011-10-01,6,Saturday,Winter,1,Morning Rush,19,4,15
2011-10-01,7,Saturday,Winter,3,Morning Rush,36,6,30
2011-10-01,8,Saturday,Winter,2,Morning Rush,67,9,58
2011-10-01,9,Saturday,Winter,3,Morning Rush,129,17,112
2011-10-01,10,Saturday,Winter,3,Mid-Day,121,21,100
2011-10-01,11,Saturday,Winter,3,Mid-Day,132,30,102
2011-10-01,12,Saturday,Winter,2,Mid-Day,158,28,130
2011-10-01,13,Saturday,Winter,2,Mid-Day,125,27,98
2011-10-01,14,Saturday,Winter,2,Mid-Day,180,33,147
2011-10-01,15,Saturday,Winter,2,Mid-Day,195,41,154
2011-10-01,16,Saturday,Winter,2,Evening Rush,223,58,165
2011-10-01,17,Saturday,Winter,3,Evening Rush,228,58,170
2011-10-01,18,Saturday,Winter,3,Evening Rush,140,23,117
2011-10-01,19,Saturday,Winter,2,Evening Rush,126,27,99
2011-10-01,20,Saturday,Winter,3,Night,66,8,58
2011-10-01,21,Saturday,Winter,3,Night,56,3,53
2011-10-01,22,Saturday,Winter,2,Night,70,12,58
2011-10-01,23,Saturday,Winter,3,Night,65,8,57
2011-10-02,0,Sunday,Winter,3,Early Morning,47,4,43
2011-10-02,1,Sunday,Winter,3,Early Morning,24,1,23
2011-10-02,2,Sunday,Winter,3,Early Morning,30,3,27
2011-10-02,3,Sunday,Winter,3,Early Morning,9,4,5
2011-10-02,4,Sunday,Winter,2,Early Morning,7,4,3
2011-10-02,5,Sunday,Winter,1,Early Morning,7,0,7
2011-10-02,6,Sunday,Winter,1,Morning Rush,15,2,13
2011-10-02,7,Sunday,Winter,1,Morning Rush,29,5,24
2011-10-02,8,Sunday,Winter,2,Morning Rush,64,14,50
2011-10-02,9,Sunday,Winter,1,Morning Rush,115,19,96
2011-10-02,10,Sunday,Winter,2,Mid-Day,248,60,188
2011-10-02,11,Sunday,Winter,2,Mid-Day,292,74,218
2011-10-02,12,Sunday,Winter,2,Mid-Day,321,78,243
2011-10-02,13,Sunday,Winter,3,Mid-Day,308,84,224
2011-10-02,14,Sunday,Winter,3,Mid-Day,256,61,195
2011-10-02,15,Sunday,Winter,3,Mid-Day,173,29,144
2011-10-02,16,Sunday,Winter,3,Evening Rush,206,44,162
2011-10-02,17,Sunday,Winter,3,Evening Rush,167,32,135
2011-10-02,18,Sunday,Winter,2,Evening Rush,174,16,158
2011-10-02,19,Sunday,Winter,2,Evening Rush,162,34,128
2011-10-02,20,Sunday,Winter,2,Night,87,16,71
2011-10-02,21,Sunday,Winter,1,Night,88,17,71
2011-10-02,22,Sunday,Winter,3,Night,64,9,55
2011-10-02,23,Sunday,Winter,1,Night,25,6,19
2011-10-03,0,Monday,Winter,1,Early Morning,16,3,13
2011-10-03,1,Monday,Winter,1,Early Morning,6,1,5
2011-10-03,2,Monday,Winter,1,Early Morning,4,0,4
2011-10-03,3,Monday,Winter,1,Early Morning,7,1,6
2011-10-03,4,Monday,Winter,1,Early Morning,8,2,6
2011-10-03,5,Monday,Winter,2,Early Morning,21,4,17
2011-10-03,6,Monday,Winter,2,Morning Rush,94,3,91
2011-10-03,7,Monday,Winter,2,Morning Rush,249,8,241
2011-10-03,8,Monday,Winter,2,Morning Rush,372,13,359
2011-10-03,9,Monday,Winter,2,Morning Rush,153,12,141
2011-10-03,10,Monday,Winter,2,Mid-Day,101,19,82
2011-10-03,11,Monday,Winter,2,Mid-Day,126,26,100
2011-10-03,12,Monday,Winter,2,Mid-Day,147,29,118
2011-10-03,13,Monday,Winter,3,Mid-Day,118,16,102
2011-10-03,14,Monday,Winter,3,Mid-Day,120,26,94
2011-10-03,15,Monday,Winter,3,Mid-Day,101,22,79
2011-10-03,16,Monday,Winter,2,Evening Rush,218,16,202
2011-10-03,17,Monday,Winter,2,Evening Rush,495,40,455
2011-10-03,18,Monday,Winter,2,Evening Rush,412,28,384
2011-10-03,19,Monday,Winter,1,Evening Rush,315,15,300
2011-10-03,20,Monday,Winter,3,Night,204,13,191
2011-10-03,21,Monday,Winter,2,Night,138,10,128
2011-10-03,22,Monday,Winter,2,Night,91,12,79
2011-10-03,23,Monday,Winter,2,Night,54,11,43
2011-10-04,0,Tuesday,Winter,2,Early Morning,27,5,22
2011-10-04,1,Tuesday,Winter,2,Early Morning,9,1,8
2011-10-04,2,Tuesday,Winter,2,Early Morning,3,1,2
2011-10-04,3,Tuesday,Winter,1,Early Morning,6,3,3
2011-10-04,4,Tuesday,Winter,1,Early Morning,7,3,4
2011-10-04,5,Tuesday,Winter,1,Early Morning,27,2,25
2011-10-04,6,Tuesday,Winter,1,Morning Rush,112,3,109
2011-10-04,7,Tuesday,Winter,1,Morning Rush,309,11,298
2011-10-04,8,Tuesday,Winter,1,Morning Rush,400,28,372
2011-10-04,9,Tuesday,Winter,1,Morning Rush,187,19,168
2011-10-04,10,Tuesday,Winter,1,Mid-Day,126,19,107
2011-10-04,11,Tuesday,Winter,1,Mid-Day,124,22,102
2011-10-04,12,Tuesday,Winter,1,Mid-Day,199,39,160
2011-10-04,13,Tuesday,Winter,1,Mid-Day,173,20,153
2011-10-04,14,Tuesday,Winter,1,Mid-Day,183,27,156
2011-10-04,15,Tuesday,Winter,1,Mid-Day,194,28,166
2011-10-04,16,Tuesday,Winter,1,Evening Rush,309,36,273
2011-10-04,17,Tuesday,Winter,1,Evening Rush,585,55,530
2011-10-04,18,Tuesday,Winter,1,Evening Rush,524,68,456
2011-10-04,19,Tuesday,Winter,1,Evening Rush,345,35,310
2011-10-04,20,Tuesday,Winter,1,Night,261,25,236
2011-10-04,21,Tuesday,Winter,1,Night,166,22,144
2011-10-04,22,Tuesday,Winter,1,Night,114,8,106
2011-10-04,23,Tuesday,Winter,1,Night,66,6,60
2011-10-05,0,Wednesday,Winter,1,Early Morning,43,7,36
2011-10-05,1,Wednesday,Winter,1,Early Morning,11,4,7
2011-10-05,2,Wednesday,Winter,1,Early Morning,3,1,2
2011-10-05,3,Wednesday,Winter,1,Early Morning,6,1,5
2011-10-05,4,Wednesday,Winter,1,Early Morning,5,1,4
2011-10-05,5,Wednesday,Winter,1,Early Morning,32,3,29
2011-10-05,6,Wednesday,Winter,1,Morning Rush,117,5,112
2011-10-05,7,Wednesday,Winter,1,Morning Rush,301,9,292
2011-10-05,8,Wednesday,Winter,1,Morning Rush,467,26,441
2011-10-05,9,Wednesday,Winter,1,Morning Rush,219,32,187
2011-10-05,10,Wednesday,Winter,1,Mid-Day,133,30,103
2011-10-05,11,Wednesday,Winter,1,Mid-Day,170,32,138
2011-10-05,12,Wednesday,Winter,1,Mid-Day,214,34,180
2011-10-05,13,Wednesday,Winter,1,Mid-Day,219,30,189
2011-10-05,14,Wednesday,Winter,1,Mid-Day,190,34,156
2011-10-05,15,Wednesday,Winter,1,Mid-Day,182,35,147
2011-10-05,16,Wednesday,Winter,1,Evening Rush,282,37,245
2011-10-05,17,Wednesday,Winter,1,Evening Rush,591,66,525
2011-10-05,18,Wednesday,Winter,1,Evening Rush,593,57,536
2011-10-05,19,Wednesday,Winter,1,Evening Rush,374,40,334
2011-10-05,20,Wednesday,Winter,1,Night,246,18,228
2011-10-05,21,Wednesday,Winter,1,Night,201,28,173
2011-10-05,22,Wednesday,Winter,1,Night,154,20,134
2011-10-05,23,Wednesday,Winter,1,Night,73,9,64
2011-10-06,0,Thursday,Winter,1,Early Morning,40,6,34
2011-10-06,1,Thursday,Winter,1,Early Morning,22,5,17
2011-10-06,2,Thursday,Winter,1,Early Morning,10,2,8
2011-10-06,3,Thursday,Winter,1,Early Morning,5,1,4
2011-10-06,4,Thursday,Winter,1,Early Morning,5,0,5
2011-10-06,5,Thursday,Winter,1,Early Morning,24,0,24
2011-10-06,6,Thursday,Winter,1,Morning Rush,114,4,110
2011-10-06,7,Thursday,Winter,1,Morning Rush,302,15,287
2011-10-06,8,Thursday,Winter,1,Morning Rush,457,20,437
2011-10-06,9,Thursday,Winter,1,Morning Rush,208,20,188
2011-10-06,10,Thursday,Winter,1,Mid-Day,129,24,105
2011-10-06,11,Thursday,Winter,1,Mid-Day,144,29,115
2011-10-06,12,Thursday,Winter,1,Mid-Day,226,46,180
2011-10-06,13,Thursday,Winter,1,Mid-Day,191,33,158
2011-10-06,14,Thursday,Winter,1,Mid-Day,195,56,139
2011-10-06,15,Thursday,Winter,1,Mid-Day,219,62,157
2011-10-06,16,Thursday,Winter,1,Evening Rush,323,51,272
2011-10-06,17,Thursday,Winter,1,Evening Rush,568,63,505
2011-10-06,18,Thursday,Winter,1,Evening Rush,538,59,479
2011-10-06,19,Thursday,Winter,1,Evening Rush,343,38,305
2011-10-06,20,Thursday,Winter,1,Night,260,29,231
2011-10-06,21,Thursday,Winter,1,Night,195,34,161
2011-10-06,22,Thursday,Winter,1,Night,148,24,124
2011-10-06,23,Thursday,Winter,1,Night,99,18,81
2011-10-07,0,Friday,Winter,1,Early Morning,67,19,48
2011-10-07,1,Friday,Winter,1,Early Morning,28,3,25
2011-10-07,2,Friday,Winter,1,Early Morning,5,0,5
2011-10-07,3,Friday,Winter,1,Early Morning,10,1,9
2011-10-07,4,Friday,Winter,1,Early Morning,5,0,5
2011-10-07,5,Friday,Winter,1,Early Morning,27,3,24
2011-10-07,6,Friday,Winter,1,Morning Rush,87,3,84
2011-10-07,7,Friday,Winter,1,Morning Rush,242,5,237
2011-10-07,8,Friday,Winter,1,Morning Rush,417,31,386
2011-10-07,9,Friday,Winter,1,Morning Rush,241,34,207
2011-10-07,10,Friday,Winter,1,Mid-Day,174,48,126
2011-10-07,11,Friday,Winter,1,Mid-Day,230,80,150
2011-10-07,12,Friday,Winter,1,Mid-Day,235,61,174
2011-10-07,13,Friday,Winter,1,Mid-Day,305,95,210
2011-10-07,14,Friday,Winter,1,Mid-Day,256,77,179
2011-10-07,15,Friday,Winter,1,Mid-Day,270,68,202
2011-10-07,16,Friday,Winter,1,Evening Rush,419,73,346
2011-10-07,17,Friday,Winter,1,Evening Rush,563,101,462
2011-10-07,18,Friday,Winter,1,Evening Rush,465,94,371
2011-10-07,19,Friday,Winter,1,Evening Rush,294,51,243
2011-10-07,20,Friday,Winter,1,Night,197,30,167
2011-10-07,21,Friday,Winter,1,Night,166,22,144
2011-10-07,22,Friday,Winter,1,Night,146,27,119
2011-10-07,23,Friday,Winter,1,Night,136,23,113
2011-10-08,0,Saturday,Winter,1,Early Morning,89,17,72
2011-10-08,1,Saturday,Winter,1,Early Morning,65,14,51
2011-10-08,2,Saturday,Winter,1,Early Morning,45,4,41
2011-10-08,3,Saturday,Winter,1,Early Morning,20,4,16
2011-10-08,4,Saturday,Winter,1,Early Morning,10,3,7
2011-10-08,5,Saturday,Winter,1,Early Morning,8,1,7
2011-10-08,6,Saturday,Winter,1,Morning Rush,22,6,16
2011-10-08,7,Saturday,Winter,1,Morning Rush,73,27,46
2011-10-08,8,Saturday,Winter,1,Morning Rush,103,14,89
2011-10-08,9,Saturday,Winter,1,Morning Rush,217,54,163
2011-10-08,10,Saturday,Winter,1,Mid-Day,337,120,217
2011-10-08,11,Saturday,Winter,1,Mid-Day,397,176,221
2011-10-08,12,Saturday,Winter,1,Mid-Day,446,191,255
2011-10-08,13,Saturday,Winter,1,Mid-Day,485,256,229
2011-10-08,14,Saturday,Winter,1,Mid-Day,465,251,214
2011-10-08,15,Saturday,Winter,1,Mid-Day,496,262,234
2011-10-08,16,Saturday,Winter,1,Evening Rush,451,221,230
2011-10-08,17,Saturday,Winter,1,Evening Rush,393,174,219
2011-10-08,18,Saturday,Winter,1,Evening Rush,359,135,224
2011-10-08,19,Saturday,Winter,1,Evening Rush,248,76,172
2011-10-08,20,Saturday,Winter,1,Night,202,78,124
2011-10-08,21,Saturday,Winter,1,Night,187,54,133
2011-10-08,22,Saturday,Winter,1,Night,149,45,104
2011-10-08,23,Saturday,Winter,1,Night,142,52,90
2011-10-09,0,Sunday,Winter,1,Early Morning,129,46,83
2011-10-09,1,Sunday,Winter,1,Early Morning,78,15,63
2011-10-09,2,Sunday,Winter,1,Early Morning,55,20,35
2011-10-09,3,Sunday,Winter,1,Early Morning,30,10,20
2011-10-09,4,Sunday,Winter,1,Early Morning,14,7,7
2011-10-09,5,Sunday,Winter,1,Early Morning,15,1,14
2011-10-09,6,Sunday,Winter,1,Morning Rush,21,7,14
2011-10-09,7,Sunday,Winter,1,Morning Rush,44,18,26
2011-10-09,8,Sunday,Winter,1,Morning Rush,107,25,82
2011-10-09,9,Sunday,Winter,1,Morning Rush,185,66,119
2011-10-09,10,Sunday,Winter,1,Mid-Day,365,155,210
2011-10-09,11,Sunday,Winter,1,Mid-Day,423,189,234
2011-10-09,12,Sunday,Winter,1,Mid-Day,455,212,243
2011-10-09,13,Sunday,Winter,1,Mid-Day,418,225,193
2011-10-09,14,Sunday,Winter,1,Mid-Day,500,272,228
2011-10-09,15,Sunday,Winter,1,Mid-Day,407,198,209
2011-10-09,16,Sunday,Winter,1,Evening Rush,470,223,247
2011-10-09,17,Sunday,Winter,1,Evening Rush,438,208,230
2011-10-09,18,Sunday,Winter,1,Evening Rush,414,186,228
2011-10-09,19,Sunday,Winter,1,Evening Rush,302,116,186
2011-10-09,20,Sunday,Winter,1,Night,193,59,134
2011-10-09,21,Sunday,Winter,1,Night,173,53,120
2011-10-09,22,Sunday,Winter,2,Night,152,48,104
2011-10-09,23,Sunday,Winter,1,Night,123,38,85
2011-10-10,0,Monday,Winter,1,Early Morning,53,11,42
2011-10-10,1,Monday,Winter,1,Early Morning,34,4,30
2011-10-10,2,Monday,Winter,1,Early Morning,19,4,15
2011-10-10,3,Monday,Winter,1,Early Morning,11,2,9
2011-10-10,4,Monday,Winter,1,Early Morning,6,2,4
2011-10-10,5,Monday,Winter,1,Early Morning,21,2,19
2011-10-10,6,Monday,Winter,1,Morning Rush,44,5,39
2011-10-10,7,Monday,Winter,1,Morning Rush,114,12,102
2011-10-10,8,Monday,Winter,1,Morning Rush,254,27,227
2011-10-10,9,Monday,Winter,1,Morning Rush,219,58,161
2011-10-10,10,Monday,Winter,1,Mid-Day,265,107,158
2011-10-10,11,Monday,Winter,1,Mid-Day,322,139,183
2011-10-10,12,Monday,Winter,2,Mid-Day,365,164,201
2011-10-10,13,Monday,Winter,1,Mid-Day,365,146,219
2011-10-10,14,Monday,Winter,1,Mid-Day,370,147,223
2011-10-10,15,Monday,Winter,2,Mid-Day,384,130,254
2011-10-10,16,Monday,Winter,2,Evening Rush,402,154,248
2011-10-10,17,Monday,Winter,2,Evening Rush,459,125,334
2011-10-10,18,Monday,Winter,2,Evening Rush,473,108,365
2011-10-10,19,Monday,Winter,2,Evening Rush,336,69,267
2011-10-10,20,Monday,Winter,1,Night,225,37,188
2011-10-10,21,Monday,Winter,1,Night,175,27,148
2011-10-10,22,Monday,Winter,1,Night,126,22,104
2011-10-10,23,Monday,Winter,2,Night,75,12,63
2011-10-11,0,Tuesday,Winter,2,Early Morning,30,14,16
2011-10-11,1,Tuesday,Winter,2,Early Morning,11,2,9
2011-10-11,2,Tuesday,Winter,2,Early Morning,5,1,4
2011-10-11,3,Tuesday,Winter,2,Early Morning,3,2,1
2011-10-11,4,Tuesday,Winter,2,Early Morning,5,0,5
2011-10-11,5,Tuesday,Winter,2,Early Morning,20,0,20
2011-10-11,6,Tuesday,Winter,1,Morning Rush,123,9,114
2011-10-11,7,Tuesday,Winter,2,Morning Rush,352,19,333
2011-10-11,8,Tuesday,Winter,2,Morning Rush,406,31,375
2011-10-11,9,Tuesday,Winter,2,Morning Rush,235,40,195
2011-10-11,10,Tuesday,Winter,2,Mid-Day,149,38,111
2011-10-11,11,Tuesday,Winter,2,Mid-Day,123,31,92
2011-10-11,12,Tuesday,Winter,2,Mid-Day,181,51,130
2011-10-11,13,Tuesday,Winter,2,Mid-Day,180,42,138
2011-10-11,14,Tuesday,Winter,3,Mid-Day,171,54,117
2011-10-11,15,Tuesday,Winter,2,Mid-Day,175,36,139
2011-10-11,16,Tuesday,Winter,2,Evening Rush,320,63,257
2011-10-11,17,Tuesday,Winter,2,Evening Rush,604,70,534
2011-10-11,18,Tuesday,Winter,2,Evening Rush,539,46,493
2011-10-11,19,Tuesday,Winter,2,Evening Rush,318,33,285
2011-10-11,20,Tuesday,Winter,2,Night,234,31,203
2011-10-11,21,Tuesday,Winter,2,Night,175,17,158
2011-10-11,22,Tuesday,Winter,2,Night,147,27,120
2011-10-11,23,Tuesday,Winter,2,Night,57,10,47
2011-10-12,0,Wednesday,Winter,2,Early Morning,25,2,23
2011-10-12,1,Wednesday,Winter,3,Early Morning,10,2,8
2011-10-12,2,Wednesday,Winter,2,Early Morning,2,0,2
2011-10-12,3,Wednesday,Winter,3,Early Morning,2,0,2
2011-10-12,4,Wednesday,Winter,3,Early Morning,7,1,6
2011-10-12,5,Wednesday,Winter,2,Early Morning,22,0,22
2011-10-12,6,Wednesday,Winter,2,Morning Rush,112,5,107
2011-10-12,7,Wednesday,Winter,2,Morning Rush,259,15,244
2011-10-12,8,Wednesday,Winter,2,Morning Rush,404,27,377
2011-10-12,9,Wednesday,Winter,2,Morning Rush,197,14,183
2011-10-12,10,Wednesday,Winter,2,Mid-Day,113,15,98
2011-10-12,11,Wednesday,Winter,3,Mid-Day,120,18,102
2011-10-12,12,Wednesday,Winter,3,Mid-Day,62,9,53
2011-10-12,13,Wednesday,Winter,3,Mid-Day,101,25,76
2011-10-12,14,Wednesday,Winter,3,Mid-Day,78,8,70
2011-10-12,15,Wednesday,Winter,3,Mid-Day,45,3,42
2011-10-12,16,Wednesday,Winter,2,Evening Rush,55,5,50
2011-10-12,17,Wednesday,Winter,3,Evening Rush,251,16,235
2011-10-12,18,Wednesday,Winter,3,Evening Rush,172,11,161
2011-10-12,19,Wednesday,Winter,3,Evening Rush,109,7,102
2011-10-12,20,Wednesday,Winter,3,Night,90,9,81
2011-10-12,21,Wednesday,Winter,3,Night,83,9,74
2011-10-12,22,Wednesday,Winter,3,Night,43,3,40
2011-10-12,23,Wednesday,Winter,3,Night,54,13,41
2011-10-13,0,Thursday,Winter,2,Early Morning,15,1,14
2011-10-13,1,Thursday,Winter,2,Early Morning,12,3,9
2011-10-13,2,Thursday,Winter,2,Early Morning,4,0,4
2011-10-13,3,Thursday,Winter,2,Early Morning,6,2,4
2011-10-13,4,Thursday,Winter,2,Early Morning,7,2,5
2011-10-13,5,Thursday,Winter,2,Early Morning,17,1,16
2011-10-13,6,Thursday,Winter,3,Morning Rush,52,1,51
2011-10-13,7,Thursday,Winter,3,Morning Rush,81,5,76
2011-10-13,8,Thursday,Winter,3,Morning Rush,209,10,199
2011-10-13,9,Thursday,Winter,3,Morning Rush,109,3,106
2011-10-13,10,Thursday,Winter,3,Mid-Day,69,16,53
2011-10-13,11,Thursday,Winter,2,Mid-Day,84,8,76
2011-10-13,12,Thursday,Winter,2,Mid-Day,105,10,95
2011-10-13,13,Thursday,Winter,2,Mid-Day,162,20,142
2011-10-13,14,Thursday,Winter,1,Mid-Day,133,22,111
2011-10-13,15,Thursday,Winter,1,Mid-Day,155,27,128
2011-10-13,16,Thursday,Winter,1,Evening Rush,276,36,240
2011-10-13,17,Thursday,Winter,3,Evening Rush,479,47,432
2011-10-13,18,Thursday,Winter,3,Evening Rush,268,20,248
2011-10-13,19,Thursday,Winter,2,Evening Rush,205,18,187
2011-10-13,20,Thursday,Winter,1,Night,181,15,166
2011-10-13,21,Thursday,Winter,1,Night,123,8,115
2011-10-13,22,Thursday,Winter,1,Night,114,13,101
2011-10-13,23,Thursday,Winter,2,Night,47,2,45
2011-10-14,0,Friday,Winter,1,Early Morning,39,10,29
2011-10-14,1,Friday,Winter,1,Early Morning,24,8,16
2011-10-14,2,Friday,Winter,1,Early Morning,6,0,6
2011-10-14,3,Friday,Winter,1,Early Morning,7,1,6
2011-10-14,4,Friday,Winter,1,Early Morning,8,0,8
2011-10-14,5,Friday,Winter,2,Early Morning,17,0,17
2011-10-14,6,Friday,Winter,3,Morning Rush,94,4,90
2011-10-14,7,Friday,Winter,3,Morning Rush,147,10,137
2011-10-14,8,Friday,Winter,2,Morning Rush,209,23,186
2011-10-14,9,Friday,Winter,2,Morning Rush,180,16,164
2011-10-14,10,Friday,Winter,3,Mid-Day,125,17,108
2011-10-14,11,Friday,Winter,3,Mid-Day,87,11,76
2011-10-14,12,Friday,Winter,3,Mid-Day,75,13,62
2011-10-14,13,Friday,Winter,1,Mid-Day,132,18,114
2011-10-14,14,Friday,Winter,1,Mid-Day,156,37,119
2011-10-14,15,Friday,Winter,1,Mid-Day,230,61,169
2011-10-14,16,Friday,Winter,1,Evening Rush,344,80,264
2011-10-14,17,Friday,Winter,1,Evening Rush,481,55,426
2011-10-14,18,Friday,Winter,1,Evening Rush,423,62,361
2011-10-14,19,Friday,Winter,1,Evening Rush,248,27,221
2011-10-14,20,Friday,Winter,1,Night,196,19,177
2011-10-14,21,Friday,Winter,1,Night,178,22,156
2011-10-14,22,Friday,Winter,1,Night,143,20,123
2011-10-14,23,Friday,Winter,1,Night,95,15,80
2011-10-15,0,Saturday,Winter,1,Early Morning,106,18,88
2011-10-15,1,Saturday,Winter,1,Early Morning,73,9,64
2011-10-15,2,Saturday,Winter,1,Early Morning,56,17,39
2011-10-15,3,Saturday,Winter,1,Early Morning,23,5,18
2011-10-15,4,Saturday,Winter,1,Early Morning,6,0,6
2011-10-15,5,Saturday,Winter,1,Early Morning,7,1,6
2011-10-15,6,Saturday,Winter,1,Morning Rush,20,5,15
2011-10-15,7,Saturday,Winter,1,Morning Rush,57,17,40
2011-10-15,8,Saturday,Winter,1,Morning Rush,125,24,101
2011-10-15,9,Saturday,Winter,1,Morning Rush,207,50,157
2011-10-15,10,Saturday,Winter,1,Mid-Day,322,115,207
2011-10-15,11,Saturday,Winter,1,Mid-Day,374,153,221
2011-10-15,12,Saturday,Winter,1,Mid-Day,456,195,261
2011-10-15,13,Saturday,Winter,1,Mid-Day,394,171,223
2011-10-15,14,Saturday,Winter,1,Mid-Day,472,242,230
2011-10-15,15,Saturday,Winter,1,Mid-Day,377,166,211
2011-10-15,16,Saturday,Winter,1,Evening Rush,443,179,264
2011-10-15,17,Saturday,Winter,1,Evening Rush,441,177,264
2011-10-15,18,Saturday,Winter,1,Evening Rush,372,121,251
2011-10-15,19,Saturday,Winter,1,Evening Rush,238,61,177
2011-10-15,20,Saturday,Winter,1,Night,179,42,137
2011-10-15,21,Saturday,Winter,1,Night,168,53,115
2011-10-15,22,Saturday,Winter,1,Night,166,45,121
2011-10-15,23,Saturday,Winter,1,Night,135,33,102
2011-10-16,0,Sunday,Winter,1,Early Morning,107,22,85
2011-10-16,1,Sunday,Winter,1,Early Morning,77,13,64
2011-10-16,2,Sunday,Winter,1,Early Morning,65,13,52
2011-10-16,3,Sunday,Winter,1,Early Morning,42,11,31
2011-10-16,4,Sunday,Winter,1,Early Morning,12,5,7
2011-10-16,5,Sunday,Winter,1,Early Morning,7,1,6
2011-10-16,6,Sunday,Winter,1,Morning Rush,10,3,7
2011-10-16,7,Sunday,Winter,1,Morning Rush,48,9,39
2011-10-16,8,Sunday,Winter,1,Morning Rush,99,28,71
2011-10-16,9,Sunday,Winter,1,Morning Rush,190,39,151
2011-10-16,10,Sunday,Winter,1,Mid-Day,347,121,226
2011-10-16,11,Sunday,Winter,1,Mid-Day,377,159,218
2011-10-16,12,Sunday,Winter,1,Mid-Day,444,167,277
2011-10-16,13,Sunday,Winter,1,Mid-Day,438,169,269
2011-10-16,14,Sunday,Winter,1,Mid-Day,462,204,258
2011-10-16,15,Sunday,Winter,1,Mid-Day,412,182,230
2011-10-16,16,Sunday,Winter,1,Evening Rush,466,177,289
2011-10-16,17,Sunday,Winter,1,Evening Rush,405,152,253
2011-10-16,18,Sunday,Winter,1,Evening Rush,328,102,226
2011-10-16,19,Sunday,Winter,1,Evening Rush,233,52,181
2011-10-16,20,Sunday,Winter,1,Night,178,49,129
2011-10-16,21,Sunday,Winter,1,Night,102,14,88
2011-10-16,22,Sunday,Winter,1,Night,130,42,88
2011-10-16,23,Sunday,Winter,1,Night,62,14,48
2011-10-17,0,Monday,Winter,1,Early Morning,37,12,25
2011-10-17,1,Monday,Winter,1,Early Morning,17,2,15
2011-10-17,2,Monday,Winter,1,Early Morning,7,4,3
2011-10-17,3,Monday,Winter,1,Early Morning,2,0,2
2011-10-17,4,Monday,Winter,1,Early Morning,5,2,3
2011-10-17,5,Monday,Winter,1,Early Morning,29,1,28
2011-10-17,6,Monday,Winter,1,Morning Rush,114,7,107
2011-10-17,7,Monday,Winter,2,Morning Rush,309,10,299
2011-10-17,8,Monday,Winter,2,Morning Rush,414,33,381
2011-10-17,9,Monday,Winter,2,Morning Rush,206,26,180
2011-10-17,10,Monday,Winter,1,Mid-Day,135,43,92
2011-10-17,11,Monday,Winter,1,Mid-Day,166,35,131
2011-10-17,12,Monday,Winter,1,Mid-Day,205,39,166
2011-10-17,13,Monday,Winter,1,Mid-Day,205,49,156
2011-10-17,14,Monday,Winter,1,Mid-Day,166,44,122
2011-10-17,15,Monday,Winter,1,Mid-Day,208,66,142
2011-10-17,16,Monday,Winter,1,Evening Rush,302,64,238
2011-10-17,17,Monday,Winter,1,Evening Rush,620,80,540
2011-10-17,18,Monday,Winter,1,Evening Rush,518,49,469
2011-10-17,19,Monday,Winter,1,Evening Rush,333,45,288
2011-10-17,20,Monday,Winter,1,Night,229,40,189
2011-10-17,21,Monday,Winter,1,Night,177,36,141
2011-10-17,22,Monday,Winter,1,Night,104,16,88
2011-10-17,23,Monday,Winter,2,Night,62,10,52
2011-10-18,0,Tuesday,Winter,1,Early Morning,31,8,23
2011-10-18,1,Tuesday,Winter,2,Early Morning,11,4,7
2011-10-18,2,Tuesday,Winter,1,Early Morning,5,1,4
2011-10-18,3,Tuesday,Winter,1,Early Morning,1,0,1
2011-10-18,4,Tuesday,Winter,2,Early Morning,4,0,4
2011-10-18,5,Tuesday,Winter,2,Early Morning,21,2,19
2011-10-18,6,Tuesday,Winter,1,Morning Rush,109,4,105
2011-10-18,7,Tuesday,Winter,1,Morning Rush,341,15,326
2011-10-18,8,Tuesday,Winter,1,Morning Rush,499,25,474
2011-10-18,9,Tuesday,Winter,2,Morning Rush,227,29,198
2011-10-18,10,Tuesday,Winter,2,Mid-Day,102,27,75
2011-10-18,11,Tuesday,Winter,2,Mid-Day,147,35,112
2011-10-18,12,Tuesday,Winter,2,Mid-Day,201,42,159
2011-10-18,13,Tuesday,Winter,2,Mid-Day,219,48,171
2011-10-18,14,Tuesday,Winter,2,Mid-Day,169,32,137
2011-10-18,15,Tuesday,Winter,1,Mid-Day,205,66,139
2011-10-18,16,Tuesday,Winter,1,Evening Rush,304,58,246
2011-10-18,17,Tuesday,Winter,1,Evening Rush,625,72,553
2011-10-18,18,Tuesday,Winter,1,Evening Rush,570,58,512
2011-10-18,19,Tuesday,Winter,1,Evening Rush,317,31,286
2011-10-18,20,Tuesday,Winter,1,Night,227,23,204
2011-10-18,21,Tuesday,Winter,2,Night,206,28,178
2011-10-18,22,Tuesday,Winter,2,Night,137,22,115
2011-10-18,23,Tuesday,Winter,2,Night,70,7,63
2011-10-19,0,Wednesday,Winter,2,Early Morning,34,11,23
2011-10-19,1,Wednesday,Winter,2,Early Morning,16,7,9
2011-10-19,2,Wednesday,Winter,2,Early Morning,7,1,6
2011-10-19,4,Wednesday,Winter,3,Early Morning,3,0,3
2011-10-19,5,Wednesday,Winter,3,Early Morning,3,0,3
2011-10-19,6,Wednesday,Winter,3,Morning Rush,31,3,28
2011-10-19,7,Wednesday,Winter,3,Morning Rush,68,1,67
2011-10-19,8,Wednesday,Winter,3,Morning Rush,210,10,200
2011-10-19,9,Wednesday,Winter,3,Morning Rush,202,17,185
2011-10-19,10,Wednesday,Winter,3,Mid-Day,123,14,109
2011-10-19,11,Wednesday,Winter,3,Mid-Day,149,33,116
2011-10-19,12,Wednesday,Winter,3,Mid-Day,130,13,117
2011-10-19,13,Wednesday,Winter,2,Mid-Day,106,20,86
2011-10-19,14,Wednesday,Winter,3,Mid-Day,97,17,80
2011-10-19,15,Wednesday,Winter,3,Mid-Day,120,21,99
2011-10-19,16,Wednesday,Winter,3,Evening Rush,201,21,180
2011-10-19,17,Wednesday,Winter,3,Evening Rush,181,11,170
2011-10-19,18,Wednesday,Winter,3,Evening Rush,140,8,132
2011-10-19,19,Wednesday,Winter,2,Evening Rush,197,8,189
2011-10-19,20,Wednesday,Winter,3,Night,145,5,140
2011-10-19,21,Wednesday,Winter,2,Night,85,6,79
2011-10-19,22,Wednesday,Winter,2,Night,107,13,94
2011-10-19,23,Wednesday,Winter,2,Night,69,14,55
2011-10-20,0,Thursday,Winter,1,Early Morning,26,4,22
2011-10-20,1,Thursday,Winter,1,Early Morning,15,4,11
2011-10-20,2,Thursday,Winter,1,Early Morning,4,0,4
2011-10-20,3,Thursday,Winter,1,Early Morning,1,0,1
2011-10-20,4,Thursday,Winter,1,Early Morning,8,2,6
2011-10-20,5,Thursday,Winter,1,Early Morning,26,2,24
2011-10-20,6,Thursday,Winter,1,Morning Rush,92,5,87
2011-10-20,7,Thursday,Winter,1,Morning Rush,318,15,303
2011-10-20,8,Thursday,Winter,1,Morning Rush,426,17,409
2011-10-20,9,Thursday,Winter,1,Morning Rush,223,26,197
2011-10-20,10,Thursday,Winter,1,Mid-Day,130,25,105
2011-10-20,11,Thursday,Winter,1,Mid-Day,129,30,99
2011-10-20,12,Thursday,Winter,1,Mid-Day,199,28,171
2011-10-20,13,Thursday,Winter,1,Mid-Day,164,28,136
2011-10-20,14,Thursday,Winter,2,Mid-Day,155,38,117
2011-10-20,15,Thursday,Winter,2,Mid-Day,160,22,138
2011-10-20,16,Thursday,Winter,2,Evening Rush,234,31,203
2011-10-20,17,Thursday,Winter,2,Evening Rush,494,56,438
2011-10-20,18,Thursday,Winter,2,Evening Rush,469,39,430
2011-10-20,19,Thursday,Winter,1,Evening Rush,298,20,278
2011-10-20,20,Thursday,Winter,2,Night,241,34,207
2011-10-20,21,Thursday,Winter,1,Night,165,16,149
2011-10-20,22,Thursday,Winter,1,Night,128,22,106
2011-10-20,23,Thursday,Winter,1,Night,90,7,83
2011-10-21,0,Friday,Winter,1,Early Morning,50,8,42
2011-10-21,1,Friday,Winter,1,Early Morning,26,7,19
2011-10-21,2,Friday,Winter,1,Early Morning,18,6,12
2011-10-21,3,Friday,Winter,1,Early Morning,7,0,7
2011-10-21,4,Friday,Winter,1,Early Morning,6,0,6
2011-10-21,5,Friday,Winter,1,Early Morning,31,0,31
2011-10-21,6,Friday,Winter,1,Morning Rush,85,7,78
2011-10-21,7,Friday,Winter,1,Morning Rush,233,5,228
2011-10-21,8,Friday,Winter,1,Morning Rush,402,16,386
2011-10-21,9,Friday,Winter,2,Morning Rush,222,33,189
2011-10-21,10,Friday,Winter,1,Mid-Day,138,32,106
2011-10-21,11,Friday,Winter,1,Mid-Day,174,39,135
2011-10-21,12,Friday,Winter,1,Mid-Day,240,47,193
2011-10-21,13,Friday,Winter,1,Mid-Day,206,43,163
2011-10-21,14,Friday,Winter,1,Mid-Day,198,67,131
2011-10-21,15,Friday,Winter,1,Mid-Day,235,57,178
2011-10-21,16,Friday,Winter,1,Evening Rush,302,60,242
2011-10-21,17,Friday,Winter,2,Evening Rush,524,79,445
2011-10-21,18,Friday,Winter,2,Evening Rush,397,43,354
2011-10-21,19,Friday,Winter,2,Evening Rush,253,25,228
2011-10-21,20,Friday,Winter,2,Night,184,29,155
2011-10-21,21,Friday,Winter,1,Night,143,31,112
2011-10-21,22,Friday,Winter,1,Night,113,24,89
2011-10-21,23,Friday,Winter,1,Night,117,18,99
2011-10-22,0,Saturday,Winter,1,Early Morning,96,16,80
2011-10-22,1,Saturday,Winter,1,Early Morning,70,20,50
2011-10-22,2,Saturday,Winter,1,Early Morning,31,6,25
2011-10-22,3,Saturday,Winter,1,Early Morning,20,1,19
2011-10-22,4,Saturday,Winter,1,Early Morning,8,4,4
2011-10-22,5,Saturday,Winter,1,Early Morning,8,1,7
2011-10-22,6,Saturday,Winter,1,Morning Rush,18,1,17
2011-10-22,7,Saturday,Winter,1,Morning Rush,57,8,49
2011-10-22,8,Saturday,Winter,1,Morning Rush,114,26,88
2011-10-22,9,Saturday,Winter,1,Morning Rush,169,47,122
2011-10-22,10,Saturday,Winter,2,Mid-Day,236,87,149
2011-10-22,11,Saturday,Winter,2,Mid-Day,282,110,172
2011-10-22,12,Saturday,Winter,1,Mid-Day,343,132,211
2011-10-22,13,Saturday,Winter,1,Mid-Day,322,136,186
2011-10-22,14,Saturday,Winter,2,Mid-Day,310,133,177
2011-10-22,15,Saturday,Winter,1,Mid-Day,382,159,223
2011-10-22,16,Saturday,Winter,1,Evening Rush,359,169,190
2011-10-22,17,Saturday,Winter,1,Evening Rush,360,143,217
2011-10-22,18,Saturday,Winter,1,Evening Rush,335,111,224
2011-10-22,19,Saturday,Winter,1,Evening Rush,220,47,173
2011-10-22,20,Saturday,Winter,1,Night,159,48,111
2011-10-22,21,Saturday,Winter,1,Night,157,37,120
2011-10-22,22,Saturday,Winter,1,Night,144,30,114
2011-10-22,23,Saturday,Winter,1,Night,108,27,81
2011-10-23,0,Sunday,Winter,1,Early Morning,88,24,64
2011-10-23,1,Sunday,Winter,1,Early Morning,71,11,60
2011-10-23,2,Sunday,Winter,1,Early Morning,50,10,40
2011-10-23,3,Sunday,Winter,1,Early Morning,46,15,31
2011-10-23,4,Sunday,Winter,1,Early Morning,6,5,1
2011-10-23,5,Sunday,Winter,1,Early Morning,3,1,2
2011-10-23,6,Sunday,Winter,1,Morning Rush,12,0,12
2011-10-23,7,Sunday,Winter,1,Morning Rush,21,3,18
2011-10-23,8,Sunday,Winter,1,Morning Rush,88,32,56
2011-10-23,9,Sunday,Winter,1,Morning Rush,143,48,95
2011-10-23,10,Sunday,Winter,1,Mid-Day,289,104,185
2011-10-23,11,Sunday,Winter,1,Mid-Day,333,131,202
2011-10-23,12,Sunday,Winter,1,Mid-Day,413,164,249
2011-10-23,13,Sunday,Winter,1,Mid-Day,415,160,255
2011-10-23,14,Sunday,Winter,1,Mid-Day,408,192,216
2011-10-23,15,Sunday,Winter,1,Mid-Day,387,171,216
2011-10-23,16,Sunday,Winter,1,Evening Rush,405,188,217
2011-10-23,17,Sunday,Winter,1,Evening Rush,340,120,220
2011-10-23,18,Sunday,Winter,1,Evening Rush,284,88,196
2011-10-23,19,Sunday,Winter,1,Evening Rush,193,53,140
2011-10-23,20,Sunday,Winter,1,Night,144,32,112
2011-10-23,21,Sunday,Winter,1,Night,99,24,75
2011-10-23,22,Sunday,Winter,1,Night,94,25,69
2011-10-23,23,Sunday,Winter,1,Night,49,18,31
2011-10-24,0,Monday,Winter,1,Early Morning,32,6,26
2011-10-24,1,Monday,Winter,1,Early Morning,15,7,8
2011-10-24,2,Monday,Winter,1,Early Morning,7,1,6
2011-10-24,3,Monday,Winter,1,Early Morning,4,1,3
2011-10-24,4,Monday,Winter,1,Early Morning,6,1,5
2011-10-24,5,Monday,Winter,1,Early Morning,21,2,19
2011-10-24,6,Monday,Winter,1,Morning Rush,86,3,83
2011-10-24,7,Monday,Winter,2,Morning Rush,285,11,274
2011-10-24,8,Monday,Winter,2,Morning Rush,398,20,378
2011-10-24,9,Monday,Winter,2,Morning Rush,195,29,166
2011-10-24,10,Monday,Winter,2,Mid-Day,129,47,82
2011-10-24,11,Monday,Winter,2,Mid-Day,168,59,109
2011-10-24,12,Monday,Winter,2,Mid-Day,220,64,156
2011-10-24,13,Monday,Winter,2,Mid-Day,198,60,138
2011-10-24,14,Monday,Winter,2,Mid-Day,206,63,143
2011-10-24,15,Monday,Winter,1,Mid-Day,177,52,125
2011-10-24,16,Monday,Winter,1,Evening Rush,310,68,242
2011-10-24,17,Monday,Winter,1,Evening Rush,614,87,527
2011-10-24,18,Monday,Winter,1,Evening Rush,486,58,428
2011-10-24,19,Monday,Winter,3,Evening Rush,237,25,212
2011-10-24,20,Monday,Winter,1,Night,129,11,118
2011-10-24,21,Monday,Winter,1,Night,126,12,114
2011-10-24,22,Monday,Winter,1,Night,79,3,76
2011-10-24,23,Monday,Winter,1,Night,59,9,50
2011-10-25,0,Tuesday,Winter,1,Early Morning,30,4,26
2011-10-25,1,Tuesday,Winter,1,Early Morning,11,5,6
2011-10-25,2,Tuesday,Winter,1,Early Morning,5,2,3
2011-10-25,3,Tuesday,Winter,1,Early Morning,4,1,3
2011-10-25,4,Tuesday,Winter,1,Early Morning,5,0,5
2011-10-25,5,Tuesday,Winter,1,Early Morning,24,0,24
2011-10-25,6,Tuesday,Winter,1,Morning Rush,98,3,95
2011-10-25,7,Tuesday,Winter,1,Morning Rush,314,15,299
2011-10-25,8,Tuesday,Winter,1,Morning Rush,408,25,383
2011-10-25,9,Tuesday,Winter,1,Morning Rush,223,29,194
2011-10-25,10,Tuesday,Winter,1,Mid-Day,128,26,102
2011-10-25,11,Tuesday,Winter,1,Mid-Day,166,46,120
2011-10-25,12,Tuesday,Winter,1,Mid-Day,200,35,165
2011-10-25,13,Tuesday,Winter,1,Mid-Day,198,37,161
2011-10-25,14,Tuesday,Winter,1,Mid-Day,200,66,134
2011-10-25,15,Tuesday,Winter,1,Mid-Day,234,63,171
2011-10-25,16,Tuesday,Winter,1,Evening Rush,285,52,233
2011-10-25,17,Tuesday,Winter,1,Evening Rush,585,68,517
2011-10-25,18,Tuesday,Winter,1,Evening Rush,518,65,453
2011-10-25,19,Tuesday,Winter,1,Evening Rush,338,44,294
2011-10-25,20,Tuesday,Winter,1,Night,248,40,208
2011-10-25,21,Tuesday,Winter,1,Night,201,32,169
2011-10-25,22,Tuesday,Winter,1,Night,170,22,148
2011-10-25,23,Tuesday,Winter,1,Night,94,15,79
2011-10-26,0,Wednesday,Winter,1,Early Morning,32,4,28
2011-10-26,1,Wednesday,Winter,1,Early Morning,12,3,9
2011-10-26,2,Wednesday,Winter,1,Early Morning,3,2,1
2011-10-26,3,Wednesday,Winter,1,Early Morning,3,0,3
2011-10-26,4,Wednesday,Winter,1,Early Morning,5,0,5
2011-10-26,5,Wednesday,Winter,1,Early Morning,21,0,21
2011-10-26,6,Wednesday,Winter,1,Morning Rush,92,0,92
2011-10-26,7,Wednesday,Winter,1,Morning Rush,299,15,284
2011-10-26,8,Wednesday,Winter,2,Morning Rush,464,26,438
2011-10-26,9,Wednesday,Winter,2,Morning Rush,240,14,226
2011-10-26,10,Wednesday,Winter,2,Mid-Day,131,26,105
2011-10-26,11,Wednesday,Winter,1,Mid-Day,155,23,132
2011-10-26,12,Wednesday,Winter,3,Mid-Day,194,39,155
2011-10-26,13,Wednesday,Winter,3,Mid-Day,82,20,62
2011-10-26,14,Wednesday,Winter,2,Mid-Day,66,14,52
2011-10-26,15,Wednesday,Winter,2,Mid-Day,70,11,59
2011-10-26,16,Wednesday,Winter,2,Evening Rush,213,17,196
2011-10-26,17,Wednesday,Winter,2,Evening Rush,454,40,414
2011-10-26,18,Wednesday,Winter,1,Evening Rush,453,55,398
2011-10-26,19,Wednesday,Winter,1,Evening Rush,331,25,306
2011-10-26,20,Wednesday,Winter,1,Night,207,27,180
2011-10-26,21,Wednesday,Winter,2,Night,157,17,140
2011-10-26,22,Wednesday,Winter,2,Night,135,23,112
2011-10-26,23,Wednesday,Winter,2,Night,75,3,72
2011-10-27,0,Thursday,Winter,1,Early Morning,26,3,23
2011-10-27,1,Thursday,Winter,1,Early Morning,11,2,9
2011-10-27,2,Thursday,Winter,3,Early Morning,8,3,5
2011-10-27,3,Thursday,Winter,3,Early Morning,4,1,3
2011-10-27,4,Thursday,Winter,3,Early Morning,4,1,3
2011-10-27,5,Thursday,Winter,3,Early Morning,15,1,14
2011-10-27,6,Thursday,Winter,3,Morning Rush,46,4,42
2011-10-27,7,Thursday,Winter,2,Morning Rush,137,9,128
2011-10-27,8,Thursday,Winter,3,Morning Rush,316,12,304
2011-10-27,9,Thursday,Winter,2,Morning Rush,171,16,155
2011-10-27,10,Thursday,Winter,3,Mid-Day,62,10,52
2011-10-27,11,Thursday,Winter,3,Mid-Day,52,8,44
2011-10-27,12,Thursday,Winter,3,Mid-Day,53,8,45
2011-10-27,13,Thursday,Winter,2,Mid-Day,74,10,64
2011-10-27,14,Thursday,Winter,2,Mid-Day,92,16,76
2011-10-27,15,Thursday,Winter,2,Mid-Day,107,12,95
2011-10-27,16,Thursday,Winter,2,Evening Rush,207,14,193
2011-10-27,17,Thursday,Winter,2,Evening Rush,322,31,291
2011-10-27,18,Thursday,Winter,2,Evening Rush,240,14,226
2011-10-27,19,Thursday,Winter,2,Evening Rush,219,19,200
2011-10-27,20,Thursday,Winter,1,Night,182,11,171
2011-10-27,21,Thursday,Winter,1,Night,132,13,119
2011-10-27,22,Thursday,Winter,1,Night,111,14,97
2011-10-27,23,Thursday,Winter,1,Night,68,8,60
2011-10-28,0,Friday,Winter,1,Early Morning,44,4,40
2011-10-28,1,Friday,Winter,1,Early Morning,16,7,9
2011-10-28,2,Friday,Winter,1,Early Morning,4,1,3
2011-10-28,3,Friday,Winter,1,Early Morning,8,4,4
2011-10-28,4,Friday,Winter,1,Early Morning,10,5,5
2011-10-28,5,Friday,Winter,2,Early Morning,25,0,25
2011-10-28,6,Friday,Winter,1,Morning Rush,75,1,74
2011-10-28,7,Friday,Winter,1,Morning Rush,205,6,199
2011-10-28,8,Friday,Winter,1,Morning Rush,374,13,361
2011-10-28,9,Friday,Winter,1,Morning Rush,229,19,210
2011-10-28,10,Friday,Winter,1,Mid-Day,130,28,102
2011-10-28,11,Friday,Winter,1,Mid-Day,168,40,128
2011-10-28,12,Friday,Winter,2,Mid-Day,213,46,167
2011-10-28,13,Friday,Winter,2,Mid-Day,228,43,185
2011-10-28,14,Friday,Winter,2,Mid-Day,185,33,152
2011-10-28,15,Friday,Winter,2,Mid-Day,215,44,171
2011-10-28,16,Friday,Winter,2,Evening Rush,308,46,262
2011-10-28,17,Friday,Winter,2,Evening Rush,446,35,411
2011-10-28,18,Friday,Winter,2,Evening Rush,368,36,332
2011-10-28,19,Friday,Winter,2,Evening Rush,204,16,188
2011-10-28,20,Friday,Winter,3,Night,143,12,131
2011-10-28,21,Friday,Winter,3,Night,74,5,69
2011-10-28,22,Friday,Winter,3,Night,36,4,32
2011-10-28,23,Friday,Winter,3,Night,39,8,31
2011-10-29,0,Saturday,Winter,3,Early Morning,19,0,19
2011-10-29,1,Saturday,Winter,3,Early Morning,18,0,18
2011-10-29,2,Saturday,Winter,3,Early Morning,17,1,16
2011-10-29,3,Saturday,Winter,3,Early Morning,8,0,8
2011-10-29,4,Saturday,Winter,3,Early Morning,1,0,1
2011-10-29,5,Saturday,Winter,3,Early Morning,1,0,1
2011-10-29,6,Saturday,Winter,3,Morning Rush,5,4,1
2011-10-29,7,Saturday,Winter,3,Morning Rush,7,1,6
2011-10-29,8,Saturday,Winter,3,Morning Rush,20,4,16
2011-10-29,9,Saturday,Winter,3,Morning Rush,20,1,19
2011-10-29,10,Saturday,Winter,3,Mid-Day,12,0,12
2011-10-29,11,Saturday,Winter,3,Mid-Day,27,1,26
2011-10-29,12,Saturday,Winter,3,Mid-Day,50,6,44
2011-10-29,13,Saturday,Winter,3,Mid-Day,30,0,30
2011-10-29,14,Saturday,Winter,3,Mid-Day,29,0,29
2011-10-29,15,Saturday,Winter,3,Mid-Day,41,3,38
2011-10-29,16,Saturday,Winter,3,Evening Rush,22,3,19
2011-10-29,17,Saturday,Winter,3,Evening Rush,31,3,28
2011-10-29,18,Saturday,Winter,3,Evening Rush,43,6,37
2011-10-29,19,Saturday,Winter,1,Evening Rush,39,3,36
2011-10-29,20,Saturday,Winter,1,Night,47,7,40
2011-10-29,21,Saturday,Winter,1,Night,50,1,49
2011-10-29,22,Saturday,Winter,1,Night,54,10,44
2011-10-29,23,Saturday,Winter,1,Night,36,3,33
2011-10-30,0,Sunday,Winter,1,Early Morning,54,7,47
2011-10-30,1,Sunday,Winter,1,Early Morning,43,9,34
2011-10-30,2,Sunday,Winter,1,Early Morning,50,7,43
2011-10-30,3,Sunday,Winter,1,Early Morning,33,7,26
2011-10-30,4,Sunday,Winter,1,Early Morning,11,1,10
2011-10-30,5,Sunday,Winter,1,Early Morning,4,0,4
2011-10-30,6,Sunday,Winter,1,Morning Rush,10,2,8
2011-10-30,7,Sunday,Winter,1,Morning Rush,22,7,15
2011-10-30,8,Sunday,Winter,1,Morning Rush,80,20,60
2011-10-30,9,Sunday,Winter,1,Morning Rush,147,55,92
2011-10-30,10,Sunday,Winter,1,Mid-Day,178,53,125
2011-10-30,11,Sunday,Winter,1,Mid-Day,240,58,182
2011-10-30,12,Sunday,Winter,1,Mid-Day,314,85,229
2011-10-30,13,Sunday,Winter,1,Mid-Day,345,113,232
2011-10-30,14,Sunday,Winter,1,Mid-Day,300,91,209
2011-10-30,15,Sunday,Winter,1,Mid-Day,290,88,202
2011-10-30,16,Sunday,Winter,1,Evening Rush,320,107,213
2011-10-30,17,Sunday,Winter,1,Evening Rush,245,54,191
2011-10-30,18,Sunday,Winter,1,Evening Rush,213,51,162
2011-10-30,19,Sunday,Winter,1,Evening Rush,153,28,125
2011-10-30,20,Sunday,Winter,1,Night,92,18,74
2011-10-30,21,Sunday,Winter,1,Night,79,4,75
2011-10-30,22,Sunday,Winter,1,Night,71,13,58
2011-10-30,23,Sunday,Winter,1,Night,37,7,30
2011-10-31,0,Monday,Winter,1,Early Morning,23,3,20
2011-10-31,1,Monday,Winter,1,Early Morning,13,5,8
2011-10-31,2,Monday,Winter,1,Early Morning,3,0,3
2011-10-31,3,Monday,Winter,1,Early Morning,3,0,3
2011-10-31,4,Monday,Winter,1,Early Morning,6,1,5
2011-10-31,5,Monday,Winter,1,Early Morning,18,0,18
2011-10-31,6,Monday,Winter,1,Morning Rush,86,4,82
2011-10-31,7,Monday,Winter,1,Morning Rush,227,11,216
2011-10-31,8,Monday,Winter,2,Morning Rush,372,17,355
2011-10-31,9,Monday,Winter,2,Morning Rush,211,14,197
2011-10-31,10,Monday,Winter,2,Mid-Day,105,18,87
2011-10-31,11,Monday,Winter,1,Mid-Day,128,31,97
2011-10-31,12,Monday,Winter,1,Mid-Day,170,30,140
2011-10-31,13,Monday,Winter,2,Mid-Day,152,24,128
2011-10-31,14,Monday,Winter,2,Mid-Day,141,22,119
2011-10-31,15,Monday,Winter,1,Mid-Day,168,27,141
2011-10-31,16,Monday,Winter,1,Evening Rush,272,30,242
2011-10-31,17,Monday,Winter,1,Evening Rush,486,44,442
2011-10-31,18,Monday,Winter,1,Evening Rush,422,30,392
2011-10-31,19,Monday,Winter,1,Evening Rush,238,12,226
2011-10-31,20,Monday,Winter,1,Night,172,18,154
2011-10-31,21,Monday,Winter,2,Night,116,7,109
2011-10-31,22,Monday,Winter,2,Night,85,8,77
2011-10-31,23,Monday,Winter,2,Night,52,6,46
2011-11-01,0,Tuesday,Winter,2,Early Morning,21,3,18
2011-11-01,1,Tuesday,Winter,1,Early Morning,11,3,8
2011-11-01,2,Tuesday,Winter,2,Early Morning,4,1,3
2011-11-01,3,Tuesday,Winter,2,Early Morning,6,1,5
2011-11-01,4,Tuesday,Winter,1,Early Morning,8,1,7
2011-11-01,5,Tuesday,Winter,1,Early Morning,18,0,18
2011-11-01,6,Tuesday,Winter,1,Morning Rush,93,3,90
2011-11-01,7,Tuesday,Winter,1,Morning Rush,254,8,246
2011-11-01,8,Tuesday,Winter,1,Morning Rush,419,17,402
2011-11-01,9,Tuesday,Winter,1,Morning Rush,222,16,206
2011-11-01,10,Tuesday,Winter,1,Mid-Day,135,21,114
2011-11-01,11,Tuesday,Winter,1,Mid-Day,117,16,101
2011-11-01,12,Tuesday,Winter,1,Mid-Day,176,23,153
2011-11-01,13,Tuesday,Winter,1,Mid-Day,167,20,147
2011-11-01,14,Tuesday,Winter,1,Mid-Day,150,32,118
2011-11-01,15,Tuesday,Winter,1,Mid-Day,186,38,148
2011-11-01,16,Tuesday,Winter,1,Evening Rush,298,46,252
2011-11-01,17,Tuesday,Winter,1,Evening Rush,506,36,470
2011-11-01,18,Tuesday,Winter,1,Evening Rush,460,39,421
2011-11-01,19,Tuesday,Winter,1,Evening Rush,313,39,274
2011-11-01,20,Tuesday,Winter,1,Night,209,18,191
2011-11-01,21,Tuesday,Winter,1,Night,127,13,114
2011-11-01,22,Tuesday,Winter,1,Night,96,5,91
2011-11-01,23,Tuesday,Winter,1,Night,72,11,61
2011-11-02,0,Wednesday,Winter,1,Early Morning,19,0,19
2011-11-02,1,Wednesday,Winter,1,Early Morning,10,2,8
2011-11-02,2,Wednesday,Winter,1,Early Morning,2,0,2
2011-11-02,3,Wednesday,Winter,1,Early Morning,2,0,2
2011-11-02,4,Wednesday,Winter,1,Early Morning,4,0,4
2011-11-02,5,Wednesday,Winter,1,Early Morning,27,0,27
2011-11-02,6,Wednesday,Winter,1,Morning Rush,92,1,91
2011-11-02,7,Wednesday,Winter,1,Morning Rush,251,11,240
2011-11-02,8,Wednesday,Winter,1,Morning Rush,472,20,452
2011-11-02,9,Wednesday,Winter,1,Morning Rush,228,15,213
2011-11-02,10,Wednesday,Winter,1,Mid-Day,133,25,108
2011-11-02,11,Wednesday,Winter,1,Mid-Day,144,27,117
2011-11-02,12,Wednesday,Winter,1,Mid-Day,189,32,157
2011-11-02,13,Wednesday,Winter,1,Mid-Day,161,22,139
2011-11-02,14,Wednesday,Winter,1,Mid-Day,172,40,132
2011-11-02,15,Wednesday,Winter,1,Mid-Day,187,26,161
2011-11-02,16,Wednesday,Winter,1,Evening Rush,266,35,231
2011-11-02,17,Wednesday,Winter,1,Evening Rush,553,30,523
2011-11-02,18,Wednesday,Winter,1,Evening Rush,479,31,448
2011-11-02,19,Wednesday,Winter,1,Evening Rush,282,25,257
2011-11-02,20,Wednesday,Winter,1,Night,182,5,177
2011-11-02,21,Wednesday,Winter,1,Night,168,13,155
2011-11-02,22,Wednesday,Winter,1,Night,106,7,99
2011-11-02,23,Wednesday,Winter,1,Night,57,3,54
2011-11-03,0,Thursday,Winter,1,Early Morning,31,3,28
2011-11-03,1,Thursday,Winter,1,Early Morning,15,3,12
2011-11-03,2,Thursday,Winter,1,Early Morning,7,2,5
2011-11-03,3,Thursday,Winter,1,Early Morning,5,1,4
2011-11-03,4,Thursday,Winter,1,Early Morning,4,1,3
2011-11-03,5,Thursday,Winter,1,Early Morning,28,1,27
2011-11-03,6,Thursday,Winter,1,Morning Rush,99,3,96
2011-11-03,7,Thursday,Winter,2,Morning Rush,292,12,280
2011-11-03,8,Thursday,Winter,2,Morning Rush,402,8,394
2011-11-03,9,Thursday,Winter,2,Morning Rush,164,9,155
2011-11-03,10,Thursday,Winter,2,Mid-Day,110,12,98
2011-11-03,11,Thursday,Winter,1,Mid-Day,120,12,108
2011-11-03,12,Thursday,Winter,1,Mid-Day,179,17,162
2011-11-03,13,Thursday,Winter,2,Mid-Day,169,19,150
2011-11-03,14,Thursday,Winter,1,Mid-Day,152,32,120
2011-11-03,15,Thursday,Winter,1,Mid-Day,162,24,138
2011-11-03,16,Thursday,Winter,1,Evening Rush,267,33,234
2011-11-03,17,Thursday,Winter,1,Evening Rush,498,33,465
2011-11-03,18,Thursday,Winter,1,Evening Rush,433,24,409
2011-11-03,19,Thursday,Winter,1,Evening Rush,252,18,234
2011-11-03,20,Thursday,Winter,1,Night,209,11,198
2011-11-03,21,Thursday,Winter,1,Night,144,4,140
2011-11-03,22,Thursday,Winter,1,Night,137,21,116
2011-11-03,23,Thursday,Winter,1,Night,95,15,80
2011-11-04,0,Friday,Winter,2,Early Morning,43,11,32
2011-11-04,1,Friday,Winter,2,Early Morning,17,1,16
2011-11-04,2,Friday,Winter,2,Early Morning,10,2,8
2011-11-04,3,Friday,Winter,2,Early Morning,8,1,7
2011-11-04,4,Friday,Winter,2,Early Morning,7,1,6
2011-11-04,5,Friday,Winter,2,Early Morning,23,0,23
2011-11-04,6,Friday,Winter,2,Morning Rush,66,2,64
2011-11-04,7,Friday,Winter,2,Morning Rush,245,10,235
2011-11-04,8,Friday,Winter,2,Morning Rush,395,8,387
2011-11-04,9,Friday,Winter,2,Morning Rush,254,15,239
2011-11-04,10,Friday,Winter,2,Mid-Day,134,19,115
2011-11-04,11,Friday,Winter,2,Mid-Day,162,34,128
2011-11-04,12,Friday,Winter,2,Mid-Day,197,44,153
2011-11-04,13,Friday,Winter,1,Mid-Day,194,33,161
2011-11-04,14,Friday,Winter,1,Mid-Day,201,54,147
2011-11-04,15,Friday,Winter,1,Mid-Day,237,45,192
2011-11-04,16,Friday,Winter,1,Evening Rush,290,53,237
2011-11-04,17,Friday,Winter,1,Evening Rush,480,42,438
2011-11-04,18,Friday,Winter,1,Evening Rush,374,35,339
2011-11-04,19,Friday,Winter,1,Evening Rush,196,14,182
2011-11-04,20,Friday,Winter,1,Night,186,15,171
2011-11-04,21,Friday,Winter,1,Night,123,8,115
2011-11-04,22,Friday,Winter,1,Night,115,6,109
2011-11-04,23,Friday,Winter,1,Night,89,17,72
2011-11-05,0,Saturday,Winter,1,Early Morning,52,4,48
2011-11-05,1,Saturday,Winter,1,Early Morning,62,5,57
2011-11-05,2,Saturday,Winter,1,Early Morning,31,7,24
2011-11-05,3,Saturday,Winter,1,Early Morning,8,0,8
2011-11-05,4,Saturday,Winter,1,Early Morning,8,3,5
2011-11-05,5,Saturday,Winter,1,Early Morning,2,0,2
2011-11-05,6,Saturday,Winter,1,Morning Rush,23,3,20
2011-11-05,7,Saturday,Winter,1,Morning Rush,34,3,31
2011-11-05,8,Saturday,Winter,1,Morning Rush,84,4,80
2011-11-05,9,Saturday,Winter,1,Morning Rush,141,30,111
2011-11-05,10,Saturday,Winter,1,Mid-Day,227,56,171
2011-11-05,11,Saturday,Winter,1,Mid-Day,238,69,169
2011-11-05,12,Saturday,Winter,1,Mid-Day,372,137,235
2011-11-05,13,Saturday,Winter,1,Mid-Day,355,148,207
2011-11-05,14,Saturday,Winter,1,Mid-Day,386,159,227
2011-11-05,15,Saturday,Winter,1,Mid-Day,343,141,202
2011-11-05,16,Saturday,Winter,1,Evening Rush,335,128,207
2011-11-05,17,Saturday,Winter,1,Evening Rush,334,100,234
2011-11-05,18,Saturday,Winter,1,Evening Rush,237,52,185
2011-11-05,19,Saturday,Winter,1,Evening Rush,204,45,159
2011-11-05,20,Saturday,Winter,1,Night,165,29,136
2011-11-05,21,Saturday,Winter,1,Night,118,19,99
2011-11-05,22,Saturday,Winter,1,Night,82,10,72
2011-11-05,23,Saturday,Winter,1,Night,85,4,81
2011-11-06,0,Sunday,Winter,1,Early Morning,75,10,65
2011-11-06,1,Sunday,Winter,1,Early Morning,115,11,104
2011-11-06,2,Sunday,Winter,1,Early Morning,29,6,23
2011-11-06,3,Sunday,Winter,1,Early Morning,9,5,4
2011-11-06,4,Sunday,Winter,1,Early Morning,6,0,6
2011-11-06,5,Sunday,Winter,1,Early Morning,5,0,5
2011-11-06,6,Sunday,Winter,1,Morning Rush,16,5,11
2011-11-06,7,Sunday,Winter,1,Morning Rush,28,4,24
2011-11-06,8,Sunday,Winter,2,Morning Rush,90,19,71
2011-11-06,9,Sunday,Winter,2,Morning Rush,170,36,134
2011-11-06,10,Sunday,Winter,1,Mid-Day,262,76,186
2011-11-06,11,Sunday,Winter,1,Mid-Day,320,104,216
2011-11-06,12,Sunday,Winter,1,Mid-Day,346,120,226
2011-11-06,13,Sunday,Winter,1,Mid-Day,314,105,209
2011-11-06,14,Sunday,Winter,1,Mid-Day,320,101,219
2011-11-06,15,Sunday,Winter,1,Mid-Day,306,96,210
2011-11-06,16,Sunday,Winter,1,Evening Rush,347,84,263
2011-11-06,17,Sunday,Winter,1,Evening Rush,256,71,185
2011-11-06,18,Sunday,Winter,1,Evening Rush,185,39,146
2011-11-06,19,Sunday,Winter,1,Evening Rush,151,21,130
2011-11-06,20,Sunday,Winter,1,Night,116,16,100
2011-11-06,21,Sunday,Winter,1,Night,88,11,77
2011-11-06,22,Sunday,Winter,1,Night,45,5,40
2011-11-06,23,Sunday,Winter,1,Night,50,7,43
2011-11-07,0,Monday,Winter,1,Early Morning,15,1,14
2011-11-07,1,Monday,Winter,1,Early Morning,8,2,6
2011-11-07,2,Monday,Winter,1,Early Morning,2,0,2
2011-11-07,3,Monday,Winter,1,Early Morning,3,0,3
2011-11-07,4,Monday,Winter,1,Early Morning,6,2,4
2011-11-07,5,Monday,Winter,1,Early Morning,26,1,25
2011-11-07,6,Monday,Winter,2,Morning Rush,99,2,97
2011-11-07,7,Monday,Winter,2,Morning Rush,311,6,305
2011-11-07,8,Monday,Winter,2,Morning Rush,410,13,397
2011-11-07,9,Monday,Winter,2,Morning Rush,174,18,156
2011-11-07,10,Monday,Winter,1,Mid-Day,123,28,95
2011-11-07,11,Monday,Winter,1,Mid-Day,128,28,100
2011-11-07,12,Monday,Winter,1,Mid-Day,179,21,158
2011-11-07,13,Monday,Winter,1,Mid-Day,189,32,157
2011-11-07,14,Monday,Winter,1,Mid-Day,145,30,115
2011-11-07,15,Monday,Winter,1,Mid-Day,170,38,132
2011-11-07,16,Monday,Winter,1,Evening Rush,295,40,255
2011-11-07,17,Monday,Winter,1,Evening Rush,528,39,489
2011-11-07,18,Monday,Winter,1,Evening Rush,425,18,407
2011-11-07,19,Monday,Winter,1,Evening Rush,300,20,280
2011-11-07,20,Monday,Winter,1,Night,204,17,187
2011-11-07,21,Monday,Winter,1,Night,139,10,129
2011-11-07,22,Monday,Winter,1,Night,108,6,102
2011-11-07,23,Monday,Winter,1,Night,48,1,47
2011-11-08,0,Tuesday,Winter,1,Early Morning,18,0,18
2011-11-08,1,Tuesday,Winter,1,Early Morning,11,3,8
2011-11-08,2,Tuesday,Winter,1,Early Morning,1,0,1
2011-11-08,3,Tuesday,Winter,1,Early Morning,3,0,3
2011-11-08,4,Tuesday,Winter,1,Early Morning,4,0,4
2011-11-08,5,Tuesday,Winter,1,Early Morning,18,1,17
2011-11-08,6,Tuesday,Winter,1,Morning Rush,99,3,96
2011-11-08,7,Tuesday,Winter,1,Morning Rush,323,7,316
2011-11-08,8,Tuesday,Winter,1,Morning Rush,466,11,455
2011-11-08,9,Tuesday,Winter,1,Morning Rush,191,14,177
2011-11-08,10,Tuesday,Winter,1,Mid-Day,129,25,104
2011-11-08,11,Tuesday,Winter,1,Mid-Day,147,21,126
2011-11-08,12,Tuesday,Winter,1,Mid-Day,203,28,175
2011-11-08,13,Tuesday,Winter,1,Mid-Day,196,31,165
2011-11-08,14,Tuesday,Winter,1,Mid-Day,161,32,129
2011-11-08,15,Tuesday,Winter,1,Mid-Day,188,33,155
2011-11-08,16,Tuesday,Winter,1,Evening Rush,289,39,250
2011-11-08,17,Tuesday,Winter,1,Evening Rush,499,40,459
2011-11-08,18,Tuesday,Winter,1,Evening Rush,462,30,432
2011-11-08,19,Tuesday,Winter,1,Evening Rush,278,14,264
2011-11-08,20,Tuesday,Winter,1,Night,181,12,169
2011-11-08,21,Tuesday,Winter,1,Night,182,16,166
2011-11-08,22,Tuesday,Winter,1,Night,108,13,95
2011-11-08,23,Tuesday,Winter,1,Night,48,3,45
2011-11-09,0,Wednesday,Winter,1,Early Morning,13,0,13
2011-11-09,1,Wednesday,Winter,1,Early Morning,10,0,10
2011-11-09,2,Wednesday,Winter,1,Early Morning,5,0,5
2011-11-09,3,Wednesday,Winter,1,Early Morning,4,0,4
2011-11-09,4,Wednesday,Winter,1,Early Morning,4,0,4
2011-11-09,5,Wednesday,Winter,1,Early Morning,28,0,28
2011-11-09,6,Wednesday,Winter,1,Morning Rush,98,0,98
2011-11-09,7,Wednesday,Winter,1,Morning Rush,300,0,300
2011-11-09,8,Wednesday,Winter,1,Morning Rush,456,19,437
2011-11-09,9,Wednesday,Winter,1,Morning Rush,219,22,197
2011-11-09,10,Wednesday,Winter,1,Mid-Day,105,16,89
2011-11-09,11,Wednesday,Winter,1,Mid-Day,152,21,131
2011-11-09,12,Wednesday,Winter,1,Mid-Day,180,24,156
2011-11-09,13,Wednesday,Winter,1,Mid-Day,167,31,136
2011-11-09,14,Wednesday,Winter,1,Mid-Day,179,26,153
2011-11-09,15,Wednesday,Winter,1,Mid-Day,151,21,130
2011-11-09,16,Wednesday,Winter,1,Evening Rush,281,24,257
2011-11-09,17,Wednesday,Winter,1,Evening Rush,485,27,458
2011-11-09,18,Wednesday,Winter,1,Evening Rush,408,21,387
2011-11-09,19,Wednesday,Winter,1,Evening Rush,304,12,292
2011-11-09,20,Wednesday,Winter,1,Night,219,18,201
2011-11-09,21,Wednesday,Winter,1,Night,161,9,152
2011-11-09,22,Wednesday,Winter,1,Night,114,9,105
2011-11-09,23,Wednesday,Winter,1,Night,66,5,61
2011-11-10,0,Thursday,Winter,1,Early Morning,24,0,24
2011-11-10,1,Thursday,Winter,2,Early Morning,11,1,10
2011-11-10,2,Thursday,Winter,2,Early Morning,5,0,5
2011-11-10,3,Thursday,Winter,1,Early Morning,11,0,11
2011-11-10,4,Thursday,Winter,1,Early Morning,3,1,2
2011-11-10,5,Thursday,Winter,2,Early Morning,23,1,22
2011-11-10,6,Thursday,Winter,2,Morning Rush,114,4,110
2011-11-10,7,Thursday,Winter,2,Morning Rush,272,6,266
2011-11-10,8,Thursday,Winter,2,Morning Rush,436,18,418
2011-11-10,9,Thursday,Winter,2,Morning Rush,211,23,188
2011-11-10,10,Thursday,Winter,2,Mid-Day,117,17,100
2011-11-10,11,Thursday,Winter,2,Mid-Day,108,9,99
2011-11-10,12,Thursday,Winter,2,Mid-Day,167,18,149
2011-11-10,13,Thursday,Winter,3,Mid-Day,96,9,87
2011-11-10,14,Thursday,Winter,3,Mid-Day,64,6,58
2011-11-10,15,Thursday,Winter,3,Mid-Day,62,5,57
2011-11-10,16,Thursday,Winter,3,Evening Rush,73,6,67
2011-11-10,17,Thursday,Winter,3,Evening Rush,177,9,168
2011-11-10,18,Thursday,Winter,2,Evening Rush,273,10,263
2011-11-10,19,Thursday,Winter,2,Evening Rush,211,19,192
2011-11-10,20,Thursday,Winter,2,Night,168,8,160
2011-11-10,21,Thursday,Winter,1,Night,136,6,130
2011-11-10,22,Thursday,Winter,1,Night,89,5,84
2011-11-10,23,Thursday,Winter,2,Night,82,9,73
2011-11-11,0,Friday,Winter,1,Early Morning,66,10,56
2011-11-11,1,Friday,Winter,1,Early Morning,19,3,16
2011-11-11,2,Friday,Winter,1,Early Morning,11,1,10
2011-11-11,3,Friday,Winter,1,Early Morning,6,0,6
2011-11-11,4,Friday,Winter,1,Early Morning,8,0,8
2011-11-11,5,Friday,Winter,1,Early Morning,13,0,13
2011-11-11,6,Friday,Winter,1,Morning Rush,46,0,46
2011-11-11,7,Friday,Winter,1,Morning Rush,121,5,116
2011-11-11,8,Friday,Winter,1,Morning Rush,258,9,249
2011-11-11,9,Friday,Winter,1,Morning Rush,201,15,186
2011-11-11,10,Friday,Winter,1,Mid-Day,200,38,162
2011-11-11,11,Friday,Winter,1,Mid-Day,170,20,150
2011-11-11,12,Friday,Winter,1,Mid-Day,239,41,198
2011-11-11,13,Friday,Winter,1,Mid-Day,236,57,179
2011-11-11,14,Friday,Winter,1,Mid-Day,247,64,183
2011-11-11,15,Friday,Winter,1,Mid-Day,216,29,187
2011-11-11,16,Friday,Winter,1,Evening Rush,238,49,189
2011-11-11,17,Friday,Winter,1,Evening Rush,310,24,286
2011-11-11,18,Friday,Winter,1,Evening Rush,208,23,185
2011-11-11,19,Friday,Winter,1,Evening Rush,199,17,182
2011-11-11,20,Friday,Winter,1,Night,109,12,97
2011-11-11,21,Friday,Winter,1,Night,83,4,79
2011-11-11,22,Friday,Winter,1,Night,91,13,78
2011-11-11,23,Friday,Winter,1,Night,73,6,67
2011-11-12,0,Saturday,Winter,1,Early Morning,64,12,52
2011-11-12,1,Saturday,Winter,1,Early Morning,54,9,45
2011-11-12,2,Saturday,Winter,1,Early Morning,46,7,39
2011-11-12,3,Saturday,Winter,1,Early Morning,17,4,13
2011-11-12,4,Saturday,Winter,1,Early Morning,7,0,7
2011-11-12,5,Saturday,Winter,1,Early Morning,4,1,3
2011-11-12,6,Saturday,Winter,1,Morning Rush,7,0,7
2011-11-12,7,Saturday,Winter,1,Morning Rush,27,3,24
2011-11-12,8,Saturday,Winter,1,Morning Rush,101,14,87
2011-11-12,9,Saturday,Winter,1,Morning Rush,160,18,142
2011-11-12,10,Saturday,Winter,1,Mid-Day,232,62,170
2011-11-12,11,Saturday,Winter,1,Mid-Day,315,102,213
2011-11-12,12,Saturday,Winter,1,Mid-Day,366,142,224
2011-11-12,13,Saturday,Winter,1,Mid-Day,353,128,225
2011-11-12,14,Saturday,Winter,1,Mid-Day,435,191,244
2011-11-12,15,Saturday,Winter,1,Mid-Day,386,165,221
2011-11-12,16,Saturday,Winter,1,Evening Rush,361,137,224
2011-11-12,17,Saturday,Winter,1,Evening Rush,285,92,193
2011-11-12,18,Saturday,Winter,1,Evening Rush,203,53,150
2011-11-12,19,Saturday,Winter,1,Evening Rush,171,32,139
2011-11-12,20,Saturday,Winter,1,Night,132,31,101
2011-11-12,21,Saturday,Winter,1,Night,122,19,103
2011-11-12,22,Saturday,Winter,1,Night,118,30,88
2011-11-12,23,Saturday,Winter,1,Night,101,23,78
2011-11-13,0,Sunday,Winter,2,Early Morning,73,12,61
2011-11-13,1,Sunday,Winter,2,Early Morning,71,13,58
2011-11-13,2,Sunday,Winter,1,Early Morning,57,9,48
2011-11-13,3,Sunday,Winter,2,Early Morning,28,8,20
2011-11-13,4,Sunday,Winter,2,Early Morning,6,1,5
2011-11-13,5,Sunday,Winter,1,Early Morning,5,2,3
2011-11-13,6,Sunday,Winter,1,Morning Rush,23,5,18
2011-11-13,7,Sunday,Winter,1,Morning Rush,43,13,30
2011-11-13,8,Sunday,Winter,1,Morning Rush,79,24,55
2011-11-13,9,Sunday,Winter,1,Morning Rush,135,38,97
2011-11-13,10,Sunday,Winter,1,Mid-Day,241,63,178
2011-11-13,11,Sunday,Winter,1,Mid-Day,295,108,187
2011-11-13,12,Sunday,Winter,2,Mid-Day,354,112,242
2011-11-13,13,Sunday,Winter,2,Mid-Day,339,105,234
2011-11-13,14,Sunday,Winter,2,Mid-Day,371,108,263
2011-11-13,15,Sunday,Winter,2,Mid-Day,310,89,221
2011-11-13,16,Sunday,Winter,2,Evening Rush,319,93,226
2011-11-13,17,Sunday,Winter,1,Evening Rush,231,44,187
2011-11-13,18,Sunday,Winter,1,Evening Rush,190,35,155
2011-11-13,19,Sunday,Winter,1,Evening Rush,157,36,121
2011-11-13,20,Sunday,Winter,1,Night,139,24,115
2011-11-13,21,Sunday,Winter,1,Night,95,19,76
2011-11-13,22,Sunday,Winter,1,Night,89,25,64
2011-11-13,23,Sunday,Winter,1,Night,67,18,49
2011-11-14,0,Monday,Winter,1,Early Morning,30,8,22
2011-11-14,1,Monday,Winter,1,Early Morning,11,5,6
2011-11-14,2,Monday,Winter,1,Early Morning,17,7,10
2011-11-14,3,Monday,Winter,1,Early Morning,7,4,3
2011-11-14,4,Monday,Winter,1,Early Morning,5,0,5
2011-11-14,5,Monday,Winter,2,Early Morning,19,0,19
2011-11-14,6,Monday,Winter,2,Morning Rush,114,10,104
2011-11-14,7,Monday,Winter,1,Morning Rush,322,11,311
2011-11-14,8,Monday,Winter,2,Morning Rush,452,27,425
2011-11-14,9,Monday,Winter,2,Morning Rush,233,29,204
2011-11-14,10,Monday,Winter,2,Mid-Day,111,26,85
2011-11-14,11,Monday,Winter,2,Mid-Day,128,22,106
2011-11-14,12,Monday,Winter,1,Mid-Day,202,36,166
2011-11-14,13,Monday,Winter,1,Mid-Day,203,50,153
2011-11-14,14,Monday,Winter,1,Mid-Day,185,47,138
2011-11-14,15,Monday,Winter,1,Mid-Day,195,53,142
2011-11-14,16,Monday,Winter,1,Evening Rush,315,51,264
2011-11-14,17,Monday,Winter,1,Evening Rush,519,55,464
2011-11-14,18,Monday,Winter,1,Evening Rush,489,29,460
2011-11-14,19,Monday,Winter,1,Evening Rush,302,28,274
2011-11-14,20,Monday,Winter,1,Night,240,30,210
2011-11-14,21,Monday,Winter,1,Night,213,37,176
2011-11-14,22,Monday,Winter,1,Night,113,17,96
2011-11-14,23,Monday,Winter,1,Night,61,13,48
2011-11-15,0,Tuesday,Winter,1,Early Morning,22,7,15
2011-11-15,1,Tuesday,Winter,1,Early Morning,10,5,5
2011-11-15,2,Tuesday,Winter,1,Early Morning,15,7,8
2011-11-15,3,Tuesday,Winter,2,Early Morning,4,0,4
2011-11-15,4,Tuesday,Winter,1,Early Morning,7,1,6
2011-11-15,5,Tuesday,Winter,1,Early Morning,28,2,26
2011-11-15,6,Tuesday,Winter,2,Morning Rush,108,4,104
2011-11-15,7,Tuesday,Winter,2,Morning Rush,319,21,298
2011-11-15,8,Tuesday,Winter,2,Morning Rush,480,27,453
2011-11-15,9,Tuesday,Winter,2,Morning Rush,200,26,174
2011-11-15,10,Tuesday,Winter,2,Mid-Day,138,23,115
2011-11-15,11,Tuesday,Winter,2,Mid-Day,134,18,116
2011-11-15,12,Tuesday,Winter,2,Mid-Day,176,28,148
2011-11-15,13,Tuesday,Winter,3,Mid-Day,153,21,132
2011-11-15,14,Tuesday,Winter,2,Mid-Day,147,27,120
2011-11-15,15,Tuesday,Winter,2,Mid-Day,191,36,155
2011-11-15,16,Tuesday,Winter,2,Evening Rush,271,31,240
2011-11-15,17,Tuesday,Winter,2,Evening Rush,451,29,422
2011-11-15,18,Tuesday,Winter,2,Evening Rush,441,27,414
2011-11-15,19,Tuesday,Winter,2,Evening Rush,286,27,259
2011-11-15,20,Tuesday,Winter,2,Night,238,26,212
2011-11-15,21,Tuesday,Winter,2,Night,168,23,145
2011-11-15,22,Tuesday,Winter,2,Night,128,19,109
2011-11-15,23,Tuesday,Winter,2,Night,80,14,66
2011-11-16,0,Wednesday,Winter,2,Early Morning,31,5,26
2011-11-16,1,Wednesday,Winter,3,Early Morning,5,0,5
2011-11-16,2,Wednesday,Winter,2,Early Morning,10,4,6
2011-11-16,3,Wednesday,Winter,2,Early Morning,5,2,3
2011-11-16,4,Wednesday,Winter,2,Early Morning,4,1,3
2011-11-16,5,Wednesday,Winter,3,Early Morning,13,0,13
2011-11-16,6,Wednesday,Winter,2,Morning Rush,56,4,52
2011-11-16,7,Wednesday,Winter,3,Morning Rush,137,7,130
2011-11-16,8,Wednesday,Winter,3,Morning Rush,232,9,223
2011-11-16,9,Wednesday,Winter,3,Morning Rush,82,5,77
2011-11-16,10,Wednesday,Winter,3,Mid-Day,36,4,32
2011-11-16,11,Wednesday,Winter,3,Mid-Day,60,7,53
2011-11-16,12,Wednesday,Winter,3,Mid-Day,54,5,49
2011-11-16,13,Wednesday,Winter,3,Mid-Day,58,6,52
2011-11-16,14,Wednesday,Winter,2,Mid-Day,61,12,49
2011-11-16,15,Wednesday,Winter,3,Mid-Day,66,16,50
2011-11-16,16,Wednesday,Winter,3,Evening Rush,123,13,110
2011-11-16,17,Wednesday,Winter,2,Evening Rush,233,17,216
2011-11-16,18,Wednesday,Winter,3,Evening Rush,189,13,176
2011-11-16,19,Wednesday,Winter,3,Evening Rush,111,3,108
2011-11-16,20,Wednesday,Winter,3,Night,99,5,94
2011-11-16,21,Wednesday,Winter,3,Night,75,3,72
2011-11-16,22,Wednesday,Winter,3,Night,46,1,45
2011-11-16,23,Wednesday,Winter,3,Night,31,3,28
2011-11-17,0,Thursday,Winter,2,Early Morning,24,2,22
2011-11-17,1,Thursday,Winter,2,Early Morning,5,0,5
2011-11-17,2,Thursday,Winter,2,Early Morning,5,0,5
2011-11-17,3,Thursday,Winter,2,Early Morning,3,0,3
2011-11-17,4,Thursday,Winter,2,Early Morning,4,1,3
2011-11-17,5,Thursday,Winter,3,Early Morning,22,1,21
2011-11-17,6,Thursday,Winter,3,Morning Rush,75,3,72
2011-11-17,7,Thursday,Winter,3,Morning Rush,168,4,164
2011-11-17,8,Thursday,Winter,3,Morning Rush,355,12,343
2011-11-17,9,Thursday,Winter,2,Morning Rush,198,14,184
2011-11-17,10,Thursday,Winter,2,Mid-Day,81,7,74
2011-11-17,11,Thursday,Winter,3,Mid-Day,97,4,93
2011-11-17,12,Thursday,Winter,2,Mid-Day,121,6,115
2011-11-17,13,Thursday,Winter,2,Mid-Day,124,15,109
2011-11-17,14,Thursday,Winter,2,Mid-Day,110,5,105
2011-11-17,15,Thursday,Winter,2,Mid-Day,116,10,106
2011-11-17,16,Thursday,Winter,1,Evening Rush,195,8,187
2011-11-17,17,Thursday,Winter,1,Evening Rush,399,20,379
2011-11-17,18,Thursday,Winter,1,Evening Rush,307,9,298
2011-11-17,19,Thursday,Winter,1,Evening Rush,217,7,210
2011-11-17,20,Thursday,Winter,1,Night,169,7,162
2011-11-17,21,Thursday,Winter,1,Night,116,3,113
2011-11-17,22,Thursday,Winter,1,Night,84,1,83
2011-11-17,23,Thursday,Winter,1,Night,58,0,58
2011-11-18,0,Friday,Winter,1,Early Morning,30,2,28
2011-11-18,1,Friday,Winter,1,Early Morning,10,0,10
2011-11-18,2,Friday,Winter,1,Early Morning,10,2,8
2011-11-18,3,Friday,Winter,1,Early Morning,2,0,2
2011-11-18,4,Friday,Winter,1,Early Morning,5,0,5
2011-11-18,5,Friday,Winter,1,Early Morning,22,0,22
2011-11-18,6,Friday,Winter,1,Morning Rush,71,1,70
2011-11-18,7,Friday,Winter,1,Morning Rush,216,5,211
2011-11-18,8,Friday,Winter,1,Morning Rush,375,6,369
2011-11-18,9,Friday,Winter,1,Morning Rush,213,6,207
2011-11-18,10,Friday,Winter,1,Mid-Day,115,10,105
2011-11-18,11,Friday,Winter,1,Mid-Day,140,18,122
2011-11-18,12,Friday,Winter,1,Mid-Day,165,22,143
2011-11-18,13,Friday,Winter,1,Mid-Day,177,31,146
2011-11-18,14,Friday,Winter,1,Mid-Day,154,31,123
2011-11-18,15,Friday,Winter,1,Mid-Day,178,27,151
2011-11-18,16,Friday,Winter,1,Evening Rush,209,19,190
2011-11-18,17,Friday,Winter,1,Evening Rush,378,17,361
2011-11-18,18,Friday,Winter,1,Evening Rush,328,16,312
2011-11-18,19,Friday,Winter,1,Evening Rush,190,7,183
2011-11-18,20,Friday,Winter,1,Night,137,8,129
2011-11-18,21,Friday,Winter,1,Night,111,3,108
2011-11-18,22,Friday,Winter,1,Night,97,9,88
2011-11-18,23,Friday,Winter,1,Night,59,5,54
2011-11-19,0,Saturday,Winter,1,Early Morning,53,4,49
2011-11-19,1,Saturday,Winter,1,Early Morning,35,1,34
2011-11-19,2,Saturday,Winter,1,Early Morning,46,12,34
2011-11-19,3,Saturday,Winter,1,Early Morning,15,4,11
2011-11-19,4,Saturday,Winter,1,Early Morning,8,4,4
2011-11-19,5,Saturday,Winter,1,Early Morning,2,0,2
2011-11-19,6,Saturday,Winter,1,Morning Rush,12,2,10
2011-11-19,7,Saturday,Winter,1,Morning Rush,41,3,38
2011-11-19,8,Saturday,Winter,1,Morning Rush,92,12,80
2011-11-19,9,Saturday,Winter,1,Morning Rush,142,12,130
2011-11-19,10,Saturday,Winter,1,Mid-Day,200,35,165
2011-11-19,11,Saturday,Winter,1,Mid-Day,233,50,183
2011-11-19,12,Saturday,Winter,1,Mid-Day,311,93,218
2011-11-19,13,Saturday,Winter,1,Mid-Day,363,118,245
2011-11-19,14,Saturday,Winter,1,Mid-Day,349,121,228
2011-11-19,15,Saturday,Winter,1,Mid-Day,382,120,262
2011-11-19,16,Saturday,Winter,1,Evening Rush,287,99,188
2011-11-19,17,Saturday,Winter,1,Evening Rush,232,61,171
2011-11-19,18,Saturday,Winter,1,Evening Rush,208,36,172
2011-11-19,19,Saturday,Winter,2,Evening Rush,182,33,149
2011-11-19,20,Saturday,Winter,2,Night,163,48,115
2011-11-19,21,Saturday,Winter,2,Night,108,29,79
2011-11-19,22,Saturday,Winter,2,Night,106,26,80
2011-11-19,23,Saturday,Winter,1,Night,93,20,73
2011-11-20,0,Sunday,Winter,1,Early Morning,93,14,79
2011-11-20,1,Sunday,Winter,1,Early Morning,84,11,73
2011-11-20,2,Sunday,Winter,1,Early Morning,56,12,44
2011-11-20,3,Sunday,Winter,2,Early Morning,37,6,31
2011-11-20,4,Sunday,Winter,2,Early Morning,12,2,10
2011-11-20,5,Sunday,Winter,2,Early Morning,4,0,4
2011-11-20,6,Sunday,Winter,2,Morning Rush,9,3,6
2011-11-20,7,Sunday,Winter,1,Morning Rush,23,4,19
2011-11-20,8,Sunday,Winter,2,Morning Rush,65,13,52
2011-11-20,9,Sunday,Winter,1,Morning Rush,138,29,109
2011-11-20,10,Sunday,Winter,2,Mid-Day,229,46,183
2011-11-20,11,Sunday,Winter,2,Mid-Day,286,74,212
2011-11-20,12,Sunday,Winter,2,Mid-Day,304,70,234
2011-11-20,13,Sunday,Winter,2,Mid-Day,369,84,285
2011-11-20,14,Sunday,Winter,1,Mid-Day,363,113,250
2011-11-20,15,Sunday,Winter,2,Mid-Day,351,109,242
2011-11-20,16,Sunday,Winter,2,Evening Rush,306,81,225
2011-11-20,17,Sunday,Winter,2,Evening Rush,203,35,168
2011-11-20,18,Sunday,Winter,2,Evening Rush,145,22,123
2011-11-20,19,Sunday,Winter,2,Evening Rush,157,17,140
2011-11-20,20,Sunday,Winter,2,Night,113,23,90
2011-11-20,21,Sunday,Winter,2,Night,105,11,94
2011-11-20,22,Sunday,Winter,3,Night,40,5,35
2011-11-20,23,Sunday,Winter,3,Night,28,3,25
2011-11-21,0,Monday,Winter,2,Early Morning,17,4,13
2011-11-21,1,Monday,Winter,3,Early Morning,12,4,8
2011-11-21,2,Monday,Winter,3,Early Morning,3,1,2
2011-11-21,3,Monday,Winter,3,Early Morning,4,0,4
2011-11-21,4,Monday,Winter,3,Early Morning,5,0,5
2011-11-21,5,Monday,Winter,2,Early Morning,20,0,20
2011-11-21,6,Monday,Winter,2,Morning Rush,76,0,76
2011-11-21,7,Monday,Winter,2,Morning Rush,246,17,229
2011-11-21,8,Monday,Winter,2,Morning Rush,391,13,378
2011-11-21,9,Monday,Winter,2,Morning Rush,237,15,222
2011-11-21,10,Monday,Winter,2,Mid-Day,135,25,110
2011-11-21,11,Monday,Winter,2,Mid-Day,128,16,112
2011-11-21,12,Monday,Winter,2,Mid-Day,162,24,138
2011-11-21,13,Monday,Winter,2,Mid-Day,134,13,121
2011-11-21,14,Monday,Winter,2,Mid-Day,135,14,121
2011-11-21,15,Monday,Winter,3,Mid-Day,108,15,93
2011-11-21,16,Monday,Winter,3,Evening Rush,108,13,95
2011-11-21,17,Monday,Winter,3,Evening Rush,210,10,200
2011-11-21,18,Monday,Winter,3,Evening Rush,192,8,184
2011-11-21,19,Monday,Winter,3,Evening Rush,137,2,135
2011-11-21,20,Monday,Winter,3,Night,80,5,75
2011-11-21,21,Monday,Winter,3,Night,114,11,103
2011-11-21,22,Monday,Winter,3,Night,78,6,72
2011-11-21,23,Monday,Winter,3,Night,33,4,29
2011-11-22,0,Tuesday,Winter,3,Early Morning,14,0,14
2011-11-22,1,Tuesday,Winter,3,Early Morning,6,1,5
2011-11-22,2,Tuesday,Winter,3,Early Morning,6,2,4
2011-11-22,3,Tuesday,Winter,3,Early Morning,3,1,2
2011-11-22,4,Tuesday,Winter,3,Early Morning,7,0,7
2011-11-22,5,Tuesday,Winter,3,Early Morning,18,1,17
2011-11-22,6,Tuesday,Winter,2,Morning Rush,64,1,63
2011-11-22,7,Tuesday,Winter,3,Morning Rush,121,2,119
2011-11-22,8,Tuesday,Winter,3,Morning Rush,190,5,185
2011-11-22,9,Tuesday,Winter,3,Morning Rush,149,2,147
2011-11-22,10,Tuesday,Winter,3,Mid-Day,52,6,46
2011-11-22,11,Tuesday,Winter,3,Mid-Day,32,4,28
2011-11-22,12,Tuesday,Winter,3,Mid-Day,21,3,18
2011-11-22,13,Tuesday,Winter,3,Mid-Day,26,4,22
2011-11-22,14,Tuesday,Winter,3,Mid-Day,35,4,31
2011-11-22,15,Tuesday,Winter,3,Mid-Day,34,2,32
2011-11-22,16,Tuesday,Winter,3,Evening Rush,62,3,59
2011-11-22,17,Tuesday,Winter,3,Evening Rush,165,4,161
2011-11-22,18,Tuesday,Winter,3,Evening Rush,148,0,148
2011-11-22,19,Tuesday,Winter,3,Evening Rush,111,5,106
2011-11-22,20,Tuesday,Winter,2,Night,127,6,121
2011-11-22,21,Tuesday,Winter,2,Night,90,4,86
2011-11-22,22,Tuesday,Winter,2,Night,87,6,81
2011-11-22,23,Tuesday,Winter,2,Night,39,3,36
2011-11-23,0,Wednesday,Winter,2,Early Morning,16,2,14
2011-11-23,1,Wednesday,Winter,2,Early Morning,8,0,8
2011-11-23,2,Wednesday,Winter,3,Early Morning,6,1,5
2011-11-23,3,Wednesday,Winter,3,Early Morning,3,1,2
2011-11-23,4,Wednesday,Winter,3,Early Morning,5,0,5
2011-11-23,5,Wednesday,Winter,2,Early Morning,17,1,16
2011-11-23,6,Wednesday,Winter,2,Morning Rush,69,1,68
2011-11-23,7,Wednesday,Winter,2,Morning Rush,156,2,154
2011-11-23,8,Wednesday,Winter,2,Morning Rush,323,7,316
2011-11-23,9,Wednesday,Winter,2,Morning Rush,167,3,164
2011-11-23,10,Wednesday,Winter,2,Mid-Day,76,6,70
2011-11-23,11,Wednesday,Winter,2,Mid-Day,116,9,107
2011-11-23,12,Wednesday,Winter,1,Mid-Day,160,9,151
2011-11-23,13,Wednesday,Winter,2,Mid-Day,174,12,162
2011-11-23,14,Wednesday,Winter,1,Mid-Day,213,13,200
2011-11-23,15,Wednesday,Winter,2,Mid-Day,207,13,194
2011-11-23,16,Wednesday,Winter,2,Evening Rush,173,4,169
2011-11-23,17,Wednesday,Winter,3,Evening Rush,163,7,156
2011-11-23,18,Wednesday,Winter,2,Evening Rush,145,7,138
2011-11-23,19,Wednesday,Winter,1,Evening Rush,122,6,116
2011-11-23,20,Wednesday,Winter,1,Night,68,1,67
2011-11-23,21,Wednesday,Winter,1,Night,66,0,66
2011-11-23,22,Wednesday,Winter,1,Night,62,3,59
2011-11-23,23,Wednesday,Winter,1,Night,51,4,47
2011-11-24,0,Thursday,Winter,1,Early Morning,23,1,22
2011-11-24,1,Thursday,Winter,1,Early Morning,24,1,23
2011-11-24,2,Thursday,Winter,1,Early Morning,22,3,19
2011-11-24,3,Thursday,Winter,1,Early Morning,5,1,4
2011-11-24,4,Thursday,Winter,1,Early Morning,2,1,1
2011-11-24,5,Thursday,Winter,1,Early Morning,11,1,10
2011-11-24,6,Thursday,Winter,1,Morning Rush,6,1,5
2011-11-24,7,Thursday,Winter,1,Morning Rush,40,9,31
2011-11-24,8,Thursday,Winter,1,Morning Rush,46,4,42
2011-11-24,9,Thursday,Winter,1,Morning Rush,81,13,68
2011-11-24,10,Thursday,Winter,1,Mid-Day,98,34,64
2011-11-24,11,Thursday,Winter,1,Mid-Day,142,52,90
2011-11-24,12,Thursday,Winter,1,Mid-Day,150,62,88
2011-11-24,13,Thursday,Winter,1,Mid-Day,175,84,91
2011-11-24,14,Thursday,Winter,1,Mid-Day,168,74,94
2011-11-24,15,Thursday,Winter,1,Mid-Day,149,78,71
2011-11-24,16,Thursday,Winter,1,Evening Rush,114,48,66
2011-11-24,17,Thursday,Winter,1,Evening Rush,74,34,40
2011-11-24,18,Thursday,Winter,1,Evening Rush,37,13,24
2011-11-24,19,Thursday,Winter,1,Evening Rush,28,15,13
2011-11-24,20,Thursday,Winter,1,Night,31,14,17
2011-11-24,21,Thursday,Winter,1,Night,26,7,19
2011-11-24,22,Thursday,Winter,1,Night,22,8,14
2011-11-24,23,Thursday,Winter,1,Night,21,2,19
2011-11-25,0,Friday,Winter,1,Early Morning,29,7,22
2011-11-25,1,Friday,Winter,1,Early Morning,14,2,12
2011-11-25,2,Friday,Winter,1,Early Morning,10,4,6
2011-11-25,3,Friday,Winter,1,Early Morning,2,0,2
2011-11-25,4,Friday,Winter,1,Early Morning,7,4,3
2011-11-25,5,Friday,Winter,1,Early Morning,5,2,3
2011-11-25,6,Friday,Winter,1,Morning Rush,13,4,9
2011-11-25,7,Friday,Winter,1,Morning Rush,35,4,31
2011-11-25,8,Friday,Winter,1,Morning Rush,74,6,68
2011-11-25,9,Friday,Winter,1,Morning Rush,95,25,70
2011-11-25,10,Friday,Winter,1,Mid-Day,142,60,82
2011-11-25,11,Friday,Winter,1,Mid-Day,226,99,127
2011-11-25,12,Friday,Winter,1,Mid-Day,272,126,146
2011-11-25,13,Friday,Winter,1,Mid-Day,283,143,140
2011-11-25,14,Friday,Winter,1,Mid-Day,272,122,150
2011-11-25,15,Friday,Winter,1,Mid-Day,310,165,145
2011-11-25,16,Friday,Winter,1,Evening Rush,261,122,139
2011-11-25,17,Friday,Winter,1,Evening Rush,184,57,127
2011-11-25,18,Friday,Winter,1,Evening Rush,153,45,108
2011-11-25,19,Friday,Winter,1,Evening Rush,134,38,96
2011-11-25,20,Friday,Winter,1,Night,95,19,76
2011-11-25,21,Friday,Winter,1,Night,85,24,61
2011-11-25,22,Friday,Winter,1,Night,58,12,46
2011-11-25,23,Friday,Winter,1,Night,33,5,28
2011-11-26,0,Saturday,Winter,1,Early Morning,47,9,38
2011-11-26,1,Saturday,Winter,1,Early Morning,29,5,24
2011-11-26,2,Saturday,Winter,1,Early Morning,23,3,20
2011-11-26,3,Saturday,Winter,1,Early Morning,17,8,9
2011-11-26,4,Saturday,Winter,1,Early Morning,4,0,4
2011-11-26,5,Saturday,Winter,1,Early Morning,3,0,3
2011-11-26,6,Saturday,Winter,2,Morning Rush,10,2,8
2011-11-26,7,Saturday,Winter,1,Morning Rush,17,4,13
2011-11-26,8,Saturday,Winter,1,Morning Rush,60,10,50
2011-11-26,9,Saturday,Winter,1,Morning Rush,83,16,67
2011-11-26,10,Saturday,Winter,1,Mid-Day,141,57,84
2011-11-26,11,Saturday,Winter,1,Mid-Day,230,107,123
2011-11-26,12,Saturday,Winter,1,Mid-Day,309,137,172
2011-11-26,13,Saturday,Winter,1,Mid-Day,325,177,148
2011-11-26,14,Saturday,Winter,2,Mid-Day,299,141,158
2011-11-26,15,Saturday,Winter,2,Mid-Day,314,154,160
2011-11-26,16,Saturday,Winter,2,Evening Rush,275,137,138
2011-11-26,17,Saturday,Winter,2,Evening Rush,184,62,122
2011-11-26,18,Saturday,Winter,2,Evening Rush,185,67,118
2011-11-26,19,Saturday,Winter,2,Evening Rush,146,46,100
2011-11-26,20,Saturday,Winter,2,Night,141,55,86
2011-11-26,21,Saturday,Winter,2,Night,92,20,72
2011-11-26,22,Saturday,Winter,2,Night,65,14,51
2011-11-26,23,Saturday,Winter,1,Night,69,18,51
2011-11-27,0,Sunday,Winter,1,Early Morning,46,7,39
2011-11-27,1,Sunday,Winter,1,Early Morning,44,9,35
2011-11-27,2,Sunday,Winter,1,Early Morning,31,9,22
2011-11-27,3,Sunday,Winter,1,Early Morning,17,9,8
2011-11-27,4,Sunday,Winter,1,Early Morning,4,0,4
2011-11-27,5,Sunday,Winter,1,Early Morning,5,0,5
2011-11-27,6,Sunday,Winter,1,Morning Rush,9,0,9
2011-11-27,7,Sunday,Winter,1,Morning Rush,23,12,11
2011-11-27,8,Sunday,Winter,1,Morning Rush,42,6,36
2011-11-27,9,Sunday,Winter,1,Morning Rush,111,21,90
2011-11-27,10,Sunday,Winter,1,Mid-Day,189,58,131
2011-11-27,11,Sunday,Winter,1,Mid-Day,240,83,157
2011-11-27,12,Sunday,Winter,1,Mid-Day,256,63,193
2011-11-27,13,Sunday,Winter,1,Mid-Day,313,97,216
2011-11-27,14,Sunday,Winter,1,Mid-Day,313,113,200
2011-11-27,15,Sunday,Winter,1,Mid-Day,317,96,221
2011-11-27,16,Sunday,Winter,1,Evening Rush,323,94,229
2011-11-27,17,Sunday,Winter,1,Evening Rush,204,37,167
2011-11-27,18,Sunday,Winter,1,Evening Rush,155,25,130
2011-11-27,19,Sunday,Winter,1,Evening Rush,139,30,109
2011-11-27,20,Sunday,Winter,1,Night,104,10,94
2011-11-27,21,Sunday,Winter,1,Night,88,13,75
2011-11-27,22,Sunday,Winter,1,Night,66,13,53
2011-11-27,23,Sunday,Winter,1,Night,32,5,27
2011-11-28,0,Monday,Winter,1,Early Morning,16,6,10
2011-11-28,1,Monday,Winter,1,Early Morning,13,1,12
2011-11-28,3,Monday,Winter,1,Early Morning,5,1,4
2011-11-28,4,Monday,Winter,1,Early Morning,4,0,4
2011-11-28,5,Monday,Winter,1,Early Morning,34,0,34
2011-11-28,6,Monday,Winter,1,Morning Rush,104,6,98
2011-11-28,7,Monday,Winter,1,Morning Rush,277,7,270
2011-11-28,8,Monday,Winter,2,Morning Rush,407,13,394
2011-11-28,9,Monday,Winter,2,Morning Rush,208,17,191
2011-11-28,10,Monday,Winter,2,Mid-Day,107,21,86
2011-11-28,11,Monday,Winter,2,Mid-Day,118,11,107
2011-11-28,12,Monday,Winter,1,Mid-Day,178,13,165
2011-11-28,13,Monday,Winter,2,Mid-Day,162,25,137
2011-11-28,14,Monday,Winter,1,Mid-Day,143,14,129
2011-11-28,15,Monday,Winter,1,Mid-Day,150,18,132
2011-11-28,16,Monday,Winter,1,Evening Rush,264,24,240
2011-11-28,17,Monday,Winter,1,Evening Rush,468,24,444
2011-11-28,18,Monday,Winter,1,Evening Rush,416,20,396
2011-11-28,19,Monday,Winter,1,Evening Rush,264,4,260
2011-11-28,20,Monday,Winter,2,Night,218,12,206
2011-11-28,21,Monday,Winter,2,Night,156,4,152
2011-11-28,22,Monday,Winter,2,Night,109,7,102
2011-11-28,23,Monday,Winter,2,Night,46,5,41
2011-11-29,0,Tuesday,Winter,1,Early Morning,22,4,18
2011-11-29,1,Tuesday,Winter,1,Early Morning,17,1,16
2011-11-29,2,Tuesday,Winter,2,Early Morning,5,0,5
2011-11-29,3,Tuesday,Winter,2,Early Morning,2,0,2
2011-11-29,4,Tuesday,Winter,2,Early Morning,6,1,5
2011-11-29,5,Tuesday,Winter,1,Early Morning,22,1,21
2011-11-29,6,Tuesday,Winter,1,Morning Rush,89,1,88
2011-11-29,7,Tuesday,Winter,1,Morning Rush,342,12,330
2011-11-29,8,Tuesday,Winter,1,Morning Rush,449,9,440
2011-11-29,9,Tuesday,Winter,3,Morning Rush,202,5,197
2011-11-29,10,Tuesday,Winter,3,Mid-Day,36,2,34
2011-11-29,11,Tuesday,Winter,3,Mid-Day,11,1,10
2011-11-29,12,Tuesday,Winter,3,Mid-Day,18,1,17
2011-11-29,13,Tuesday,Winter,3,Mid-Day,22,0,22
2011-11-29,14,Tuesday,Winter,3,Mid-Day,36,1,35
2011-11-29,15,Tuesday,Winter,3,Mid-Day,65,5,60
2011-11-29,16,Tuesday,Winter,3,Evening Rush,151,5,146
2011-11-29,17,Tuesday,Winter,2,Evening Rush,354,8,346
2011-11-29,18,Tuesday,Winter,2,Evening Rush,358,11,347
2011-11-29,19,Tuesday,Winter,2,Evening Rush,250,6,244
2011-11-29,20,Tuesday,Winter,2,Night,184,8,176
2011-11-29,21,Tuesday,Winter,2,Night,125,9,116
2011-11-29,22,Tuesday,Winter,1,Night,95,5,90
2011-11-29,23,Tuesday,Winter,1,Night,53,0,53
2011-11-30,0,Wednesday,Winter,1,Early Morning,24,1,23
2011-11-30,1,Wednesday,Winter,1,Early Morning,8,0,8
2011-11-30,2,Wednesday,Winter,1,Early Morning,5,0,5
2011-11-30,3,Wednesday,Winter,1,Early Morning,1,0,1
2011-11-30,4,Wednesday,Winter,1,Early Morning,5,0,5
2011-11-30,5,Wednesday,Winter,1,Early Morning,22,1,21
2011-11-30,6,Wednesday,Winter,1,Morning Rush,103,3,100
2011-11-30,7,Wednesday,Winter,1,Morning Rush,285,9,276
2011-11-30,8,Wednesday,Winter,1,Morning Rush,478,13,465
2011-11-30,9,Wednesday,Winter,1,Morning Rush,193,7,186
2011-11-30,10,Wednesday,Winter,1,Mid-Day,110,15,95
2011-11-30,11,Wednesday,Winter,1,Mid-Day,122,10,112
2011-11-30,12,Wednesday,Winter,2,Mid-Day,160,12,148
2011-11-30,13,Wednesday,Winter,2,Mid-Day,147,16,131
2011-11-30,14,Wednesday,Winter,2,Mid-Day,112,13,99
2011-11-30,15,Wednesday,Winter,1,Mid-Day,115,11,104
2011-11-30,16,Wednesday,Winter,1,Evening Rush,226,27,199
2011-11-30,17,Wednesday,Winter,2,Evening Rush,380,15,365
2011-11-30,18,Wednesday,Winter,1,Evening Rush,376,7,369
2011-11-30,19,Wednesday,Winter,2,Evening Rush,279,6,273
2011-11-30,20,Wednesday,Winter,2,Night,190,6,184
2011-11-30,21,Wednesday,Winter,1,Night,135,7,128
2011-11-30,22,Wednesday,Winter,1,Night,87,5,82
2011-11-30,23,Wednesday,Winter,1,Night,50,4,46
2011-12-01,0,Thursday,Winter,1,Early Morning,20,1,19
2011-12-01,1,Thursday,Winter,1,Early Morning,10,1,9
2011-12-01,2,Thursday,Winter,1,Early Morning,9,1,8
2011-12-01,3,Thursday,Winter,1,Early Morning,7,1,6
2011-12-01,4,Thursday,Winter,1,Early Morning,1,0,1
2011-12-01,5,Thursday,Winter,1,Early Morning,24,1,23
2011-12-01,6,Thursday,Winter,1,Morning Rush,97,5,92
2011-12-01,7,Thursday,Winter,1,Morning Rush,276,11,265
2011-12-01,8,Thursday,Winter,1,Morning Rush,477,15,462
2011-12-01,9,Thursday,Winter,1,Morning Rush,224,9,215
2011-12-01,10,Thursday,Winter,1,Mid-Day,93,7,86
2011-12-01,11,Thursday,Winter,1,Mid-Day,102,7,95
2011-12-01,12,Thursday,Winter,1,Mid-Day,148,9,139
2011-12-01,13,Thursday,Winter,1,Mid-Day,154,17,137
2011-12-01,14,Thursday,Winter,1,Mid-Day,150,20,130
2011-12-01,15,Thursday,Winter,1,Mid-Day,154,10,144
2011-12-01,16,Thursday,Winter,1,Evening Rush,201,9,192
2011-12-01,17,Thursday,Winter,1,Evening Rush,418,9,409
2011-12-01,18,Thursday,Winter,1,Evening Rush,405,12,393
2011-12-01,19,Thursday,Winter,1,Evening Rush,228,9,219
2011-12-01,20,Thursday,Winter,1,Night,190,12,178
2011-12-01,21,Thursday,Winter,1,Night,162,8,154
2011-12-01,22,Thursday,Winter,1,Night,104,5,99
2011-12-01,23,Thursday,Winter,1,Night,73,3,70
2011-12-02,0,Friday,Winter,1,Early Morning,38,6,32
2011-12-02,1,Friday,Winter,1,Early Morning,15,1,14
2011-12-02,2,Friday,Winter,1,Early Morning,10,0,10
2011-12-02,3,Friday,Winter,1,Early Morning,1,0,1
2011-12-02,4,Friday,Winter,1,Early Morning,3,0,3
2011-12-02,5,Friday,Winter,1,Early Morning,23,0,23
2011-12-02,6,Friday,Winter,1,Morning Rush,87,3,84
2011-12-02,7,Friday,Winter,1,Morning Rush,205,6,199
2011-12-02,8,Friday,Winter,1,Morning Rush,445,13,432
2011-12-02,9,Friday,Winter,1,Morning Rush,246,12,234
2011-12-02,10,Friday,Winter,1,Mid-Day,105,16,89
2011-12-02,11,Friday,Winter,1,Mid-Day,160,18,142
2011-12-02,12,Friday,Winter,1,Mid-Day,204,18,186
2011-12-02,13,Friday,Winter,1,Mid-Day,207,19,188
2011-12-02,14,Friday,Winter,1,Mid-Day,170,25,145
2011-12-02,15,Friday,Winter,1,Mid-Day,199,24,175
2011-12-02,16,Friday,Winter,1,Evening Rush,276,22,254
2011-12-02,17,Friday,Winter,1,Evening Rush,411,20,391
2011-12-02,18,Friday,Winter,1,Evening Rush,372,10,362
2011-12-02,19,Friday,Winter,1,Evening Rush,265,13,252
2011-12-02,20,Friday,Winter,1,Night,190,12,178
2011-12-02,21,Friday,Winter,1,Night,111,9,102
2011-12-02,22,Friday,Winter,1,Night,102,7,95
2011-12-02,23,Friday,Winter,1,Night,95,14,81
2011-12-03,0,Saturday,Winter,1,Early Morning,75,10,65
2011-12-03,1,Saturday,Winter,1,Early Morning,71,9,62
2011-12-03,2,Saturday,Winter,1,Early Morning,50,9,41
2011-12-03,3,Saturday,Winter,1,Early Morning,9,4,5
2011-12-03,4,Saturday,Winter,1,Early Morning,8,1,7
2011-12-03,5,Saturday,Winter,1,Early Morning,6,0,6
2011-12-03,6,Saturday,Winter,1,Morning Rush,11,1,10
2011-12-03,7,Saturday,Winter,1,Morning Rush,26,2,24
2011-12-03,8,Saturday,Winter,1,Morning Rush,63,1,62
2011-12-03,9,Saturday,Winter,1,Morning Rush,124,25,99
2011-12-03,10,Saturday,Winter,1,Mid-Day,195,22,173
2011-12-03,11,Saturday,Winter,1,Mid-Day,275,48,227
2011-12-03,12,Saturday,Winter,1,Mid-Day,358,78,280
2011-12-03,13,Saturday,Winter,1,Mid-Day,292,70,222
2011-12-03,14,Saturday,Winter,1,Mid-Day,343,92,251
2011-12-03,15,Saturday,Winter,1,Mid-Day,337,100,237
2011-12-03,16,Saturday,Winter,1,Evening Rush,305,75,230
2011-12-03,17,Saturday,Winter,1,Evening Rush,232,46,186
2011-12-03,18,Saturday,Winter,1,Evening Rush,224,31,193
2011-12-03,19,Saturday,Winter,1,Evening Rush,175,31,144
2011-12-03,20,Saturday,Winter,1,Night,127,17,110
2011-12-03,21,Saturday,Winter,2,Night,109,5,104
2011-12-03,22,Saturday,Winter,2,Night,114,17,97
2011-12-03,23,Saturday,Winter,1,Night,85,12,73
2011-12-04,0,Sunday,Winter,1,Early Morning,83,19,64
2011-12-04,1,Sunday,Winter,1,Early Morning,74,20,54
2011-12-04,2,Sunday,Winter,1,Early Morning,62,11,51
2011-12-04,3,Sunday,Winter,1,Early Morning,41,7,34
2011-12-04,4,Sunday,Winter,1,Early Morning,11,2,9
2011-12-04,5,Sunday,Winter,1,Early Morning,4,2,2
2011-12-04,6,Sunday,Winter,1,Morning Rush,4,1,3
2011-12-04,7,Sunday,Winter,1,Morning Rush,26,3,23
2011-12-04,8,Sunday,Winter,1,Morning Rush,55,7,48
2011-12-04,9,Sunday,Winter,1,Morning Rush,126,12,114
2011-12-04,10,Sunday,Winter,1,Mid-Day,216,36,180
2011-12-04,11,Sunday,Winter,1,Mid-Day,254,48,206
2011-12-04,12,Sunday,Winter,1,Mid-Day,329,82,247
2011-12-04,13,Sunday,Winter,1,Mid-Day,357,88,269
2011-12-04,14,Sunday,Winter,1,Mid-Day,323,77,246
2011-12-04,15,Sunday,Winter,1,Mid-Day,296,69,227
2011-12-04,16,Sunday,Winter,1,Evening Rush,330,64,266
2011-12-04,17,Sunday,Winter,1,Evening Rush,245,38,207
2011-12-04,18,Sunday,Winter,1,Evening Rush,171,10,161
2011-12-04,19,Sunday,Winter,1,Evening Rush,173,15,158
2011-12-04,20,Sunday,Winter,1,Night,124,8,116
2011-12-04,21,Sunday,Winter,1,Night,72,7,65
2011-12-04,22,Sunday,Winter,1,Night,64,5,59
2011-12-04,23,Sunday,Winter,1,Night,45,3,42
2011-12-05,0,Monday,Winter,1,Early Morning,24,3,21
2011-12-05,1,Monday,Winter,1,Early Morning,12,2,10
2011-12-05,2,Monday,Winter,1,Early Morning,8,0,8
2011-12-05,3,Monday,Winter,1,Early Morning,2,0,2
2011-12-05,4,Monday,Winter,1,Early Morning,7,0,7
2011-12-05,5,Monday,Winter,1,Early Morning,25,1,24
2011-12-05,6,Monday,Winter,1,Morning Rush,90,1,89
2011-12-05,7,Monday,Winter,1,Morning Rush,283,9,274
2011-12-05,8,Monday,Winter,1,Morning Rush,404,12,392
2011-12-05,9,Monday,Winter,2,Morning Rush,190,12,178
2011-12-05,10,Monday,Winter,2,Mid-Day,87,9,78
2011-12-05,11,Monday,Winter,2,Mid-Day,123,17,106
2011-12-05,12,Monday,Winter,2,Mid-Day,154,29,125
2011-12-05,13,Monday,Winter,2,Mid-Day,171,18,153
2011-12-05,14,Monday,Winter,2,Mid-Day,133,7,126
2011-12-05,15,Monday,Winter,2,Mid-Day,148,16,132
2011-12-05,16,Monday,Winter,1,Evening Rush,248,10,238
2011-12-05,17,Monday,Winter,1,Evening Rush,446,16,430
2011-12-05,18,Monday,Winter,1,Evening Rush,399,13,386
2011-12-05,19,Monday,Winter,2,Evening Rush,308,13,295
2011-12-05,20,Monday,Winter,2,Night,205,15,190
2011-12-05,21,Monday,Winter,2,Night,176,10,166
2011-12-05,22,Monday,Winter,2,Night,106,12,94
2011-12-05,23,Monday,Winter,2,Night,62,8,54
2011-12-06,0,Tuesday,Winter,2,Early Morning,28,3,25
2011-12-06,1,Tuesday,Winter,2,Early Morning,16,2,14
2011-12-06,2,Tuesday,Winter,2,Early Morning,3,0,3
2011-12-06,3,Tuesday,Winter,2,Early Morning,3,0,3
2011-12-06,4,Tuesday,Winter,3,Early Morning,7,0,7
2011-12-06,5,Tuesday,Winter,3,Early Morning,20,0,20
2011-12-06,6,Tuesday,Winter,2,Morning Rush,86,5,81
2011-12-06,7,Tuesday,Winter,2,Morning Rush,234,7,227
2011-12-06,8,Tuesday,Winter,2,Morning Rush,414,13,401
2011-12-06,9,Tuesday,Winter,2,Morning Rush,204,4,200
2011-12-06,10,Tuesday,Winter,3,Mid-Day,50,6,44
2011-12-06,11,Tuesday,Winter,3,Mid-Day,32,4,28
2011-12-06,12,Tuesday,Winter,3,Mid-Day,55,5,50
2011-12-06,13,Tuesday,Winter,3,Mid-Day,71,6,65
2011-12-06,14,Tuesday,Winter,3,Mid-Day,75,6,69
2011-12-06,15,Tuesday,Winter,3,Mid-Day,45,2,43
2011-12-06,16,Tuesday,Winter,3,Evening Rush,88,4,84
2011-12-06,17,Tuesday,Winter,2,Evening Rush,262,13,249
2011-12-06,18,Tuesday,Winter,2,Evening Rush,304,17,287
2011-12-06,19,Tuesday,Winter,3,Evening Rush,233,10,223
2011-12-06,20,Tuesday,Winter,3,Night,110,3,107
2011-12-06,21,Tuesday,Winter,2,Night,114,6,108
2011-12-06,22,Tuesday,Winter,3,Night,87,5,82
2011-12-06,23,Tuesday,Winter,3,Night,53,5,48
2011-12-07,0,Wednesday,Winter,1,Early Morning,33,3,30
2011-12-07,1,Wednesday,Winter,2,Early Morning,13,4,9
2011-12-07,2,Wednesday,Winter,3,Early Morning,6,2,4
2011-12-07,3,Wednesday,Winter,3,Early Morning,3,0,3
2011-12-07,4,Wednesday,Winter,3,Early Morning,1,0,1
2011-12-07,5,Wednesday,Winter,3,Early Morning,3,0,3
2011-12-07,6,Wednesday,Winter,3,Morning Rush,18,0,18
2011-12-07,7,Wednesday,Winter,3,Morning Rush,46,3,43
2011-12-07,8,Wednesday,Winter,3,Morning Rush,86,6,80
2011-12-07,9,Wednesday,Winter,3,Morning Rush,64,0,64
2011-12-07,10,Wednesday,Winter,3,Mid-Day,33,1,32
2011-12-07,11,Wednesday,Winter,3,Mid-Day,50,3,47
2011-12-07,12,Wednesday,Winter,3,Mid-Day,33,4,29
2011-12-07,13,Wednesday,Winter,3,Mid-Day,33,5,28
2011-12-07,14,Wednesday,Winter,3,Mid-Day,25,1,24
2011-12-07,15,Wednesday,Winter,3,Mid-Day,30,5,25
2011-12-07,16,Wednesday,Winter,3,Evening Rush,31,3,28
2011-12-07,17,Wednesday,Winter,3,Evening Rush,52,4,48
2011-12-07,18,Wednesday,Winter,3,Evening Rush,51,3,48
2011-12-07,19,Wednesday,Winter,3,Evening Rush,33,2,31
2011-12-07,20,Wednesday,Winter,3,Night,26,1,25
2011-12-07,21,Wednesday,Winter,3,Night,6,0,6
2011-12-07,22,Wednesday,Winter,3,Night,13,0,13
2011-12-07,23,Wednesday,Winter,1,Night,16,0,16
2011-12-08,0,Thursday,Winter,2,Early Morning,21,0,21
2011-12-08,1,Thursday,Winter,1,Early Morning,7,1,6
2011-12-08,2,Thursday,Winter,1,Early Morning,4,0,4
2011-12-08,3,Thursday,Winter,1,Early Morning,1,0,1
2011-12-08,4,Thursday,Winter,2,Early Morning,2,0,2
2011-12-08,5,Thursday,Winter,1,Early Morning,12,0,12
2011-12-08,6,Thursday,Winter,1,Morning Rush,71,0,71
2011-12-08,7,Thursday,Winter,1,Morning Rush,244,11,233
2011-12-08,8,Thursday,Winter,1,Morning Rush,429,11,418
2011-12-08,9,Thursday,Winter,1,Morning Rush,225,7,218
2011-12-08,10,Thursday,Winter,1,Mid-Day,110,1,109
2011-12-08,11,Thursday,Winter,1,Mid-Day,106,6,100
2011-12-08,12,Thursday,Winter,1,Mid-Day,156,8,148
2011-12-08,13,Thursday,Winter,1,Mid-Day,124,9,115
2011-12-08,14,Thursday,Winter,1,Mid-Day,137,16,121
2011-12-08,15,Thursday,Winter,1,Mid-Day,117,19,98
2011-12-08,16,Thursday,Winter,1,Evening Rush,208,7,201
2011-12-08,17,Thursday,Winter,1,Evening Rush,331,10,321
2011-12-08,18,Thursday,Winter,1,Evening Rush,318,12,306
2011-12-08,19,Thursday,Winter,1,Evening Rush,232,12,220
2011-12-08,20,Thursday,Winter,1,Night,175,5,170
2011-12-08,21,Thursday,Winter,1,Night,139,4,135
2011-12-08,22,Thursday,Winter,1,Night,92,8,84
2011-12-08,23,Thursday,Winter,1,Night,61,3,58
2011-12-09,0,Friday,Winter,1,Early Morning,34,8,26
2011-12-09,1,Friday,Winter,1,Early Morning,14,2,12
2011-12-09,2,Friday,Winter,1,Early Morning,12,2,10
2011-12-09,3,Friday,Winter,1,Early Morning,6,1,5
2011-12-09,4,Friday,Winter,1,Early Morning,2,1,1
2011-12-09,5,Friday,Winter,1,Early Morning,20,0,20
2011-12-09,6,Friday,Winter,1,Morning Rush,63,1,62
2011-12-09,7,Friday,Winter,1,Morning Rush,199,4,195
2011-12-09,8,Friday,Winter,1,Morning Rush,385,7,378
2011-12-09,9,Friday,Winter,1,Morning Rush,264,8,256
2011-12-09,10,Friday,Winter,2,Mid-Day,126,11,115
2011-12-09,11,Friday,Winter,1,Mid-Day,136,15,121
2011-12-09,12,Friday,Winter,1,Mid-Day,173,27,146
2011-12-09,13,Friday,Winter,1,Mid-Day,168,27,141
2011-12-09,14,Friday,Winter,1,Mid-Day,187,24,163
2011-12-09,15,Friday,Winter,1,Mid-Day,189,29,160
2011-12-09,16,Friday,Winter,1,Evening Rush,250,24,226
2011-12-09,17,Friday,Winter,1,Evening Rush,362,10,352
2011-12-09,18,Friday,Winter,1,Evening Rush,318,10,308
2011-12-09,19,Friday,Winter,1,Evening Rush,199,10,189
2011-12-09,20,Friday,Winter,1,Night,150,10,140
2011-12-09,21,Friday,Winter,1,Night,140,9,131
2011-12-09,22,Friday,Winter,1,Night,129,15,114
2011-12-09,23,Friday,Winter,1,Night,94,6,88
2011-12-10,0,Saturday,Winter,2,Early Morning,77,11,66
2011-12-10,1,Saturday,Winter,2,Early Morning,66,11,55
2011-12-10,2,Saturday,Winter,2,Early Morning,60,12,48
2011-12-10,3,Saturday,Winter,2,Early Morning,25,5,20
2011-12-10,4,Saturday,Winter,2,Early Morning,3,0,3
2011-12-10,5,Saturday,Winter,1,Early Morning,6,0,6
2011-12-10,6,Saturday,Winter,1,Morning Rush,11,1,10
2011-12-10,7,Saturday,Winter,1,Morning Rush,11,0,11
2011-12-10,8,Saturday,Winter,1,Morning Rush,73,5,68
2011-12-10,9,Saturday,Winter,1,Morning Rush,149,15,134
2011-12-10,10,Saturday,Winter,1,Mid-Day,192,31,161
2011-12-10,11,Saturday,Winter,1,Mid-Day,236,44,192
2011-12-10,12,Saturday,Winter,1,Mid-Day,283,48,235
2011-12-10,13,Saturday,Winter,1,Mid-Day,286,47,239
2011-12-10,14,Saturday,Winter,1,Mid-Day,293,51,242
2011-12-10,15,Saturday,Winter,1,Mid-Day,299,60,239
2011-12-10,16,Saturday,Winter,1,Evening Rush,241,58,183
2011-12-10,17,Saturday,Winter,1,Evening Rush,185,34,151
2011-12-10,18,Saturday,Winter,1,Evening Rush,172,28,144
2011-12-10,19,Saturday,Winter,1,Evening Rush,154,15,139
2011-12-10,20,Saturday,Winter,1,Night,124,10,114
2011-12-10,21,Saturday,Winter,1,Night,83,4,79
2011-12-10,22,Saturday,Winter,1,Night,95,7,88
2011-12-10,23,Saturday,Winter,1,Night,66,5,61
2011-12-11,0,Sunday,Winter,1,Early Morning,74,5,69
2011-12-11,1,Sunday,Winter,1,Early Morning,62,8,54
2011-12-11,2,Sunday,Winter,1,Early Morning,52,5,47
2011-12-11,3,Sunday,Winter,1,Early Morning,19,2,17
2011-12-11,4,Sunday,Winter,1,Early Morning,5,0,5
2011-12-11,5,Sunday,Winter,1,Early Morning,6,0,6
2011-12-11,6,Sunday,Winter,1,Morning Rush,10,0,10
2011-12-11,7,Sunday,Winter,1,Morning Rush,31,1,30
2011-12-11,8,Sunday,Winter,1,Morning Rush,72,4,68
2011-12-11,9,Sunday,Winter,1,Morning Rush,107,19,88
2011-12-11,10,Sunday,Winter,1,Mid-Day,194,30,164
2011-12-11,11,Sunday,Winter,1,Mid-Day,197,31,166
2011-12-11,12,Sunday,Winter,1,Mid-Day,288,42,246
2011-12-11,13,Sunday,Winter,1,Mid-Day,268,44,224
2011-12-11,14,Sunday,Winter,1,Mid-Day,242,44,198
2011-12-11,15,Sunday,Winter,1,Mid-Day,266,47,219
2011-12-11,16,Sunday,Winter,1,Evening Rush,206,32,174
2011-12-11,17,Sunday,Winter,1,Evening Rush,163,13,150
2011-12-11,18,Sunday,Winter,1,Evening Rush,163,12,151
2011-12-11,19,Sunday,Winter,1,Evening Rush,105,7,98
2011-12-11,20,Sunday,Winter,1,Night,72,10,62
2011-12-11,21,Sunday,Winter,1,Night,63,10,53
2011-12-11,22,Sunday,Winter,1,Night,43,7,36
2011-12-11,23,Sunday,Winter,1,Night,35,4,31
2011-12-12,0,Monday,Winter,1,Early Morning,20,4,16
2011-12-12,1,Monday,Winter,1,Early Morning,9,0,9
2011-12-12,2,Monday,Winter,1,Early Morning,4,0,4
2011-12-12,3,Monday,Winter,1,Early Morning,2,0,2
2011-12-12,4,Monday,Winter,1,Early Morning,3,0,3
2011-12-12,5,Monday,Winter,1,Early Morning,21,0,21
2011-12-12,6,Monday,Winter,1,Morning Rush,64,1,63
2011-12-12,7,Monday,Winter,1,Morning Rush,235,4,231
2011-12-12,8,Monday,Winter,2,Morning Rush,385,7,378
2011-12-12,9,Monday,Winter,2,Morning Rush,220,12,208
2011-12-12,10,Monday,Winter,2,Mid-Day,105,14,91
2011-12-12,11,Monday,Winter,2,Mid-Day,115,15,100
2011-12-12,12,Monday,Winter,1,Mid-Day,145,7,138
2011-12-12,13,Monday,Winter,2,Mid-Day,166,13,153
2011-12-12,14,Monday,Winter,2,Mid-Day,111,16,95
2011-12-12,15,Monday,Winter,2,Mid-Day,132,8,124
2011-12-12,16,Monday,Winter,2,Evening Rush,214,5,209
2011-12-12,17,Monday,Winter,2,Evening Rush,359,7,352
2011-12-12,18,Monday,Winter,1,Evening Rush,357,8,349
2011-12-12,19,Monday,Winter,1,Evening Rush,241,9,232
2011-12-12,20,Monday,Winter,1,Night,165,8,157
2011-12-12,21,Monday,Winter,1,Night,121,2,119
2011-12-12,22,Monday,Winter,1,Night,71,0,71
2011-12-12,23,Monday,Winter,1,Night,45,3,42
2011-12-13,0,Tuesday,Winter,1,Early Morning,17,1,16
2011-12-13,1,Tuesday,Winter,1,Early Morning,4,0,4
2011-12-13,2,Tuesday,Winter,1,Early Morning,2,1,1
2011-12-13,3,Tuesday,Winter,1,Early Morning,3,0,3
2011-12-13,4,Tuesday,Winter,1,Early Morning,4,0,4
2011-12-13,5,Tuesday,Winter,1,Early Morning,20,0,20
2011-12-13,6,Tuesday,Winter,1,Morning Rush,92,0,92
2011-12-13,7,Tuesday,Winter,1,Morning Rush,223,2,221
2011-12-13,8,Tuesday,Winter,1,Morning Rush,400,9,391
2011-12-13,9,Tuesday,Winter,1,Morning Rush,233,10,223
2011-12-13,10,Tuesday,Winter,1,Mid-Day,102,3,99
2011-12-13,11,Tuesday,Winter,1,Mid-Day,124,9,115
2011-12-13,12,Tuesday,Winter,1,Mid-Day,167,20,147
2011-12-13,13,Tuesday,Winter,1,Mid-Day,127,7,120
2011-12-13,14,Tuesday,Winter,1,Mid-Day,134,18,116
2011-12-13,15,Tuesday,Winter,1,Mid-Day,151,7,144
2011-12-13,16,Tuesday,Winter,1,Evening Rush,207,13,194
2011-12-13,17,Tuesday,Winter,1,Evening Rush,398,17,381
2011-12-13,18,Tuesday,Winter,1,Evening Rush,382,12,370
2011-12-13,19,Tuesday,Winter,1,Evening Rush,267,5,262
2011-12-13,20,Tuesday,Winter,1,Night,161,7,154
2011-12-13,21,Tuesday,Winter,1,Night,139,5,134
2011-12-13,22,Tuesday,Winter,1,Night,107,5,102
2011-12-13,23,Tuesday,Winter,1,Night,59,4,55
2011-12-14,0,Wednesday,Winter,1,Early Morning,22,0,22
2011-12-14,1,Wednesday,Winter,1,Early Morning,8,0,8
2011-12-14,2,Wednesday,Winter,1,Early Morning,2,0,2
2011-12-14,3,Wednesday,Winter,1,Early Morning,3,0,3
2011-12-14,4,Wednesday,Winter,1,Early Morning,4,0,4
2011-12-14,5,Wednesday,Winter,2,Early Morning,26,0,26
2011-12-14,6,Wednesday,Winter,2,Morning Rush,87,0,87
2011-12-14,7,Wednesday,Winter,1,Morning Rush,247,4,243
2011-12-14,8,Wednesday,Winter,2,Morning Rush,467,9,458
2011-12-14,9,Wednesday,Winter,2,Morning Rush,239,9,230
2011-12-14,10,Wednesday,Winter,2,Mid-Day,142,9,133
2011-12-14,11,Wednesday,Winter,2,Mid-Day,115,12,103
2011-12-14,12,Wednesday,Winter,2,Mid-Day,144,6,138
2011-12-14,13,Wednesday,Winter,2,Mid-Day,133,14,119
2011-12-14,14,Wednesday,Winter,2,Mid-Day,151,17,134
2011-12-14,15,Wednesday,Winter,2,Mid-Day,167,24,143
2011-12-14,16,Wednesday,Winter,2,Evening Rush,245,12,233
2011-12-14,17,Wednesday,Winter,2,Evening Rush,396,19,377
2011-12-14,18,Wednesday,Winter,2,Evening Rush,390,11,379
2011-12-14,19,Wednesday,Winter,2,Evening Rush,268,9,259
2011-12-14,20,Wednesday,Winter,2,Night,175,6,169
2011-12-14,21,Wednesday,Winter,2,Night,154,9,145
2011-12-14,22,Wednesday,Winter,1,Night,104,5,99
2011-12-14,23,Wednesday,Winter,1,Night,51,3,48
2011-12-15,0,Thursday,Winter,1,Early Morning,50,5,45
2011-12-15,1,Thursday,Winter,2,Early Morning,20,5,15
2011-12-15,2,Thursday,Winter,2,Early Morning,7,2,5
2011-12-15,3,Thursday,Winter,2,Early Morning,3,1,2
2011-12-15,4,Thursday,Winter,2,Early Morning,6,0,6
2011-12-15,5,Thursday,Winter,2,Early Morning,24,0,24
2011-12-15,6,Thursday,Winter,1,Morning Rush,92,2,90
2011-12-15,7,Thursday,Winter,1,Morning Rush,258,6,252
2011-12-15,8,Thursday,Winter,2,Morning Rush,457,8,449
2011-12-15,9,Thursday,Winter,2,Morning Rush,280,6,274
2011-12-15,10,Thursday,Winter,2,Mid-Day,109,4,105
2011-12-15,11,Thursday,Winter,2,Mid-Day,135,9,126
2011-12-15,12,Thursday,Winter,2,Mid-Day,157,17,140
2011-12-15,13,Thursday,Winter,2,Mid-Day,164,14,150
2011-12-15,14,Thursday,Winter,2,Mid-Day,132,8,124
2011-12-15,15,Thursday,Winter,3,Mid-Day,82,6,76
2011-12-15,16,Thursday,Winter,3,Evening Rush,131,7,124
2011-12-15,17,Thursday,Winter,2,Evening Rush,324,14,310
2011-12-15,18,Thursday,Winter,2,Evening Rush,377,14,363
2011-12-15,19,Thursday,Winter,2,Evening Rush,287,13,274
2011-12-15,20,Thursday,Winter,1,Night,221,12,209
2011-12-15,21,Thursday,Winter,1,Night,155,10,145
2011-12-15,22,Thursday,Winter,1,Night,124,8,116
2011-12-15,23,Thursday,Winter,1,Night,114,10,104
2011-12-16,0,Friday,Winter,1,Early Morning,72,12,60
2011-12-16,1,Friday,Winter,1,Early Morning,31,3,28
2011-12-16,2,Friday,Winter,1,Early Morning,23,0,23
2011-12-16,3,Friday,Winter,1,Early Morning,5,2,3
2011-12-16,4,Friday,Winter,2,Early Morning,5,1,4
2011-12-16,5,Friday,Winter,1,Early Morning,26,0,26
2011-12-16,6,Friday,Winter,2,Morning Rush,82,2,80
2011-12-16,7,Friday,Winter,2,Morning Rush,231,5,226
2011-12-16,8,Friday,Winter,1,Morning Rush,459,10,449
2011-12-16,9,Friday,Winter,1,Morning Rush,243,8,235
2011-12-16,10,Friday,Winter,1,Mid-Day,132,10,122
2011-12-16,11,Friday,Winter,2,Mid-Day,144,9,135
2011-12-16,12,Friday,Winter,2,Mid-Day,173,10,163
2011-12-16,13,Friday,Winter,2,Mid-Day,137,12,125
2011-12-16,14,Friday,Winter,2,Mid-Day,128,13,115
2011-12-16,15,Friday,Winter,2,Mid-Day,153,12,141
2011-12-16,16,Friday,Winter,2,Evening Rush,224,12,212
2011-12-16,17,Friday,Winter,2,Evening Rush,365,13,352
2011-12-16,18,Friday,Winter,2,Evening Rush,295,10,285
2011-12-16,19,Friday,Winter,2,Evening Rush,214,11,203
2011-12-16,20,Friday,Winter,2,Night,152,6,146
2011-12-16,21,Friday,Winter,2,Night,102,7,95
2011-12-16,22,Friday,Winter,2,Night,106,6,100
2011-12-16,23,Friday,Winter,2,Night,75,4,71
2011-12-17,0,Saturday,Winter,1,Early Morning,62,3,59
2011-12-17,1,Saturday,Winter,2,Early Morning,43,4,39
2011-12-17,2,Saturday,Winter,2,Early Morning,58,11,47
2011-12-17,3,Saturday,Winter,1,Early Morning,26,4,22
2011-12-17,4,Saturday,Winter,1,Early Morning,9,0,9
2011-12-17,5,Saturday,Winter,2,Early Morning,9,2,7
2011-12-17,6,Saturday,Winter,2,Morning Rush,17,0,17
2011-12-17,7,Saturday,Winter,2,Morning Rush,20,0,20
2011-12-17,8,Saturday,Winter,2,Morning Rush,59,4,55
2011-12-17,9,Saturday,Winter,2,Morning Rush,100,5,95
2011-12-17,10,Saturday,Winter,2,Mid-Day,181,10,171
2011-12-17,11,Saturday,Winter,2,Mid-Day,209,21,188
2011-12-17,12,Saturday,Winter,2,Mid-Day,244,28,216
2011-12-17,13,Saturday,Winter,2,Mid-Day,236,32,204
2011-12-17,14,Saturday,Winter,1,Mid-Day,237,30,207
2011-12-17,15,Saturday,Winter,1,Mid-Day,228,33,195
2011-12-17,16,Saturday,Winter,1,Evening Rush,222,30,192
2011-12-17,17,Saturday,Winter,1,Evening Rush,165,12,153
2011-12-17,18,Saturday,Winter,1,Evening Rush,157,7,150
2011-12-17,19,Saturday,Winter,3,Evening Rush,106,11,95
2011-12-17,20,Saturday,Winter,1,Night,106,7,99
2011-12-17,21,Saturday,Winter,1,Night,96,8,88
2011-12-17,22,Saturday,Winter,1,Night,80,7,73
2011-12-17,23,Saturday,Winter,1,Night,69,6,63
2011-12-18,0,Sunday,Winter,1,Early Morning,71,7,64
2011-12-18,1,Sunday,Winter,1,Early Morning,46,3,43
2011-12-18,2,Sunday,Winter,1,Early Morning,41,2,39
2011-12-18,3,Sunday,Winter,1,Early Morning,18,2,16
2011-12-18,4,Sunday,Winter,1,Early Morning,1,0,1
2011-12-18,5,Sunday,Winter,1,Early Morning,5,1,4
2011-12-18,6,Sunday,Winter,1,Morning Rush,3,0,3
2011-12-18,7,Sunday,Winter,1,Morning Rush,12,1,11
2011-12-18,8,Sunday,Winter,1,Morning Rush,32,1,31
2011-12-18,9,Sunday,Winter,1,Morning Rush,81,6,75
2011-12-18,10,Sunday,Winter,1,Mid-Day,129,7,122
2011-12-18,11,Sunday,Winter,2,Mid-Day,188,20,168
2011-12-18,12,Sunday,Winter,1,Mid-Day,228,26,202
2011-12-18,13,Sunday,Winter,1,Mid-Day,228,18,210
2011-12-18,14,Sunday,Winter,1,Mid-Day,219,19,200
2011-12-18,15,Sunday,Winter,1,Mid-Day,207,23,184
2011-12-18,16,Sunday,Winter,1,Evening Rush,234,27,207
2011-12-18,17,Sunday,Winter,1,Evening Rush,136,10,126
2011-12-18,18,Sunday,Winter,1,Evening Rush,138,15,123
2011-12-18,19,Sunday,Winter,1,Evening Rush,135,5,130
2011-12-18,20,Sunday,Winter,1,Night,104,10,94
2011-12-18,21,Sunday,Winter,1,Night,89,9,80
2011-12-18,22,Sunday,Winter,1,Night,49,2,47
2011-12-18,23,Sunday,Winter,1,Night,37,6,31
2011-12-19,0,Monday,Winter,1,Early Morning,17,3,14
2011-12-19,1,Monday,Winter,1,Early Morning,11,3,8
2011-12-19,2,Monday,Winter,1,Early Morning,3,0,3
2011-12-19,3,Monday,Winter,1,Early Morning,3,0,3
2011-12-19,4,Monday,Winter,1,Early Morning,4,0,4
2011-12-19,5,Monday,Winter,1,Early Morning,21,0,21
2011-12-19,6,Monday,Winter,1,Morning Rush,68,0,68
2011-12-19,7,Monday,Winter,1,Morning Rush,191,4,187
2011-12-19,8,Monday,Winter,1,Morning Rush,397,8,389
2011-12-19,9,Monday,Winter,1,Morning Rush,183,17,166
2011-12-19,10,Monday,Winter,1,Mid-Day,108,12,96
2011-12-19,11,Monday,Winter,1,Mid-Day,127,22,105
2011-12-19,12,Monday,Winter,1,Mid-Day,141,13,128
2011-12-19,13,Monday,Winter,1,Mid-Day,142,15,127
2011-12-19,14,Monday,Winter,1,Mid-Day,137,30,107
2011-12-19,15,Monday,Winter,1,Mid-Day,159,24,135
2011-12-19,16,Monday,Winter,1,Evening Rush,208,19,189
2011-12-19,17,Monday,Winter,1,Evening Rush,378,16,362
2011-12-19,18,Monday,Winter,1,Evening Rush,354,11,343
2011-12-19,19,Monday,Winter,2,Evening Rush,251,17,234
2011-12-19,20,Monday,Winter,1,Night,206,9,197
2011-12-19,21,Monday,Winter,2,Night,127,15,112
2011-12-19,22,Monday,Winter,2,Night,107,12,95
2011-12-19,23,Monday,Winter,1,Night,60,10,50
2011-12-20,0,Tuesday,Winter,1,Early Morning,21,0,21
2011-12-20,1,Tuesday,Winter,1,Early Morning,6,0,6
2011-12-20,2,Tuesday,Winter,2,Early Morning,11,1,10
2011-12-20,3,Tuesday,Winter,2,Early Morning,2,1,1
2011-12-20,4,Tuesday,Winter,2,Early Morning,4,0,4
2011-12-20,5,Tuesday,Winter,2,Early Morning,15,0,15
2011-12-20,6,Tuesday,Winter,2,Morning Rush,72,1,71
2011-12-20,7,Tuesday,Winter,2,Morning Rush,268,7,261
2011-12-20,8,Tuesday,Winter,2,Morning Rush,432,10,422
2011-12-20,9,Tuesday,Winter,2,Morning Rush,259,14,245
2011-12-20,10,Tuesday,Winter,2,Mid-Day,129,20,109
2011-12-20,11,Tuesday,Winter,2,Mid-Day,129,13,116
2011-12-20,12,Tuesday,Winter,2,Mid-Day,175,16,159
2011-12-20,13,Tuesday,Winter,2,Mid-Day,181,18,163
2011-12-20,14,Tuesday,Winter,2,Mid-Day,138,11,127
2011-12-20,15,Tuesday,Winter,2,Mid-Day,154,15,139
2011-12-20,16,Tuesday,Winter,1,Evening Rush,238,20,218
2011-12-20,17,Tuesday,Winter,1,Evening Rush,431,14,417
2011-12-20,18,Tuesday,Winter,1,Evening Rush,411,26,385
2011-12-20,19,Tuesday,Winter,1,Evening Rush,224,6,218
2011-12-20,20,Tuesday,Winter,1,Night,147,3,144
2011-12-20,21,Tuesday,Winter,1,Night,143,4,139
2011-12-20,22,Tuesday,Winter,2,Night,107,3,104
2011-12-20,23,Tuesday,Winter,2,Night,53,13,40
2011-12-21,0,Wednesday,Spring,2,Early Morning,25,7,18
2011-12-21,1,Wednesday,Spring,2,Early Morning,11,1,10
2011-12-21,2,Wednesday,Spring,2,Early Morning,4,0,4
2011-12-21,3,Wednesday,Spring,2,Early Morning,2,0,2
2011-12-21,4,Wednesday,Spring,2,Early Morning,2,0,2
2011-12-21,5,Wednesday,Spring,2,Early Morning,28,0,28
2011-12-21,6,Wednesday,Spring,2,Morning Rush,76,1,75
2011-12-21,7,Wednesday,Spring,2,Morning Rush,229,5,224
2011-12-21,8,Wednesday,Spring,3,Morning Rush,405,12,393
2011-12-21,9,Wednesday,Spring,2,Morning Rush,234,14,220
2011-12-21,10,Wednesday,Spring,2,Mid-Day,89,6,83
2011-12-21,11,Wednesday,Spring,2,Mid-Day,56,3,53
2011-12-21,12,Wednesday,Spring,3,Mid-Day,61,3,58
2011-12-21,13,Wednesday,Spring,3,Mid-Day,58,3,55
2011-12-21,14,Wednesday,Spring,2,Mid-Day,51,11,40
2011-12-21,15,Wednesday,Spring,2,Mid-Day,61,4,57
2011-12-21,16,Wednesday,Spring,3,Evening Rush,101,6,95
2011-12-21,17,Wednesday,Spring,3,Evening Rush,229,3,226
2011-12-21,18,Wednesday,Spring,2,Evening Rush,280,2,278
2011-12-21,19,Wednesday,Spring,2,Evening Rush,209,9,200
2011-12-21,20,Wednesday,Spring,2,Night,167,5,162
2011-12-21,21,Wednesday,Spring,1,Night,123,9,114
2011-12-21,22,Wednesday,Spring,1,Night,105,3,102
2011-12-21,23,Wednesday,Spring,1,Night,54,0,54
2011-12-22,0,Thursday,Spring,2,Early Morning,27,3,24
2011-12-22,1,Thursday,Spring,1,Early Morning,15,0,15
2011-12-22,2,Thursday,Spring,1,Early Morning,11,1,10
2011-12-22,3,Thursday,Spring,1,Early Morning,6,0,6
2011-12-22,4,Thursday,Spring,1,Early Morning,3,0,3
2011-12-22,5,Thursday,Spring,1,Early Morning,16,1,15
2011-12-22,6,Thursday,Spring,1,Morning Rush,64,1,63
2011-12-22,7,Thursday,Spring,1,Morning Rush,186,4,182
2011-12-22,8,Thursday,Spring,2,Morning Rush,343,10,333
2011-12-22,9,Thursday,Spring,2,Morning Rush,228,10,218
2011-12-22,10,Thursday,Spring,2,Mid-Day,141,13,128
2011-12-22,11,Thursday,Spring,2,Mid-Day,145,10,135
2011-12-22,12,Thursday,Spring,2,Mid-Day,202,22,180
2011-12-22,13,Thursday,Spring,2,Mid-Day,188,21,167
2011-12-22,14,Thursday,Spring,2,Mid-Day,159,23,136
2011-12-22,15,Thursday,Spring,2,Mid-Day,214,28,186
2011-12-22,16,Thursday,Spring,2,Evening Rush,256,30,226
2011-12-22,17,Thursday,Spring,2,Evening Rush,356,24,332
2011-12-22,18,Thursday,Spring,2,Evening Rush,288,11,277
2011-12-22,19,Thursday,Spring,2,Evening Rush,142,12,130
2011-12-22,20,Thursday,Spring,3,Night,33,0,33
2011-12-22,21,Thursday,Spring,3,Night,17,2,15
2011-12-22,22,Thursday,Spring,3,Night,17,0,17
2011-12-22,23,Thursday,Spring,3,Night,11,1,10
2011-12-23,0,Friday,Spring,3,Early Morning,9,2,7
2011-12-23,1,Friday,Spring,3,Early Morning,12,1,11
2011-12-23,2,Friday,Spring,3,Early Morning,13,1,12
2011-12-23,3,Friday,Spring,3,Early Morning,4,0,4
2011-12-23,4,Friday,Spring,3,Early Morning,2,0,2
2011-12-23,5,Friday,Spring,1,Early Morning,8,0,8
2011-12-23,6,Friday,Spring,1,Morning Rush,40,0,40
2011-12-23,7,Friday,Spring,1,Morning Rush,92,4,88
2011-12-23,8,Friday,Spring,1,Morning Rush,182,9,173
2011-12-23,9,Friday,Spring,1,Morning Rush,156,4,152
2011-12-23,10,Friday,Spring,1,Mid-Day,104,8,96
2011-12-23,11,Friday,Spring,1,Mid-Day,174,26,148
2011-12-23,12,Friday,Spring,1,Mid-Day,170,14,156
2011-12-23,13,Friday,Spring,1,Mid-Day,194,17,177
2011-12-23,14,Friday,Spring,1,Mid-Day,200,23,177
2011-12-23,15,Friday,Spring,1,Mid-Day,203,12,191
2011-12-23,16,Friday,Spring,1,Evening Rush,181,15,166
2011-12-23,17,Friday,Spring,1,Evening Rush,140,11,129
2011-12-23,18,Friday,Spring,1,Evening Rush,95,4,91
2011-12-23,19,Friday,Spring,1,Evening Rush,76,1,75
2011-12-23,20,Friday,Spring,1,Night,50,3,47
2011-12-23,21,Friday,Spring,1,Night,32,0,32
2011-12-23,22,Friday,Spring,1,Night,47,4,43
2011-12-23,23,Friday,Spring,1,Night,25,4,21
2011-12-24,0,Saturday,Spring,2,Early Morning,23,3,20
2011-12-24,1,Saturday,Spring,2,Early Morning,16,1,15
2011-12-24,2,Saturday,Spring,2,Early Morning,26,4,22
2011-12-24,3,Saturday,Spring,2,Early Morning,5,0,5
2011-12-24,4,Saturday,Spring,2,Early Morning,3,0,3
2011-12-24,5,Saturday,Spring,2,Early Morning,4,1,3
2011-12-24,6,Saturday,Spring,2,Morning Rush,10,0,10
2011-12-24,7,Saturday,Spring,1,Morning Rush,10,0,10
2011-12-24,8,Saturday,Spring,1,Morning Rush,27,0,27
2011-12-24,9,Saturday,Spring,1,Morning Rush,56,3,53
2011-12-24,10,Saturday,Spring,1,Mid-Day,56,4,52
2011-12-24,11,Saturday,Spring,1,Mid-Day,71,9,62
2011-12-24,12,Saturday,Spring,1,Mid-Day,94,15,79
2011-12-24,13,Saturday,Spring,1,Mid-Day,121,24,97
2011-12-24,14,Saturday,Spring,1,Mid-Day,85,15,70
2011-12-24,15,Saturday,Spring,1,Mid-Day,97,15,82
2011-12-24,16,Saturday,Spring,1,Evening Rush,99,25,74
2011-12-24,17,Saturday,Spring,1,Evening Rush,68,15,53
2011-12-24,18,Saturday,Spring,1,Evening Rush,35,2,33
2011-12-24,19,Saturday,Spring,1,Evening Rush,25,1,24
2011-12-24,20,Saturday,Spring,1,Night,24,5,19
2011-12-24,21,Saturday,Spring,1,Night,19,4,15
2011-12-24,22,Saturday,Spring,1,Night,20,8,12
2011-12-24,23,Saturday,Spring,1,Night,17,1,16
2011-12-25,0,Sunday,Spring,1,Early Morning,6,2,4
2011-12-25,1,Sunday,Spring,1,Early Morning,4,2,2
2011-12-25,2,Sunday,Spring,1,Early Morning,2,0,2
2011-12-25,3,Sunday,Spring,1,Early Morning,4,1,3
2011-12-25,5,Sunday,Spring,1,Early Morning,1,0,1
2011-12-25,6,Sunday,Spring,1,Morning Rush,1,0,1
2011-12-25,7,Sunday,Spring,1,Morning Rush,4,0,4
2011-12-25,8,Sunday,Spring,1,Morning Rush,5,1,4
2011-12-25,9,Sunday,Spring,1,Morning Rush,23,3,20
2011-12-25,10,Sunday,Spring,1,Mid-Day,43,31,12
2011-12-25,11,Sunday,Spring,1,Mid-Day,85,43,42
2011-12-25,12,Sunday,Spring,1,Mid-Day,66,25,41
2011-12-25,13,Sunday,Spring,1,Mid-Day,79,40,39
2011-12-25,14,Sunday,Spring,1,Mid-Day,86,41,45
2011-12-25,15,Sunday,Spring,1,Mid-Day,91,43,48
2011-12-25,16,Sunday,Spring,1,Evening Rush,86,35,51
2011-12-25,17,Sunday,Spring,1,Evening Rush,44,11,33
2011-12-25,18,Sunday,Spring,1,Evening Rush,30,7,23
2011-12-25,19,Sunday,Spring,1,Evening Rush,16,2,14
2011-12-25,20,Sunday,Spring,1,Night,26,8,18
2011-12-25,21,Sunday,Spring,1,Night,19,4,15
2011-12-25,22,Sunday,Spring,1,Night,17,2,15
2011-12-25,23,Sunday,Spring,1,Night,16,2,14
2011-12-26,0,Monday,Spring,1,Early Morning,11,5,6
2011-12-26,1,Monday,Spring,1,Early Morning,10,3,7
2011-12-26,2,Monday,Spring,1,Early Morning,7,2,5
2011-12-26,4,Monday,Spring,1,Early Morning,2,0,2
2011-12-26,5,Monday,Spring,1,Early Morning,4,0,4
2011-12-26,6,Monday,Spring,1,Morning Rush,4,0,4
2011-12-26,7,Monday,Spring,1,Morning Rush,19,2,17
2011-12-26,8,Monday,Spring,1,Morning Rush,18,5,13
2011-12-26,9,Monday,Spring,1,Morning Rush,62,24,38
2011-12-26,10,Monday,Spring,1,Mid-Day,70,31,39
2011-12-26,11,Monday,Spring,1,Mid-Day,91,40,51
2011-12-26,12,Monday,Spring,1,Mid-Day,100,34,66
2011-12-26,13,Monday,Spring,1,Mid-Day,140,57,83
2011-12-26,14,Monday,Spring,1,Mid-Day,153,73,80
2011-12-26,15,Monday,Spring,1,Mid-Day,131,26,105
2011-12-26,16,Monday,Spring,1,Evening Rush,97,28,69
2011-12-26,17,Monday,Spring,1,Evening Rush,97,30,67
2011-12-26,18,Monday,Spring,1,Evening Rush,75,21,54
2011-12-26,19,Monday,Spring,1,Evening Rush,65,16,49
2011-12-26,20,Monday,Spring,1,Night,56,14,42
2011-12-26,21,Monday,Spring,1,Night,49,10,39
2011-12-26,22,Monday,Spring,1,Night,27,5,22
2011-12-26,23,Monday,Spring,1,Night,29,4,25
2011-12-27,0,Tuesday,Spring,1,Early Morning,12,3,9
2011-12-27,1,Tuesday,Spring,1,Early Morning,6,0,6
2011-12-27,2,Tuesday,Spring,1,Early Morning,4,2,2
2011-12-27,3,Tuesday,Spring,2,Early Morning,3,0,3
2011-12-27,4,Tuesday,Spring,2,Early Morning,3,0,3
2011-12-27,5,Tuesday,Spring,2,Early Morning,8,0,8
2011-12-27,6,Tuesday,Spring,2,Morning Rush,35,0,35
2011-12-27,7,Tuesday,Spring,2,Morning Rush,80,1,79
2011-12-27,8,Tuesday,Spring,2,Morning Rush,164,9,155
2011-12-27,9,Tuesday,Spring,3,Morning Rush,104,19,85
2011-12-27,10,Tuesday,Spring,2,Mid-Day,60,13,47
2011-12-27,11,Tuesday,Spring,3,Mid-Day,30,6,24
2011-12-27,12,Tuesday,Spring,3,Mid-Day,24,8,16
2011-12-27,13,Tuesday,Spring,3,Mid-Day,20,1,19
2011-12-27,14,Tuesday,Spring,3,Mid-Day,14,0,14
2011-12-27,15,Tuesday,Spring,3,Mid-Day,19,2,17
2011-12-27,16,Tuesday,Spring,3,Evening Rush,46,2,44
2011-12-27,17,Tuesday,Spring,3,Evening Rush,115,6,109
2011-12-27,18,Tuesday,Spring,1,Evening Rush,135,9,126
2011-12-27,19,Tuesday,Spring,1,Evening Rush,90,3,87
2011-12-27,20,Tuesday,Spring,1,Night,69,3,66
2011-12-27,21,Tuesday,Spring,1,Night,63,11,52
2011-12-27,22,Tuesday,Spring,1,Night,32,3,29
2011-12-27,23,Tuesday,Spring,1,Night,26,2,24
2011-12-28,0,Wednesday,Spring,1,Early Morning,10,0,10
2011-12-28,1,Wednesday,Spring,1,Early Morning,12,0,12
2011-12-28,2,Wednesday,Spring,1,Early Morning,7,0,7
2011-12-28,3,Wednesday,Spring,1,Early Morning,4,0,4
2011-12-28,5,Wednesday,Spring,1,Early Morning,9,0,9
2011-12-28,6,Wednesday,Spring,1,Morning Rush,43,1,42
2011-12-28,7,Wednesday,Spring,1,Morning Rush,110,4,106
2011-12-28,8,Wednesday,Spring,1,Morning Rush,217,11,206
2011-12-28,9,Wednesday,Spring,1,Morning Rush,189,18,171
2011-12-28,10,Wednesday,Spring,1,Mid-Day,96,12,84
2011-12-28,11,Wednesday,Spring,1,Mid-Day,111,18,93
2011-12-28,12,Wednesday,Spring,1,Mid-Day,140,32,108
2011-12-28,13,Wednesday,Spring,1,Mid-Day,159,24,135
2011-12-28,14,Wednesday,Spring,1,Mid-Day,120,24,96
2011-12-28,15,Wednesday,Spring,1,Mid-Day,117,16,101
2011-12-28,16,Wednesday,Spring,1,Evening Rush,167,23,144
2011-12-28,17,Wednesday,Spring,1,Evening Rush,250,25,225
2011-12-28,18,Wednesday,Spring,1,Evening Rush,169,10,159
2011-12-28,19,Wednesday,Spring,1,Evening Rush,151,16,135
2011-12-28,20,Wednesday,Spring,1,Night,79,9,70
2011-12-28,21,Wednesday,Spring,1,Night,70,7,63
2011-12-28,22,Wednesday,Spring,1,Night,33,2,31
2011-12-28,23,Wednesday,Spring,1,Night,39,3,36
2011-12-29,0,Thursday,Spring,2,Early Morning,28,4,24
2011-12-29,1,Thursday,Spring,1,Early Morning,15,0,15
2011-12-29,2,Thursday,Spring,1,Early Morning,3,0,3
2011-12-29,3,Thursday,Spring,1,Early Morning,2,0,2
2011-12-29,4,Thursday,Spring,1,Early Morning,3,1,2
2011-12-29,5,Thursday,Spring,1,Early Morning,10,0,10
2011-12-29,6,Thursday,Spring,1,Morning Rush,41,2,39
2011-12-29,7,Thursday,Spring,1,Morning Rush,106,2,104
2011-12-29,8,Thursday,Spring,2,Morning Rush,210,3,207
2011-12-29,9,Thursday,Spring,2,Morning Rush,170,15,155
2011-12-29,10,Thursday,Spring,2,Mid-Day,110,13,97
2011-12-29,11,Thursday,Spring,2,Mid-Day,122,23,99
2011-12-29,12,Thursday,Spring,2,Mid-Day,130,12,118
2011-12-29,13,Thursday,Spring,2,Mid-Day,131,36,95
2011-12-29,14,Thursday,Spring,2,Mid-Day,142,30,112
2011-12-29,15,Thursday,Spring,2,Mid-Day,177,27,150
2011-12-29,16,Thursday,Spring,1,Evening Rush,177,22,155
2011-12-29,17,Thursday,Spring,1,Evening Rush,240,14,226
2011-12-29,18,Thursday,Spring,1,Evening Rush,207,15,192
2011-12-29,19,Thursday,Spring,1,Evening Rush,135,11,124
2011-12-29,20,Thursday,Spring,1,Night,96,8,88
2011-12-29,21,Thursday,Spring,2,Night,68,8,60
2011-12-29,22,Thursday,Spring,1,Night,55,7,48
2011-12-29,23,Thursday,Spring,1,Night,45,1,44
2011-12-30,0,Friday,Spring,1,Early Morning,30,4,26
2011-12-30,1,Friday,Spring,1,Early Morning,20,9,11
2011-12-30,2,Friday,Spring,1,Early Morning,12,2,10
2011-12-30,3,Friday,Spring,1,Early Morning,6,0,6
2011-12-30,4,Friday,Spring,1,Early Morning,2,0,2
2011-12-30,5,Friday,Spring,1,Early Morning,10,0,10
2011-12-30,6,Friday,Spring,1,Morning Rush,32,1,31
2011-12-30,7,Friday,Spring,1,Morning Rush,95,3,92
2011-12-30,8,Friday,Spring,2,Morning Rush,205,12,193
2011-12-30,9,Friday,Spring,1,Morning Rush,194,19,175
2011-12-30,10,Friday,Spring,1,Mid-Day,118,10,108
2011-12-30,11,Friday,Spring,1,Mid-Day,171,45,126
2011-12-30,12,Friday,Spring,1,Mid-Day,197,38,159
2011-12-30,13,Friday,Spring,2,Mid-Day,207,53,154
2011-12-30,14,Friday,Spring,2,Mid-Day,245,67,178
2011-12-30,15,Friday,Spring,1,Mid-Day,292,56,236
2011-12-30,16,Friday,Spring,1,Evening Rush,283,36,247
2011-12-30,17,Friday,Spring,1,Evening Rush,242,54,188
2011-12-30,18,Friday,Spring,1,Evening Rush,182,19,163
2011-12-30,19,Friday,Spring,2,Evening Rush,112,16,96
2011-12-30,20,Friday,Spring,2,Night,91,16,75
2011-12-30,21,Friday,Spring,2,Night,95,11,84
2011-12-30,22,Friday,Spring,2,Night,85,7,78
2011-12-30,23,Friday,Spring,2,Night,73,13,60
2011-12-31,0,Saturday,Spring,2,Early Morning,44,7,37
2011-12-31,1,Saturday,Spring,2,Early Morning,35,4,31
2011-12-31,2,Saturday,Spring,2,Early Morning,28,1,27
2011-12-31,3,Saturday,Spring,2,Early Morning,18,1,17
2011-12-31,4,Saturday,Spring,1,Early Morning,10,1,9
2011-12-31,5,Saturday,Spring,2,Early Morning,1,1,0
2011-12-31,6,Saturday,Spring,2,Morning Rush,6,1,5
2011-12-31,7,Saturday,Spring,3,Morning Rush,19,6,13
2011-12-31,8,Saturday,Spring,1,Morning Rush,49,7,42
2011-12-31,9,Saturday,Spring,1,Morning Rush,90,18,72
2011-12-31,10,Saturday,Spring,1,Mid-Day,128,20,108
2011-12-31,11,Saturday,Spring,1,Mid-Day,217,65,152
2011-12-31,12,Saturday,Spring,1,Mid-Day,273,93,180
2011-12-31,13,Saturday,Spring,1,Mid-Day,313,108,205
2011-12-31,14,Saturday,Spring,1,Mid-Day,300,115,185
2011-12-31,15,Saturday,Spring,1,Mid-Day,253,89,164
2011-12-31,16,Saturday,Spring,1,Evening Rush,195,52,143
2011-12-31,17,Saturday,Spring,1,Evening Rush,129,28,101
2011-12-31,18,Saturday,Spring,1,Evening Rush,93,13,80
2011-12-31,19,Saturday,Spring,1,Evening Rush,92,19,73
2011-12-31,20,Saturday,Spring,1,Night,71,8,63
2011-12-31,21,Saturday,Spring,1,Night,52,2,50
2011-12-31,22,Saturday,Spring,1,Night,38,2,36
2011-12-31,23,Saturday,Spring,1,Night,31,4,27
2012-01-01,0,Sunday,Spring,1,Early Morning,48,5,43
2012-01-01,1,Sunday,Spring,1,Early Morning,93,15,78
2012-01-01,2,Sunday,Spring,1,Early Morning,75,16,59
2012-01-01,3,Sunday,Spring,1,Early Morning,52,11,41
2012-01-01,4,Sunday,Spring,1,Early Morning,8,0,8
2012-01-01,5,Sunday,Spring,1,Early Morning,5,0,5
2012-01-01,6,Sunday,Spring,1,Morning Rush,2,1,1
2012-01-01,7,Sunday,Spring,1,Morning Rush,7,1,6
2012-01-01,8,Sunday,Spring,1,Morning Rush,14,4,10
2012-01-01,9,Sunday,Spring,1,Morning Rush,40,13,27
2012-01-01,10,Sunday,Spring,1,Mid-Day,70,18,52
2012-01-01,11,Sunday,Spring,1,Mid-Day,138,40,98
2012-01-01,12,Sunday,Spring,1,Mid-Day,201,58,143
2012-01-01,13,Sunday,Spring,1,Mid-Day,223,82,141
2012-01-01,14,Sunday,Spring,1,Mid-Day,267,120,147
2012-01-01,15,Sunday,Spring,1,Mid-Day,265,101,164
2012-01-01,16,Sunday,Spring,2,Evening Rush,215,68,147
2012-01-01,17,Sunday,Spring,2,Evening Rush,111,36,75
2012-01-01,18,Sunday,Spring,3,Evening Rush,106,25,81
2012-01-01,19,Sunday,Spring,3,Evening Rush,105,20,85
2012-01-01,20,Sunday,Spring,2,Night,83,25,58
2012-01-01,21,Sunday,Spring,2,Night,71,10,61
2012-01-01,22,Sunday,Spring,1,Night,66,13,53
2012-01-01,23,Sunday,Spring,1,Night,29,4,25
2012-01-02,0,Monday,Spring,1,Early Morning,39,8,31
2012-01-02,1,Monday,Spring,1,Early Morning,12,1,11
2012-01-02,2,Monday,Spring,1,Early Morning,7,1,6
2012-01-02,4,Monday,Spring,1,Early Morning,4,0,4
2012-01-02,5,Monday,Spring,1,Early Morning,4,1,3
2012-01-02,6,Monday,Spring,1,Morning Rush,14,0,14
2012-01-02,7,Monday,Spring,1,Morning Rush,16,0,16
2012-01-02,8,Monday,Spring,1,Morning Rush,53,2,51
2012-01-02,9,Monday,Spring,1,Morning Rush,68,15,53
2012-01-02,10,Monday,Spring,1,Mid-Day,109,20,89
2012-01-02,11,Monday,Spring,1,Mid-Day,175,33,142
2012-01-02,12,Monday,Spring,1,Mid-Day,202,41,161
2012-01-02,13,Monday,Spring,1,Mid-Day,176,26,150
2012-01-02,14,Monday,Spring,1,Mid-Day,151,10,141
2012-01-02,15,Monday,Spring,1,Mid-Day,168,29,139
2012-01-02,16,Monday,Spring,1,Evening Rush,154,10,144
2012-01-02,17,Monday,Spring,1,Evening Rush,153,17,136
2012-01-02,18,Monday,Spring,1,Evening Rush,126,13,113
2012-01-02,19,Monday,Spring,1,Evening Rush,93,4,89
2012-01-02,20,Monday,Spring,1,Night,88,5,83
2012-01-02,21,Monday,Spring,2,Night,66,3,63
2012-01-02,22,Monday,Spring,2,Night,39,3,36
2012-01-02,23,Monday,Spring,1,Night,34,2,32
2012-01-03,0,Tuesday,Spring,1,Early Morning,13,0,13
2012-01-03,1,Tuesday,Spring,1,Early Morning,6,1,5
2012-01-03,2,Tuesday,Spring,1,Early Morning,3,0,3
2012-01-03,3,Tuesday,Spring,1,Early Morning,2,0,2
2012-01-03,4,Tuesday,Spring,1,Early Morning,5,0,5
2012-01-03,5,Tuesday,Spring,1,Early Morning,12,0,12
2012-01-03,6,Tuesday,Spring,1,Morning Rush,85,4,81
2012-01-03,7,Tuesday,Spring,1,Morning Rush,170,2,168
2012-01-03,8,Tuesday,Spring,1,Morning Rush,354,5,349
2012-01-03,9,Tuesday,Spring,1,Morning Rush,153,8,145
2012-01-03,10,Tuesday,Spring,1,Mid-Day,60,5,55
2012-01-03,11,Tuesday,Spring,1,Mid-Day,75,12,63
2012-01-03,12,Tuesday,Spring,1,Mid-Day,74,4,70
2012-01-03,13,Tuesday,Spring,1,Mid-Day,73,5,68
2012-01-03,14,Tuesday,Spring,1,Mid-Day,79,7,72
2012-01-03,15,Tuesday,Spring,1,Mid-Day,77,9,68
2012-01-03,16,Tuesday,Spring,1,Evening Rush,136,7,129
2012-01-03,17,Tuesday,Spring,1,Evening Rush,245,4,241
2012-01-03,18,Tuesday,Spring,1,Evening Rush,224,10,214
2012-01-03,19,Tuesday,Spring,1,Evening Rush,156,4,152
2012-01-03,20,Tuesday,Spring,1,Night,115,0,115
2012-01-03,21,Tuesday,Spring,1,Night,68,2,66
2012-01-03,22,Tuesday,Spring,1,Night,33,0,33
2012-01-03,23,Tuesday,Spring,1,Night,18,0,18
2012-01-04,0,Wednesday,Spring,1,Early Morning,9,0,9
2012-01-04,1,Wednesday,Spring,1,Early Morning,3,0,3
2012-01-04,2,Wednesday,Spring,1,Early Morning,1,0,1
2012-01-04,3,Wednesday,Spring,1,Early Morning,1,0,1
2012-01-04,4,Wednesday,Spring,1,Early Morning,2,0,2
2012-01-04,5,Wednesday,Spring,1,Early Morning,14,0,14
2012-01-04,6,Wednesday,Spring,1,Morning Rush,59,0,59
2012-01-04,7,Wednesday,Spring,1,Morning Rush,152,1,151
2012-01-04,8,Wednesday,Spring,1,Morning Rush,315,5,310
2012-01-04,9,Wednesday,Spring,1,Morning Rush,180,7,173
2012-01-04,10,Wednesday,Spring,1,Mid-Day,64,7,57
2012-01-04,11,Wednesday,Spring,2,Mid-Day,46,6,40
2012-01-04,12,Wednesday,Spring,2,Mid-Day,84,9,75
2012-01-04,13,Wednesday,Spring,2,Mid-Day,91,9,82
2012-01-04,14,Wednesday,Spring,2,Mid-Day,75,6,69
2012-01-04,15,Wednesday,Spring,2,Mid-Day,90,9,81
2012-01-04,16,Wednesday,Spring,2,Evening Rush,131,8,123
2012-01-04,17,Wednesday,Spring,2,Evening Rush,281,9,272
2012-01-04,18,Wednesday,Spring,2,Evening Rush,289,9,280
2012-01-04,19,Wednesday,Spring,2,Evening Rush,184,2,182
2012-01-04,20,Wednesday,Spring,2,Night,123,2,121
2012-01-04,21,Wednesday,Spring,2,Night,90,2,88
2012-01-04,22,Wednesday,Spring,2,Night,52,4,48
2012-01-04,23,Wednesday,Spring,2,Night,32,0,32
2012-01-05,0,Thursday,Spring,2,Early Morning,14,1,13
2012-01-05,1,Thursday,Spring,1,Early Morning,5,0,5
2012-01-05,2,Thursday,Spring,1,Early Morning,4,0,4
2012-01-05,3,Thursday,Spring,1,Early Morning,4,0,4
2012-01-05,4,Thursday,Spring,2,Early Morning,5,0,5
2012-01-05,5,Thursday,Spring,2,Early Morning,26,0,26
2012-01-05,6,Thursday,Spring,2,Morning Rush,78,0,78
2012-01-05,7,Thursday,Spring,2,Morning Rush,215,3,212
2012-01-05,8,Thursday,Spring,2,Morning Rush,388,11,377
2012-01-05,9,Thursday,Spring,2,Morning Rush,227,7,220
2012-01-05,10,Thursday,Spring,2,Mid-Day,86,5,81
2012-01-05,11,Thursday,Spring,1,Mid-Day,84,6,78
2012-01-05,12,Thursday,Spring,1,Mid-Day,120,6,114
2012-01-05,13,Thursday,Spring,1,Mid-Day,118,6,112
2012-01-05,14,Thursday,Spring,1,Mid-Day,117,13,104
2012-01-05,15,Thursday,Spring,1,Mid-Day,119,6,113
2012-01-05,16,Thursday,Spring,1,Evening Rush,197,19,178
2012-01-05,17,Thursday,Spring,2,Evening Rush,412,19,393
2012-01-05,18,Thursday,Spring,1,Evening Rush,383,9,374
2012-01-05,19,Thursday,Spring,1,Evening Rush,265,10,255
2012-01-05,20,Thursday,Spring,1,Night,177,5,172
2012-01-05,21,Thursday,Spring,1,Night,97,9,88
2012-01-05,22,Thursday,Spring,1,Night,71,1,70
2012-01-05,23,Thursday,Spring,1,Night,60,4,56
2012-01-06,0,Friday,Spring,1,Early Morning,25,1,24
2012-01-06,1,Friday,Spring,1,Early Morning,8,2,6
2012-01-06,2,Friday,Spring,1,Early Morning,5,2,3
2012-01-06,3,Friday,Spring,1,Early Morning,4,1,3
2012-01-06,4,Friday,Spring,1,Early Morning,3,0,3
2012-01-06,5,Friday,Spring,2,Early Morning,13,0,13
2012-01-06,6,Friday,Spring,2,Morning Rush,70,1,69
2012-01-06,7,Friday,Spring,2,Morning Rush,205,4,201
2012-01-06,8,Friday,Spring,1,Morning Rush,447,11,436
2012-01-06,9,Friday,Spring,1,Morning Rush,241,4,237
2012-01-06,10,Friday,Spring,1,Mid-Day,116,14,102
2012-01-06,11,Friday,Spring,1,Mid-Day,138,8,130
2012-01-06,12,Friday,Spring,1,Mid-Day,191,23,168
2012-01-06,13,Friday,Spring,1,Mid-Day,204,16,188
2012-01-06,14,Friday,Spring,1,Mid-Day,178,26,152
2012-01-06,15,Friday,Spring,1,Mid-Day,222,44,178
2012-01-06,16,Friday,Spring,1,Evening Rush,294,35,259
2012-01-06,17,Friday,Spring,1,Evening Rush,476,20,456
2012-01-06,18,Friday,Spring,1,Evening Rush,419,28,391
2012-01-06,19,Friday,Spring,1,Evening Rush,272,11,261
2012-01-06,20,Friday,Spring,1,Night,177,14,163
2012-01-06,21,Friday,Spring,1,Night,154,17,137
2012-01-06,22,Friday,Spring,1,Night,135,12,123
2012-01-06,23,Friday,Spring,1,Night,101,13,88
2012-01-07,0,Saturday,Spring,1,Early Morning,79,2,77
2012-01-07,1,Saturday,Spring,1,Early Morning,62,6,56
2012-01-07,2,Saturday,Spring,1,Early Morning,38,2,36
2012-01-07,3,Saturday,Spring,1,Early Morning,20,1,19
2012-01-07,4,Saturday,Spring,1,Early Morning,10,1,9
2012-01-07,5,Saturday,Spring,1,Early Morning,9,2,7
2012-01-07,6,Saturday,Spring,1,Morning Rush,7,0,7
2012-01-07,7,Saturday,Spring,1,Morning Rush,20,0,20
2012-01-07,8,Saturday,Spring,1,Morning Rush,64,0,64
2012-01-07,9,Saturday,Spring,1,Morning Rush,130,14,116
2012-01-07,10,Saturday,Spring,1,Mid-Day,203,43,160
2012-01-07,11,Saturday,Spring,1,Mid-Day,324,74,250
2012-01-07,12,Saturday,Spring,1,Mid-Day,376,100,276
2012-01-07,13,Saturday,Spring,1,Mid-Day,445,149,296
2012-01-07,14,Saturday,Spring,1,Mid-Day,512,156,356
2012-01-07,15,Saturday,Spring,1,Mid-Day,449,132,317
2012-01-07,16,Saturday,Spring,2,Evening Rush,401,133,268
2012-01-07,17,Saturday,Spring,2,Evening Rush,322,87,235
2012-01-07,18,Saturday,Spring,1,Evening Rush,297,49,248
2012-01-07,19,Saturday,Spring,1,Evening Rush,215,44,171
2012-01-07,20,Saturday,Spring,1,Night,170,21,149
2012-01-07,21,Saturday,Spring,1,Night,140,22,118
2012-01-07,22,Saturday,Spring,1,Night,109,16,93
2012-01-07,23,Saturday,Spring,1,Night,119,16,103
2012-01-08,0,Sunday,Spring,1,Early Morning,91,14,77
2012-01-08,1,Sunday,Spring,1,Early Morning,72,10,62
2012-01-08,2,Sunday,Spring,1,Early Morning,67,10,57
2012-01-08,3,Sunday,Spring,1,Early Morning,32,6,26
2012-01-08,4,Sunday,Spring,1,Early Morning,6,2,4
2012-01-08,5,Sunday,Spring,2,Early Morning,2,0,2
2012-01-08,6,Sunday,Spring,2,Morning Rush,2,0,2
2012-01-08,7,Sunday,Spring,2,Morning Rush,24,1,23
2012-01-08,8,Sunday,Spring,1,Morning Rush,57,4,53
2012-01-08,9,Sunday,Spring,1,Morning Rush,125,23,102
2012-01-08,10,Sunday,Spring,1,Mid-Day,208,27,181
2012-01-08,11,Sunday,Spring,1,Mid-Day,256,55,201
2012-01-08,12,Sunday,Spring,1,Mid-Day,351,78,273
2012-01-08,13,Sunday,Spring,1,Mid-Day,343,77,266
2012-01-08,14,Sunday,Spring,1,Mid-Day,328,75,253
2012-01-08,15,Sunday,Spring,1,Mid-Day,330,89,241
2012-01-08,16,Sunday,Spring,1,Evening Rush,314,58,256
2012-01-08,17,Sunday,Spring,1,Evening Rush,219,22,197
2012-01-08,18,Sunday,Spring,1,Evening Rush,181,19,162
2012-01-08,19,Sunday,Spring,1,Evening Rush,112,8,104
2012-01-08,20,Sunday,Spring,1,Night,126,7,119
2012-01-08,21,Sunday,Spring,1,Night,91,10,81
2012-01-08,22,Sunday,Spring,1,Night,58,4,54
2012-01-08,23,Sunday,Spring,1,Night,30,0,30
2012-01-09,0,Monday,Spring,1,Early Morning,15,3,12
2012-01-09,1,Monday,Spring,1,Early Morning,5,1,4
2012-01-09,2,Monday,Spring,1,Early Morning,5,2,3
2012-01-09,3,Monday,Spring,1,Early Morning,3,0,3
2012-01-09,4,Monday,Spring,1,Early Morning,4,0,4
2012-01-09,5,Monday,Spring,2,Early Morning,21,0,21
2012-01-09,6,Monday,Spring,2,Morning Rush,88,3,85
2012-01-09,7,Monday,Spring,2,Morning Rush,240,1,239
2012-01-09,8,Monday,Spring,2,Morning Rush,420,13,407
2012-01-09,9,Monday,Spring,2,Morning Rush,197,9,188
2012-01-09,10,Monday,Spring,1,Mid-Day,108,13,95
2012-01-09,11,Monday,Spring,2,Mid-Day,88,6,82
2012-01-09,12,Monday,Spring,2,Mid-Day,103,10,93
2012-01-09,13,Monday,Spring,2,Mid-Day,80,3,77
2012-01-09,14,Monday,Spring,3,Mid-Day,50,5,45
2012-01-09,15,Monday,Spring,3,Mid-Day,69,5,64
2012-01-09,16,Monday,Spring,3,Evening Rush,49,3,46
2012-01-09,17,Monday,Spring,3,Evening Rush,152,5,147
2012-01-09,18,Monday,Spring,4,Evening Rush,164,6,158
2012-01-09,19,Monday,Spring,3,Evening Rush,190,3,187
2012-01-09,20,Monday,Spring,2,Night,132,5,127
2012-01-09,21,Monday,Spring,2,Night,79,1,78
2012-01-09,22,Monday,Spring,2,Night,62,8,54
2012-01-09,23,Monday,Spring,2,Night,52,1,51
2012-01-10,0,Tuesday,Spring,2,Early Morning,14,0,14
2012-01-10,1,Tuesday,Spring,2,Early Morning,5,2,3
2012-01-10,2,Tuesday,Spring,2,Early Morning,4,2,2
2012-01-10,4,Tuesday,Spring,2,Early Morning,4,0,4
2012-01-10,5,Tuesday,Spring,1,Early Morning,23,0,23
2012-01-10,6,Tuesday,Spring,2,Morning Rush,79,0,79
2012-01-10,7,Tuesday,Spring,2,Morning Rush,222,3,219
2012-01-10,8,Tuesday,Spring,2,Morning Rush,471,6,465
2012-01-10,9,Tuesday,Spring,2,Morning Rush,195,11,184
2012-01-10,10,Tuesday,Spring,2,Mid-Day,83,3,80
2012-01-10,11,Tuesday,Spring,1,Mid-Day,101,8,93
2012-01-10,12,Tuesday,Spring,1,Mid-Day,140,13,127
2012-01-10,13,Tuesday,Spring,1,Mid-Day,178,15,163
2012-01-10,14,Tuesday,Spring,1,Mid-Day,106,10,96
2012-01-10,15,Tuesday,Spring,1,Mid-Day,136,17,119
2012-01-10,16,Tuesday,Spring,1,Evening Rush,240,15,225
2012-01-10,17,Tuesday,Spring,1,Evening Rush,460,14,446
2012-01-10,18,Tuesday,Spring,1,Evening Rush,385,13,372
2012-01-10,19,Tuesday,Spring,1,Evening Rush,281,11,270
2012-01-10,20,Tuesday,Spring,1,Night,200,10,190
2012-01-10,21,Tuesday,Spring,1,Night,116,7,109
2012-01-10,22,Tuesday,Spring,1,Night,114,10,104
2012-01-10,23,Tuesday,Spring,1,Night,41,3,38
2012-01-11,0,Wednesday,Spring,1,Early Morning,28,2,26
2012-01-11,1,Wednesday,Spring,1,Early Morning,7,1,6
2012-01-11,2,Wednesday,Spring,1,Early Morning,5,0,5
2012-01-11,3,Wednesday,Spring,1,Early Morning,4,0,4
2012-01-11,4,Wednesday,Spring,1,Early Morning,2,0,2
2012-01-11,5,Wednesday,Spring,1,Early Morning,22,0,22
2012-01-11,6,Wednesday,Spring,1,Morning Rush,74,2,72
2012-01-11,7,Wednesday,Spring,1,Morning Rush,256,9,247
2012-01-11,8,Wednesday,Spring,1,Morning Rush,499,11,488
2012-01-11,9,Wednesday,Spring,2,Morning Rush,225,7,218
2012-01-11,10,Wednesday,Spring,2,Mid-Day,97,13,84
2012-01-11,11,Wednesday,Spring,2,Mid-Day,99,9,90
2012-01-11,12,Wednesday,Spring,3,Mid-Day,55,4,51
2012-01-11,13,Wednesday,Spring,3,Mid-Day,65,8,57
2012-01-11,14,Wednesday,Spring,3,Mid-Day,73,3,70
2012-01-11,15,Wednesday,Spring,2,Mid-Day,79,6,73
2012-01-11,16,Wednesday,Spring,2,Evening Rush,118,6,112
2012-01-11,17,Wednesday,Spring,3,Evening Rush,134,6,128
2012-01-11,18,Wednesday,Spring,3,Evening Rush,98,2,96
2012-01-11,19,Wednesday,Spring,3,Evening Rush,93,1,92
2012-01-11,20,Wednesday,Spring,3,Night,57,2,55
2012-01-11,21,Wednesday,Spring,3,Night,29,0,29
2012-01-11,22,Wednesday,Spring,3,Night,49,0,49
2012-01-11,23,Wednesday,Spring,3,Night,9,0,9
2012-01-12,0,Thursday,Spring,3,Early Morning,3,0,3
2012-01-12,1,Thursday,Spring,3,Early Morning,3,0,3
2012-01-12,2,Thursday,Spring,3,Early Morning,2,1,1
2012-01-12,3,Thursday,Spring,3,Early Morning,3,0,3
2012-01-12,4,Thursday,Spring,3,Early Morning,2,0,2
2012-01-12,5,Thursday,Spring,3,Early Morning,16,0,16
2012-01-12,6,Thursday,Spring,3,Morning Rush,89,1,88
2012-01-12,7,Thursday,Spring,2,Morning Rush,220,2,218
2012-01-12,8,Thursday,Spring,1,Morning Rush,508,11,497
2012-01-12,9,Thursday,Spring,1,Morning Rush,230,10,220
2012-01-12,10,Thursday,Spring,1,Mid-Day,90,6,84
2012-01-12,11,Thursday,Spring,2,Mid-Day,119,18,101
2012-01-12,12,Thursday,Spring,2,Mid-Day,144,14,130
2012-01-12,13,Thursday,Spring,1,Mid-Day,183,13,170
2012-01-12,14,Thursday,Spring,1,Mid-Day,156,24,132
2012-01-12,15,Thursday,Spring,1,Mid-Day,188,32,156
2012-01-12,16,Thursday,Spring,1,Evening Rush,281,33,248
2012-01-12,17,Thursday,Spring,1,Evening Rush,495,23,472
2012-01-12,18,Thursday,Spring,1,Evening Rush,421,22,399
2012-01-12,19,Thursday,Spring,2,Evening Rush,330,17,313
2012-01-12,20,Thursday,Spring,2,Night,240,11,229
2012-01-12,21,Thursday,Spring,1,Night,174,12,162
2012-01-12,22,Thursday,Spring,1,Night,133,12,121
2012-01-12,23,Thursday,Spring,1,Night,67,7,60
2012-01-13,0,Friday,Spring,2,Early Morning,42,4,38
2012-01-13,1,Friday,Spring,2,Early Morning,12,0,12
2012-01-13,2,Friday,Spring,1,Early Morning,14,1,13
2012-01-13,3,Friday,Spring,1,Early Morning,7,3,4
2012-01-13,4,Friday,Spring,3,Early Morning,3,1,2
2012-01-13,5,Friday,Spring,2,Early Morning,21,0,21
2012-01-13,6,Friday,Spring,2,Morning Rush,73,2,71
2012-01-13,7,Friday,Spring,1,Morning Rush,177,3,174
2012-01-13,8,Friday,Spring,1,Morning Rush,419,11,408
2012-01-13,9,Friday,Spring,1,Morning Rush,214,10,204
2012-01-13,10,Friday,Spring,1,Mid-Day,103,2,101
2012-01-13,11,Friday,Spring,1,Mid-Day,114,12,102
2012-01-13,12,Friday,Spring,1,Mid-Day,154,14,140
2012-01-13,13,Friday,Spring,1,Mid-Day,154,14,140
2012-01-13,14,Friday,Spring,1,Mid-Day,129,10,119
2012-01-13,15,Friday,Spring,1,Mid-Day,138,15,123
2012-01-13,16,Friday,Spring,1,Evening Rush,233,18,215
2012-01-13,17,Friday,Spring,1,Evening Rush,332,15,317
2012-01-13,18,Friday,Spring,1,Evening Rush,301,7,294
2012-01-13,19,Friday,Spring,1,Evening Rush,206,7,199
2012-01-13,20,Friday,Spring,1,Night,136,6,130
2012-01-13,21,Friday,Spring,1,Night,102,7,95
2012-01-13,22,Friday,Spring,1,Night,65,7,58
2012-01-13,23,Friday,Spring,1,Night,65,5,60
2012-01-14,0,Saturday,Spring,1,Early Morning,44,2,42
2012-01-14,1,Saturday,Spring,1,Early Morning,50,6,44
2012-01-14,2,Saturday,Spring,1,Early Morning,38,6,32
2012-01-14,3,Saturday,Spring,1,Early Morning,20,6,14
2012-01-14,4,Saturday,Spring,1,Early Morning,3,0,3
2012-01-14,5,Saturday,Spring,1,Early Morning,4,0,4
2012-01-14,6,Saturday,Spring,1,Morning Rush,5,0,5
2012-01-14,7,Saturday,Spring,1,Morning Rush,24,0,24
2012-01-14,8,Saturday,Spring,1,Morning Rush,92,3,89
2012-01-14,9,Saturday,Spring,1,Morning Rush,81,3,78
2012-01-14,10,Saturday,Spring,1,Mid-Day,149,14,135
2012-01-14,11,Saturday,Spring,1,Mid-Day,178,28,150
2012-01-14,12,Saturday,Spring,1,Mid-Day,219,30,189
2012-01-14,13,Saturday,Spring,1,Mid-Day,220,38,182
2012-01-14,14,Saturday,Spring,1,Mid-Day,231,52,179
2012-01-14,15,Saturday,Spring,1,Mid-Day,226,49,177
2012-01-14,16,Saturday,Spring,1,Evening Rush,206,28,178
2012-01-14,17,Saturday,Spring,1,Evening Rush,144,15,129
2012-01-14,18,Saturday,Spring,1,Evening Rush,143,21,122
2012-01-14,19,Saturday,Spring,1,Evening Rush,102,12,90
2012-01-14,20,Saturday,Spring,1,Night,103,8,95
2012-01-14,21,Saturday,Spring,1,Night,69,3,66
2012-01-14,22,Saturday,Spring,1,Night,66,4,62
2012-01-14,23,Saturday,Spring,1,Night,76,5,71
2012-01-15,0,Sunday,Spring,1,Early Morning,59,9,50
2012-01-15,1,Sunday,Spring,2,Early Morning,42,2,40
2012-01-15,2,Sunday,Spring,2,Early Morning,43,5,38
2012-01-15,3,Sunday,Spring,2,Early Morning,25,1,24
2012-01-15,4,Sunday,Spring,2,Early Morning,6,1,5
2012-01-15,5,Sunday,Spring,2,Early Morning,5,0,5
2012-01-15,6,Sunday,Spring,2,Morning Rush,8,1,7
2012-01-15,7,Sunday,Spring,1,Morning Rush,17,3,14
2012-01-15,8,Sunday,Spring,1,Morning Rush,36,2,34
2012-01-15,9,Sunday,Spring,1,Morning Rush,90,10,80
2012-01-15,10,Sunday,Spring,1,Mid-Day,126,11,115
2012-01-15,11,Sunday,Spring,1,Mid-Day,165,21,144
2012-01-15,12,Sunday,Spring,1,Mid-Day,234,42,192
2012-01-15,13,Sunday,Spring,1,Mid-Day,224,40,184
2012-01-15,14,Sunday,Spring,1,Mid-Day,188,25,163
2012-01-15,15,Sunday,Spring,1,Mid-Day,206,33,173
2012-01-15,16,Sunday,Spring,1,Evening Rush,205,31,174
2012-01-15,17,Sunday,Spring,1,Evening Rush,146,15,131
2012-01-15,18,Sunday,Spring,1,Evening Rush,120,7,113
2012-01-15,19,Sunday,Spring,1,Evening Rush,110,9,101
2012-01-15,20,Sunday,Spring,1,Night,95,10,85
2012-01-15,21,Sunday,Spring,1,Night,72,1,71
2012-01-15,22,Sunday,Spring,1,Night,60,2,58
2012-01-15,23,Sunday,Spring,1,Night,29,3,26
2012-01-16,0,Monday,Spring,1,Early Morning,25,2,23
2012-01-16,1,Monday,Spring,1,Early Morning,20,2,18
2012-01-16,2,Monday,Spring,1,Early Morning,17,3,14
2012-01-16,3,Monday,Spring,1,Early Morning,3,0,3
2012-01-16,4,Monday,Spring,1,Early Morning,8,2,6
2012-01-16,5,Monday,Spring,1,Early Morning,6,1,5
2012-01-16,6,Monday,Spring,1,Morning Rush,13,0,13
2012-01-16,7,Monday,Spring,1,Morning Rush,33,5,28
2012-01-16,8,Monday,Spring,1,Morning Rush,78,3,75
2012-01-16,9,Monday,Spring,1,Morning Rush,96,7,89
2012-01-16,10,Monday,Spring,2,Mid-Day,126,19,107
2012-01-16,11,Monday,Spring,1,Mid-Day,179,21,158
2012-01-16,12,Monday,Spring,1,Mid-Day,185,20,165
2012-01-16,13,Monday,Spring,2,Mid-Day,228,26,202
2012-01-16,14,Monday,Spring,1,Mid-Day,181,23,158
2012-01-16,15,Monday,Spring,1,Mid-Day,192,17,175
2012-01-16,16,Monday,Spring,1,Evening Rush,180,22,158
2012-01-16,17,Monday,Spring,1,Evening Rush,193,19,174
2012-01-16,18,Monday,Spring,1,Evening Rush,181,6,175
2012-01-16,19,Monday,Spring,1,Evening Rush,144,10,134
2012-01-16,20,Monday,Spring,1,Night,90,2,88
2012-01-16,21,Monday,Spring,1,Night,49,3,46
2012-01-16,22,Monday,Spring,2,Night,43,4,39
2012-01-16,23,Monday,Spring,3,Night,28,0,28
2012-01-17,0,Tuesday,Spring,2,Early Morning,12,0,12
2012-01-17,1,Tuesday,Spring,2,Early Morning,2,0,2
2012-01-17,2,Tuesday,Spring,3,Early Morning,12,0,12
2012-01-17,4,Tuesday,Spring,3,Early Morning,2,0,2
2012-01-17,5,Tuesday,Spring,3,Early Morning,13,0,13
2012-01-17,6,Tuesday,Spring,3,Morning Rush,57,0,57
2012-01-17,7,Tuesday,Spring,3,Morning Rush,126,5,121
2012-01-17,8,Tuesday,Spring,3,Morning Rush,93,3,90
2012-01-17,9,Tuesday,Spring,3,Morning Rush,68,7,61
2012-01-17,10,Tuesday,Spring,3,Mid-Day,62,1,61
2012-01-17,11,Tuesday,Spring,2,Mid-Day,75,2,73
2012-01-17,12,Tuesday,Spring,2,Mid-Day,86,3,83
2012-01-17,13,Tuesday,Spring,2,Mid-Day,103,8,95
2012-01-17,14,Tuesday,Spring,1,Mid-Day,132,12,120
2012-01-17,15,Tuesday,Spring,1,Mid-Day,129,6,123
2012-01-17,16,Tuesday,Spring,1,Evening Rush,219,14,205
2012-01-17,17,Tuesday,Spring,1,Evening Rush,462,20,442
2012-01-17,18,Tuesday,Spring,1,Evening Rush,463,12,451
2012-01-17,19,Tuesday,Spring,1,Evening Rush,308,11,297
2012-01-17,20,Tuesday,Spring,1,Night,180,11,169
2012-01-17,21,Tuesday,Spring,1,Night,180,6,174
2012-01-17,22,Tuesday,Spring,1,Night,90,5,85
2012-01-17,23,Tuesday,Spring,1,Night,61,1,60
2012-01-18,0,Wednesday,Spring,2,Early Morning,17,3,14
2012-01-18,1,Wednesday,Spring,2,Early Morning,10,0,10
2012-01-18,2,Wednesday,Spring,2,Early Morning,2,1,1
2012-01-18,3,Wednesday,Spring,2,Early Morning,4,1,3
2012-01-18,4,Wednesday,Spring,1,Early Morning,1,0,1
2012-01-18,5,Wednesday,Spring,1,Early Morning,29,0,29
2012-01-18,6,Wednesday,Spring,1,Morning Rush,88,0,88
2012-01-18,7,Wednesday,Spring,1,Morning Rush,263,1,262
2012-01-18,8,Wednesday,Spring,1,Morning Rush,489,15,474
2012-01-18,9,Wednesday,Spring,1,Morning Rush,202,6,196
2012-01-18,10,Wednesday,Spring,1,Mid-Day,93,5,88
2012-01-18,11,Wednesday,Spring,1,Mid-Day,114,4,110
2012-01-18,12,Wednesday,Spring,1,Mid-Day,161,6,155
2012-01-18,13,Wednesday,Spring,1,Mid-Day,130,6,124
2012-01-18,14,Wednesday,Spring,1,Mid-Day,105,7,98
2012-01-18,15,Wednesday,Spring,1,Mid-Day,130,8,122
2012-01-18,16,Wednesday,Spring,1,Evening Rush,176,13,163
2012-01-18,17,Wednesday,Spring,1,Evening Rush,346,8,338
2012-01-18,18,Wednesday,Spring,1,Evening Rush,355,8,347
2012-01-18,19,Wednesday,Spring,1,Evening Rush,256,5,251
2012-01-18,20,Wednesday,Spring,1,Night,165,1,164
2012-01-18,21,Wednesday,Spring,1,Night,124,5,119
2012-01-18,22,Wednesday,Spring,1,Night,78,4,74
2012-01-18,23,Wednesday,Spring,1,Night,38,2,36
2012-01-19,0,Thursday,Spring,1,Early Morning,16,0,16
2012-01-19,1,Thursday,Spring,1,Early Morning,5,0,5
2012-01-19,2,Thursday,Spring,1,Early Morning,3,0,3
2012-01-19,3,Thursday,Spring,1,Early Morning,4,0,4
2012-01-19,4,Thursday,Spring,1,Early Morning,1,0,1
2012-01-19,5,Thursday,Spring,1,Early Morning,19,0,19
2012-01-19,6,Thursday,Spring,1,Morning Rush,86,0,86
2012-01-19,7,Thursday,Spring,1,Morning Rush,206,2,204
2012-01-19,8,Thursday,Spring,1,Morning Rush,423,9,414
2012-01-19,9,Thursday,Spring,1,Morning Rush,210,6,204
2012-01-19,10,Thursday,Spring,1,Mid-Day,108,10,98
2012-01-19,11,Thursday,Spring,1,Mid-Day,99,6,93
2012-01-19,12,Thursday,Spring,1,Mid-Day,111,5,106
2012-01-19,13,Thursday,Spring,1,Mid-Day,124,6,118
2012-01-19,14,Thursday,Spring,1,Mid-Day,119,15,104
2012-01-19,15,Thursday,Spring,1,Mid-Day,127,9,118
2012-01-19,16,Thursday,Spring,1,Evening Rush,193,8,185
2012-01-19,17,Thursday,Spring,2,Evening Rush,385,21,364
2012-01-19,18,Thursday,Spring,2,Evening Rush,361,16,345
2012-01-19,19,Thursday,Spring,2,Evening Rush,234,5,229
2012-01-19,20,Thursday,Spring,1,Night,191,7,184
2012-01-19,21,Thursday,Spring,1,Night,121,4,117
2012-01-19,22,Thursday,Spring,2,Night,90,0,90
2012-01-19,23,Thursday,Spring,1,Night,56,1,55
2012-01-20,0,Friday,Spring,2,Early Morning,27,3,24
2012-01-20,1,Friday,Spring,1,Early Morning,15,0,15
2012-01-20,2,Friday,Spring,1,Early Morning,11,0,11
2012-01-20,3,Friday,Spring,1,Early Morning,4,0,4
2012-01-20,4,Friday,Spring,1,Early Morning,3,0,3
2012-01-20,5,Friday,Spring,1,Early Morning,19,0,19
2012-01-20,6,Friday,Spring,1,Morning Rush,68,0,68
2012-01-20,7,Friday,Spring,1,Morning Rush,185,2,183
2012-01-20,8,Friday,Spring,1,Morning Rush,425,4,421
2012-01-20,9,Friday,Spring,1,Morning Rush,263,21,242
2012-01-20,10,Friday,Spring,2,Mid-Day,97,1,96
2012-01-20,11,Friday,Spring,2,Mid-Day,123,6,117
2012-01-20,12,Friday,Spring,2,Mid-Day,124,5,119
2012-01-20,13,Friday,Spring,1,Mid-Day,156,12,144
2012-01-20,14,Friday,Spring,2,Mid-Day,115,8,107
2012-01-20,15,Friday,Spring,2,Mid-Day,156,12,144
2012-01-20,16,Friday,Spring,2,Evening Rush,174,11,163
2012-01-20,17,Friday,Spring,2,Evening Rush,349,9,340
2012-01-20,18,Friday,Spring,2,Evening Rush,301,5,296
2012-01-20,19,Friday,Spring,2,Evening Rush,192,6,186
2012-01-20,20,Friday,Spring,2,Night,142,1,141
2012-01-20,21,Friday,Spring,2,Night,104,5,99
2012-01-20,22,Friday,Spring,2,Night,72,1,71
2012-01-20,23,Friday,Spring,3,Night,38,3,35
2012-01-21,0,Saturday,Spring,3,Early Morning,24,0,24
2012-01-21,1,Saturday,Spring,4,Early Morning,23,1,22
2012-01-21,2,Saturday,Spring,3,Early Morning,26,1,25
2012-01-21,3,Saturday,Spring,3,Early Morning,13,0,13
2012-01-21,4,Saturday,Spring,3,Early Morning,1,0,1
2012-01-21,5,Saturday,Spring,3,Early Morning,2,0,2
2012-01-21,6,Saturday,Spring,3,Morning Rush,1,0,1
2012-01-21,7,Saturday,Spring,3,Morning Rush,13,3,10
2012-01-21,8,Saturday,Spring,2,Morning Rush,25,3,22
2012-01-21,9,Saturday,Spring,2,Morning Rush,42,2,40
2012-01-21,10,Saturday,Spring,3,Mid-Day,45,0,45
2012-01-21,11,Saturday,Spring,2,Mid-Day,63,1,62
2012-01-21,12,Saturday,Spring,2,Mid-Day,67,5,62
2012-01-21,13,Saturday,Spring,2,Mid-Day,76,10,66
2012-01-21,14,Saturday,Spring,3,Mid-Day,95,6,89
2012-01-21,15,Saturday,Spring,3,Mid-Day,119,6,113
2012-01-21,16,Saturday,Spring,2,Evening Rush,118,5,113
2012-01-21,17,Saturday,Spring,2,Evening Rush,106,7,99
2012-01-21,18,Saturday,Spring,2,Evening Rush,110,3,107
2012-01-21,19,Saturday,Spring,2,Evening Rush,85,0,85
2012-01-21,20,Saturday,Spring,2,Night,67,5,62
2012-01-21,21,Saturday,Spring,1,Night,69,5,64
2012-01-21,22,Saturday,Spring,2,Night,59,3,56
2012-01-21,23,Saturday,Spring,2,Night,52,1,51
2012-01-22,0,Sunday,Spring,1,Early Morning,52,1,51
2012-01-22,1,Sunday,Spring,2,Early Morning,50,1,49
2012-01-22,2,Sunday,Spring,2,Early Morning,47,1,46
2012-01-22,3,Sunday,Spring,2,Early Morning,21,1,20
2012-01-22,4,Sunday,Spring,3,Early Morning,2,1,1
2012-01-22,5,Sunday,Spring,3,Early Morning,3,1,2
2012-01-22,6,Sunday,Spring,2,Morning Rush,4,0,4
2012-01-22,7,Sunday,Spring,2,Morning Rush,13,2,11
2012-01-22,8,Sunday,Spring,2,Morning Rush,32,3,29
2012-01-22,9,Sunday,Spring,2,Morning Rush,63,9,54
2012-01-22,10,Sunday,Spring,2,Mid-Day,129,9,120
2012-01-22,11,Sunday,Spring,3,Mid-Day,133,18,115
2012-01-22,12,Sunday,Spring,2,Mid-Day,185,24,161
2012-01-22,13,Sunday,Spring,2,Mid-Day,199,24,175
2012-01-22,14,Sunday,Spring,2,Mid-Day,182,19,163
2012-01-22,15,Sunday,Spring,2,Mid-Day,176,27,149
2012-01-22,16,Sunday,Spring,2,Evening Rush,155,12,143
2012-01-22,17,Sunday,Spring,2,Evening Rush,108,8,100
2012-01-22,18,Sunday,Spring,3,Evening Rush,121,11,110
2012-01-22,19,Sunday,Spring,3,Evening Rush,89,9,80
2012-01-22,20,Sunday,Spring,3,Night,74,5,69
2012-01-22,21,Sunday,Spring,3,Night,44,8,36
2012-01-22,22,Sunday,Spring,2,Night,58,0,58
2012-01-22,23,Sunday,Spring,2,Night,37,2,35
2012-01-23,0,Monday,Spring,2,Early Morning,19,2,17
2012-01-23,1,Monday,Spring,2,Early Morning,4,0,4
2012-01-23,2,Monday,Spring,2,Early Morning,2,0,2
2012-01-23,3,Monday,Spring,2,Early Morning,1,0,1
2012-01-23,4,Monday,Spring,2,Early Morning,1,0,1
2012-01-23,5,Monday,Spring,2,Early Morning,19,0,19
2012-01-23,6,Monday,Spring,2,Morning Rush,42,6,36
2012-01-23,7,Monday,Spring,3,Morning Rush,122,8,114
2012-01-23,8,Monday,Spring,3,Morning Rush,272,5,267
2012-01-23,9,Monday,Spring,2,Morning Rush,211,13,198
2012-01-23,10,Monday,Spring,2,Mid-Day,149,10,139
2012-01-23,11,Monday,Spring,2,Mid-Day,62,5,57
2012-01-23,12,Monday,Spring,2,Mid-Day,62,10,52
2012-01-23,13,Monday,Spring,3,Mid-Day,37,5,32
2012-01-23,14,Monday,Spring,3,Mid-Day,61,13,48
2012-01-23,15,Monday,Spring,2,Mid-Day,74,10,64
2012-01-23,16,Monday,Spring,2,Evening Rush,122,14,108
2012-01-23,17,Monday,Spring,2,Evening Rush,276,6,270
2012-01-23,18,Monday,Spring,2,Evening Rush,282,7,275
2012-01-23,19,Monday,Spring,2,Evening Rush,220,9,211
2012-01-23,20,Monday,Spring,2,Night,169,8,161
2012-01-23,21,Monday,Spring,2,Night,120,8,112
2012-01-23,22,Monday,Spring,2,Night,68,4,64
2012-01-23,23,Monday,Spring,2,Night,37,2,35
2012-01-24,0,Tuesday,Spring,2,Early Morning,25,6,19
2012-01-24,1,Tuesday,Spring,2,Early Morning,9,2,7
2012-01-24,2,Tuesday,Spring,2,Early Morning,8,2,6
2012-01-24,3,Tuesday,Spring,2,Early Morning,3,0,3
2012-01-24,4,Tuesday,Spring,2,Early Morning,2,0,2
2012-01-24,5,Tuesday,Spring,2,Early Morning,26,0,26
2012-01-24,6,Tuesday,Spring,2,Morning Rush,89,1,88
2012-01-24,7,Tuesday,Spring,2,Morning Rush,232,11,221
2012-01-24,8,Tuesday,Spring,2,Morning Rush,490,11,479
2012-01-24,9,Tuesday,Spring,2,Morning Rush,255,11,244
2012-01-24,10,Tuesday,Spring,1,Mid-Day,116,23,93
2012-01-24,11,Tuesday,Spring,1,Mid-Day,153,30,123
2012-01-24,12,Tuesday,Spring,1,Mid-Day,175,25,150
2012-01-24,13,Tuesday,Spring,1,Mid-Day,203,33,170
2012-01-24,14,Tuesday,Spring,1,Mid-Day,173,35,138
2012-01-24,15,Tuesday,Spring,2,Mid-Day,208,52,156
2012-01-24,16,Tuesday,Spring,1,Evening Rush,278,35,243
2012-01-24,17,Tuesday,Spring,1,Evening Rush,515,41,474
2012-01-24,18,Tuesday,Spring,1,Evening Rush,423,32,391
2012-01-24,19,Tuesday,Spring,1,Evening Rush,331,20,311
2012-01-24,20,Tuesday,Spring,1,Night,229,18,211
2012-01-24,21,Tuesday,Spring,1,Night,172,18,154
2012-01-24,22,Tuesday,Spring,1,Night,125,14,111
2012-01-24,23,Tuesday,Spring,1,Night,99,19,80
2012-01-25,0,Wednesday,Spring,1,Early Morning,31,6,25
2012-01-25,1,Wednesday,Spring,1,Early Morning,13,4,9
2012-01-25,2,Wednesday,Spring,1,Early Morning,6,3,3
2012-01-25,3,Wednesday,Spring,1,Early Morning,1,0,1
2012-01-25,4,Wednesday,Spring,1,Early Morning,4,0,4
2012-01-25,5,Wednesday,Spring,1,Early Morning,33,0,33
2012-01-25,6,Wednesday,Spring,1,Morning Rush,88,1,87
2012-01-25,7,Wednesday,Spring,1,Morning Rush,257,14,243
2012-01-25,8,Wednesday,Spring,1,Morning Rush,513,18,495
2012-01-25,9,Wednesday,Spring,1,Morning Rush,236,18,218
2012-01-25,10,Wednesday,Spring,2,Mid-Day,141,30,111
2012-01-25,11,Wednesday,Spring,2,Mid-Day,157,52,105
2012-01-25,12,Wednesday,Spring,1,Mid-Day,193,46,147
2012-01-25,13,Wednesday,Spring,1,Mid-Day,212,63,149
2012-01-25,14,Wednesday,Spring,1,Mid-Day,160,53,107
2012-01-25,15,Wednesday,Spring,1,Mid-Day,155,30,125
2012-01-25,16,Wednesday,Spring,1,Evening Rush,246,29,217
2012-01-25,17,Wednesday,Spring,1,Evening Rush,470,27,443
2012-01-25,18,Wednesday,Spring,1,Evening Rush,439,24,415
2012-01-25,19,Wednesday,Spring,2,Evening Rush,316,5,311
2012-01-25,20,Wednesday,Spring,1,Night,235,10,225
2012-01-25,21,Wednesday,Spring,1,Night,185,19,166
2012-01-25,22,Wednesday,Spring,1,Night,113,12,101
2012-01-25,23,Wednesday,Spring,2,Night,66,3,63
2012-01-26,0,Thursday,Spring,2,Early Morning,25,3,22
2012-01-26,1,Thursday,Spring,2,Early Morning,21,5,16
2012-01-26,2,Thursday,Spring,2,Early Morning,7,1,6
2012-01-26,3,Thursday,Spring,2,Early Morning,6,1,5
2012-01-26,4,Thursday,Spring,1,Early Morning,3,0,3
2012-01-26,5,Thursday,Spring,2,Early Morning,28,0,28
2012-01-26,6,Thursday,Spring,2,Morning Rush,88,0,88
2012-01-26,7,Thursday,Spring,2,Morning Rush,239,11,228
2012-01-26,8,Thursday,Spring,2,Morning Rush,530,16,514
2012-01-26,9,Thursday,Spring,2,Morning Rush,274,18,256
2012-01-26,10,Thursday,Spring,2,Mid-Day,108,16,92
2012-01-26,11,Thursday,Spring,2,Mid-Day,111,11,100
2012-01-26,12,Thursday,Spring,2,Mid-Day,165,29,136
2012-01-26,13,Thursday,Spring,2,Mid-Day,173,17,156
2012-01-26,14,Thursday,Spring,2,Mid-Day,128,16,112
2012-01-26,15,Thursday,Spring,2,Mid-Day,164,22,142
2012-01-26,16,Thursday,Spring,2,Evening Rush,224,15,209
2012-01-26,17,Thursday,Spring,2,Evening Rush,413,16,397
2012-01-26,18,Thursday,Spring,2,Evening Rush,406,12,394
2012-01-26,19,Thursday,Spring,2,Evening Rush,313,11,302
2012-01-26,20,Thursday,Spring,2,Night,224,8,216
2012-01-26,21,Thursday,Spring,2,Night,192,8,184
2012-01-26,22,Thursday,Spring,1,Night,142,3,139
2012-01-26,23,Thursday,Spring,2,Night,91,5,86
2012-01-27,0,Friday,Spring,2,Early Morning,38,6,32
2012-01-27,1,Friday,Spring,2,Early Morning,29,6,23
2012-01-27,2,Friday,Spring,1,Early Morning,13,2,11
2012-01-27,3,Friday,Spring,2,Early Morning,8,3,5
2012-01-27,4,Friday,Spring,2,Early Morning,4,1,3
2012-01-27,5,Friday,Spring,2,Early Morning,24,0,24
2012-01-27,6,Friday,Spring,2,Morning Rush,72,0,72
2012-01-27,7,Friday,Spring,2,Morning Rush,134,6,128
2012-01-27,8,Friday,Spring,3,Morning Rush,220,14,206
2012-01-27,9,Friday,Spring,3,Morning Rush,107,6,101
2012-01-27,10,Friday,Spring,3,Mid-Day,126,9,117
2012-01-27,11,Friday,Spring,2,Mid-Day,105,10,95
2012-01-27,12,Friday,Spring,2,Mid-Day,180,25,155
2012-01-27,13,Friday,Spring,1,Mid-Day,201,26,175
2012-01-27,14,Friday,Spring,1,Mid-Day,176,23,153
2012-01-27,15,Friday,Spring,1,Mid-Day,197,27,170
2012-01-27,16,Friday,Spring,1,Evening Rush,267,26,241
2012-01-27,17,Friday,Spring,1,Evening Rush,422,16,406
2012-01-27,18,Friday,Spring,1,Evening Rush,383,20,363
2012-01-27,19,Friday,Spring,1,Evening Rush,251,10,241
2012-01-27,20,Friday,Spring,1,Night,159,6,153
2012-01-27,21,Friday,Spring,1,Night,135,8,127
2012-01-27,22,Friday,Spring,1,Night,119,11,108
2012-01-27,23,Friday,Spring,1,Night,86,8,78
2012-01-28,0,Saturday,Spring,1,Early Morning,69,1,68
2012-01-28,1,Saturday,Spring,1,Early Morning,58,1,57
2012-01-28,2,Saturday,Spring,1,Early Morning,41,3,38
2012-01-28,3,Saturday,Spring,1,Early Morning,17,1,16
2012-01-28,4,Saturday,Spring,1,Early Morning,8,0,8
2012-01-28,5,Saturday,Spring,1,Early Morning,10,0,10
2012-01-28,6,Saturday,Spring,1,Morning Rush,15,3,12
2012-01-28,7,Saturday,Spring,1,Morning Rush,31,3,28
2012-01-28,8,Saturday,Spring,1,Morning Rush,91,9,82
2012-01-28,9,Saturday,Spring,1,Morning Rush,158,13,145
2012-01-28,10,Saturday,Spring,1,Mid-Day,191,27,164
2012-01-28,11,Saturday,Spring,1,Mid-Day,296,55,241
2012-01-28,12,Saturday,Spring,1,Mid-Day,314,70,244
2012-01-28,13,Saturday,Spring,1,Mid-Day,373,80,293
2012-01-28,14,Saturday,Spring,1,Mid-Day,362,123,239
2012-01-28,15,Saturday,Spring,1,Mid-Day,410,90,320
2012-01-28,16,Saturday,Spring,1,Evening Rush,407,131,276
2012-01-28,17,Saturday,Spring,1,Evening Rush,290,57,233
2012-01-28,18,Saturday,Spring,1,Evening Rush,241,40,201
2012-01-28,19,Saturday,Spring,2,Evening Rush,206,33,173
2012-01-28,20,Saturday,Spring,1,Night,120,5,115
2012-01-28,21,Saturday,Spring,1,Night,127,18,109
2012-01-28,22,Saturday,Spring,1,Night,103,6,97
2012-01-28,23,Saturday,Spring,1,Night,85,6,79
2012-01-29,0,Sunday,Spring,1,Early Morning,96,15,81
2012-01-29,1,Sunday,Spring,1,Early Morning,73,5,68
2012-01-29,2,Sunday,Spring,1,Early Morning,51,3,48
2012-01-29,3,Sunday,Spring,1,Early Morning,21,4,17
2012-01-29,4,Sunday,Spring,1,Early Morning,5,0,5
2012-01-29,5,Sunday,Spring,1,Early Morning,7,1,6
2012-01-29,6,Sunday,Spring,1,Morning Rush,5,1,4
2012-01-29,7,Sunday,Spring,1,Morning Rush,12,0,12
2012-01-29,8,Sunday,Spring,1,Morning Rush,70,9,61
2012-01-29,9,Sunday,Spring,1,Morning Rush,111,13,98
2012-01-29,10,Sunday,Spring,1,Mid-Day,191,38,153
2012-01-29,11,Sunday,Spring,1,Mid-Day,255,57,198
2012-01-29,12,Sunday,Spring,1,Mid-Day,288,73,215
2012-01-29,13,Sunday,Spring,1,Mid-Day,316,78,238
2012-01-29,14,Sunday,Spring,1,Mid-Day,280,51,229
2012-01-29,15,Sunday,Spring,1,Mid-Day,310,68,242
2012-01-29,16,Sunday,Spring,1,Evening Rush,322,54,268
2012-01-29,17,Sunday,Spring,1,Evening Rush,234,33,201
2012-01-29,18,Sunday,Spring,1,Evening Rush,168,17,151
2012-01-29,19,Sunday,Spring,1,Evening Rush,159,14,145
2012-01-29,20,Sunday,Spring,1,Night,111,13,98
2012-01-29,21,Sunday,Spring,1,Night,69,0,69
2012-01-29,22,Sunday,Spring,1,Night,64,7,57
2012-01-29,23,Sunday,Spring,1,Night,25,4,21
2012-01-30,0,Monday,Spring,2,Early Morning,10,0,10
2012-01-30,1,Monday,Spring,1,Early Morning,9,0,9
2012-01-30,2,Monday,Spring,1,Early Morning,7,1,6
2012-01-30,3,Monday,Spring,1,Early Morning,4,0,4
2012-01-30,4,Monday,Spring,1,Early Morning,5,0,5
2012-01-30,5,Monday,Spring,1,Early Morning,26,0,26
2012-01-30,6,Monday,Spring,1,Morning Rush,80,0,80
2012-01-30,7,Monday,Spring,1,Morning Rush,225,4,221
2012-01-30,8,Monday,Spring,1,Morning Rush,493,12,481
2012-01-30,9,Monday,Spring,1,Morning Rush,198,5,193
2012-01-30,10,Monday,Spring,1,Mid-Day,85,3,82
2012-01-30,11,Monday,Spring,1,Mid-Day,99,6,93
2012-01-30,12,Monday,Spring,1,Mid-Day,134,5,129
2012-01-30,13,Monday,Spring,1,Mid-Day,132,15,117
2012-01-30,14,Monday,Spring,1,Mid-Day,115,15,100
2012-01-30,15,Monday,Spring,1,Mid-Day,138,7,131
2012-01-30,16,Monday,Spring,1,Evening Rush,221,11,210
2012-01-30,17,Monday,Spring,1,Evening Rush,438,16,422
2012-01-30,18,Monday,Spring,1,Evening Rush,410,11,399
2012-01-30,19,Monday,Spring,1,Evening Rush,306,8,298
2012-01-30,20,Monday,Spring,1,Night,181,2,179
2012-01-30,21,Monday,Spring,1,Night,162,3,159
2012-01-30,22,Monday,Spring,1,Night,94,2,92
2012-01-30,23,Monday,Spring,1,Night,52,0,52
2012-01-31,0,Tuesday,Spring,1,Early Morning,15,0,15
2012-01-31,1,Tuesday,Spring,1,Early Morning,8,1,7
2012-01-31,2,Tuesday,Spring,1,Early Morning,2,0,2
2012-01-31,3,Tuesday,Spring,1,Early Morning,2,0,2
2012-01-31,4,Tuesday,Spring,1,Early Morning,1,0,1
2012-01-31,5,Tuesday,Spring,1,Early Morning,22,0,22
2012-01-31,6,Tuesday,Spring,1,Morning Rush,104,0,104
2012-01-31,7,Tuesday,Spring,1,Morning Rush,279,6,273
2012-01-31,8,Tuesday,Spring,1,Morning Rush,512,14,498
2012-01-31,9,Tuesday,Spring,1,Morning Rush,261,30,231
2012-01-31,10,Tuesday,Spring,2,Mid-Day,144,34,110
2012-01-31,11,Tuesday,Spring,1,Mid-Day,139,14,125
2012-01-31,12,Tuesday,Spring,1,Mid-Day,194,13,181
2012-01-31,13,Tuesday,Spring,1,Mid-Day,198,27,171
2012-01-31,14,Tuesday,Spring,1,Mid-Day,160,18,142
2012-01-31,15,Tuesday,Spring,1,Mid-Day,177,27,150
2012-01-31,16,Tuesday,Spring,1,Evening Rush,307,30,277
2012-01-31,17,Tuesday,Spring,1,Evening Rush,559,41,518
2012-01-31,18,Tuesday,Spring,1,Evening Rush,502,16,486
2012-01-31,19,Tuesday,Spring,1,Evening Rush,328,22,306
2012-01-31,20,Tuesday,Spring,1,Night,238,15,223
2012-01-31,21,Tuesday,Spring,1,Night,165,3,162
2012-01-31,22,Tuesday,Spring,1,Night,129,11,118
2012-01-31,23,Tuesday,Spring,1,Night,63,2,61
2012-02-01,0,Wednesday,Spring,1,Early Morning,31,0,31
2012-02-01,1,Wednesday,Spring,1,Early Morning,4,0,4
2012-02-01,2,Wednesday,Spring,1,Early Morning,7,1,6
2012-02-01,3,Wednesday,Spring,1,Early Morning,3,0,3
2012-02-01,4,Wednesday,Spring,1,Early Morning,1,0,1
2012-02-01,5,Wednesday,Spring,1,Early Morning,18,0,18
2012-02-01,6,Wednesday,Spring,3,Morning Rush,67,0,67
2012-02-01,7,Wednesday,Spring,3,Morning Rush,208,7,201
2012-02-01,8,Wednesday,Spring,3,Morning Rush,520,15,505
2012-02-01,9,Wednesday,Spring,2,Morning Rush,276,9,267
2012-02-01,10,Wednesday,Spring,1,Mid-Day,133,9,124
2012-02-01,11,Wednesday,Spring,1,Mid-Day,143,27,116
2012-02-01,12,Wednesday,Spring,1,Mid-Day,179,26,153
2012-02-01,13,Wednesday,Spring,1,Mid-Day,186,12,174
2012-02-01,14,Wednesday,Spring,1,Mid-Day,192,33,159
2012-02-01,15,Wednesday,Spring,1,Mid-Day,194,25,169
2012-02-01,16,Wednesday,Spring,1,Evening Rush,283,22,261
2012-02-01,17,Wednesday,Spring,1,Evening Rush,539,31,508
2012-02-01,18,Wednesday,Spring,1,Evening Rush,526,12,514
2012-02-01,19,Wednesday,Spring,1,Evening Rush,335,20,315
2012-02-01,20,Wednesday,Spring,1,Night,264,10,254
2012-02-01,21,Wednesday,Spring,1,Night,233,16,217
2012-02-01,22,Wednesday,Spring,1,Night,140,7,133
2012-02-01,23,Wednesday,Spring,1,Night,97,22,75
2012-02-02,0,Thursday,Spring,1,Early Morning,31,7,24
2012-02-02,1,Thursday,Spring,2,Early Morning,17,3,14
2012-02-02,2,Thursday,Spring,2,Early Morning,9,2,7
2012-02-02,3,Thursday,Spring,2,Early Morning,2,0,2
2012-02-02,4,Thursday,Spring,3,Early Morning,1,0,1
2012-02-02,5,Thursday,Spring,3,Early Morning,19,0,19
2012-02-02,6,Thursday,Spring,3,Morning Rush,74,1,73
2012-02-02,7,Thursday,Spring,3,Morning Rush,205,4,201
2012-02-02,8,Thursday,Spring,3,Morning Rush,445,9,436
2012-02-02,9,Thursday,Spring,3,Morning Rush,228,15,213
2012-02-02,10,Thursday,Spring,3,Mid-Day,78,6,72
2012-02-02,11,Thursday,Spring,3,Mid-Day,105,6,99
2012-02-02,12,Thursday,Spring,1,Mid-Day,148,8,140
2012-02-02,13,Thursday,Spring,2,Mid-Day,137,13,124
2012-02-02,14,Thursday,Spring,1,Mid-Day,141,12,129
2012-02-02,15,Thursday,Spring,1,Mid-Day,174,24,150
2012-02-02,16,Thursday,Spring,1,Evening Rush,229,18,211
2012-02-02,17,Thursday,Spring,1,Evening Rush,450,13,437
2012-02-02,18,Thursday,Spring,1,Evening Rush,410,17,393
2012-02-02,19,Thursday,Spring,1,Evening Rush,327,16,311
2012-02-02,20,Thursday,Spring,1,Night,213,9,204
2012-02-02,21,Thursday,Spring,1,Night,148,4,144
2012-02-02,22,Thursday,Spring,1,Night,109,3,106
2012-02-02,23,Thursday,Spring,1,Night,61,0,61
2012-02-03,0,Friday,Spring,1,Early Morning,38,1,37
2012-02-03,1,Friday,Spring,1,Early Morning,22,3,19
2012-02-03,2,Friday,Spring,1,Early Morning,6,0,6
2012-02-03,3,Friday,Spring,1,Early Morning,4,0,4
2012-02-03,4,Friday,Spring,1,Early Morning,2,0,2
2012-02-03,5,Friday,Spring,1,Early Morning,17,0,17
2012-02-03,6,Friday,Spring,1,Morning Rush,88,0,88
2012-02-03,7,Friday,Spring,1,Morning Rush,226,10,216
2012-02-03,8,Friday,Spring,1,Morning Rush,441,12,429
2012-02-03,9,Friday,Spring,1,Morning Rush,270,18,252
2012-02-03,10,Friday,Spring,1,Mid-Day,129,15,114
2012-02-03,11,Friday,Spring,1,Mid-Day,164,15,149
2012-02-03,12,Friday,Spring,1,Mid-Day,216,25,191
2012-02-03,13,Friday,Spring,1,Mid-Day,198,25,173
2012-02-03,14,Friday,Spring,1,Mid-Day,170,22,148
2012-02-03,15,Friday,Spring,1,Mid-Day,216,48,168
2012-02-03,16,Friday,Spring,1,Evening Rush,311,36,275
2012-02-03,17,Friday,Spring,1,Evening Rush,488,30,458
2012-02-03,18,Friday,Spring,1,Evening Rush,385,17,368
2012-02-03,19,Friday,Spring,1,Evening Rush,267,11,256
2012-02-03,20,Friday,Spring,1,Night,163,8,155
2012-02-03,21,Friday,Spring,1,Night,134,8,126
2012-02-03,22,Friday,Spring,1,Night,119,3,116
2012-02-03,23,Friday,Spring,1,Night,77,3,74
2012-02-04,0,Saturday,Spring,1,Early Morning,86,10,76
2012-02-04,1,Saturday,Spring,1,Early Morning,43,0,43
2012-02-04,2,Saturday,Spring,1,Early Morning,44,6,38
2012-02-04,3,Saturday,Spring,1,Early Morning,18,1,17
2012-02-04,4,Saturday,Spring,1,Early Morning,6,1,5
2012-02-04,5,Saturday,Spring,1,Early Morning,4,1,3
2012-02-04,6,Saturday,Spring,1,Morning Rush,5,1,4
2012-02-04,7,Saturday,Spring,2,Morning Rush,28,1,27
2012-02-04,8,Saturday,Spring,1,Morning Rush,90,4,86
2012-02-04,9,Saturday,Spring,1,Morning Rush,157,16,141
2012-02-04,10,Saturday,Spring,1,Mid-Day,224,31,193
2012-02-04,11,Saturday,Spring,1,Mid-Day,270,46,224
2012-02-04,12,Saturday,Spring,2,Mid-Day,300,40,260
2012-02-04,13,Saturday,Spring,2,Mid-Day,302,58,244
2012-02-04,14,Saturday,Spring,2,Mid-Day,276,47,229
2012-02-04,15,Saturday,Spring,2,Mid-Day,305,61,244
2012-02-04,16,Saturday,Spring,2,Evening Rush,143,20,123
2012-02-04,17,Saturday,Spring,3,Evening Rush,67,13,54
2012-02-04,18,Saturday,Spring,3,Evening Rush,64,6,58
2012-02-04,19,Saturday,Spring,3,Evening Rush,80,5,75
2012-02-04,20,Saturday,Spring,3,Night,77,4,73
2012-02-04,21,Saturday,Spring,3,Night,78,4,74
2012-02-04,22,Saturday,Spring,2,Night,95,4,91
2012-02-04,23,Saturday,Spring,2,Night,70,4,66
2012-02-05,0,Sunday,Spring,2,Early Morning,61,3,58
2012-02-05,1,Sunday,Spring,2,Early Morning,51,5,46
2012-02-05,2,Sunday,Spring,2,Early Morning,63,4,59
2012-02-05,3,Sunday,Spring,3,Early Morning,17,4,13
2012-02-05,4,Sunday,Spring,2,Early Morning,9,0,9
2012-02-05,5,Sunday,Spring,3,Early Morning,4,0,4
2012-02-05,6,Sunday,Spring,2,Morning Rush,4,0,4
2012-02-05,7,Sunday,Spring,2,Morning Rush,16,0,16
2012-02-05,8,Sunday,Spring,2,Morning Rush,62,4,58
2012-02-05,9,Sunday,Spring,2,Morning Rush,92,9,83
2012-02-05,10,Sunday,Spring,2,Mid-Day,148,10,138
2012-02-05,11,Sunday,Spring,2,Mid-Day,182,22,160
2012-02-05,12,Sunday,Spring,2,Mid-Day,248,25,223
2012-02-05,13,Sunday,Spring,2,Mid-Day,274,33,241
2012-02-05,14,Sunday,Spring,1,Mid-Day,243,40,203
2012-02-05,15,Sunday,Spring,2,Mid-Day,272,55,217
2012-02-05,16,Sunday,Spring,1,Evening Rush,296,35,261
2012-02-05,17,Sunday,Spring,1,Evening Rush,306,31,275
2012-02-05,18,Sunday,Spring,1,Evening Rush,181,10,171
2012-02-05,19,Sunday,Spring,1,Evening Rush,69,6,63
2012-02-05,20,Sunday,Spring,1,Night,50,3,47
2012-02-05,21,Sunday,Spring,1,Night,66,6,60
2012-02-05,22,Sunday,Spring,1,Night,191,9,182
2012-02-05,23,Sunday,Spring,1,Night,42,4,38
2012-02-06,0,Monday,Spring,1,Early Morning,21,7,14
2012-02-06,1,Monday,Spring,1,Early Morning,6,0,6
2012-02-06,2,Monday,Spring,1,Early Morning,3,0,3
2012-02-06,4,Monday,Spring,1,Early Morning,2,0,2
2012-02-06,5,Monday,Spring,1,Early Morning,17,0,17
2012-02-06,6,Monday,Spring,1,Morning Rush,72,0,72
2012-02-06,7,Monday,Spring,1,Morning Rush,234,5,229
2012-02-06,8,Monday,Spring,1,Morning Rush,444,10,434
2012-02-06,9,Monday,Spring,1,Morning Rush,277,8,269
2012-02-06,10,Monday,Spring,1,Mid-Day,116,20,96
2012-02-06,11,Monday,Spring,1,Mid-Day,116,12,104
2012-02-06,12,Monday,Spring,1,Mid-Day,150,19,131
2012-02-06,13,Monday,Spring,1,Mid-Day,141,17,124
2012-02-06,14,Monday,Spring,1,Mid-Day,140,14,126
2012-02-06,15,Monday,Spring,1,Mid-Day,171,25,146
2012-02-06,16,Monday,Spring,1,Evening Rush,228,13,215
2012-02-06,17,Monday,Spring,1,Evening Rush,430,13,417
2012-02-06,18,Monday,Spring,1,Evening Rush,437,11,426
2012-02-06,19,Monday,Spring,1,Evening Rush,291,7,284
2012-02-06,20,Monday,Spring,1,Night,201,7,194
2012-02-06,21,Monday,Spring,1,Night,154,11,143
2012-02-06,22,Monday,Spring,1,Night,87,4,83
2012-02-06,23,Monday,Spring,1,Night,46,3,43
2012-02-07,0,Tuesday,Spring,1,Early Morning,23,1,22
2012-02-07,1,Tuesday,Spring,1,Early Morning,14,8,6
2012-02-07,2,Tuesday,Spring,1,Early Morning,4,0,4
2012-02-07,3,Tuesday,Spring,2,Early Morning,2,1,1
2012-02-07,4,Tuesday,Spring,2,Early Morning,3,0,3
2012-02-07,5,Tuesday,Spring,1,Early Morning,15,0,15
2012-02-07,6,Tuesday,Spring,1,Morning Rush,100,2,98
2012-02-07,7,Tuesday,Spring,1,Morning Rush,299,6,293
2012-02-07,8,Tuesday,Spring,1,Morning Rush,529,7,522
2012-02-07,9,Tuesday,Spring,1,Morning Rush,289,11,278
2012-02-07,10,Tuesday,Spring,1,Mid-Day,116,12,104
2012-02-07,11,Tuesday,Spring,1,Mid-Day,129,9,120
2012-02-07,12,Tuesday,Spring,1,Mid-Day,172,9,163
2012-02-07,13,Tuesday,Spring,1,Mid-Day,184,15,169
2012-02-07,14,Tuesday,Spring,1,Mid-Day,138,11,127
2012-02-07,15,Tuesday,Spring,1,Mid-Day,146,13,133
2012-02-07,16,Tuesday,Spring,1,Evening Rush,276,19,257
2012-02-07,17,Tuesday,Spring,1,Evening Rush,509,15,494
2012-02-07,18,Tuesday,Spring,1,Evening Rush,518,10,508
2012-02-07,19,Tuesday,Spring,1,Evening Rush,338,11,327
2012-02-07,20,Tuesday,Spring,1,Night,212,6,206
2012-02-07,21,Tuesday,Spring,1,Night,190,20,170
2012-02-07,22,Tuesday,Spring,1,Night,118,11,107
2012-02-07,23,Tuesday,Spring,1,Night,51,2,49
2012-02-08,0,Wednesday,Spring,1,Early Morning,23,2,21
2012-02-08,1,Wednesday,Spring,1,Early Morning,10,1,9
2012-02-08,2,Wednesday,Spring,1,Early Morning,1,0,1
2012-02-08,3,Wednesday,Spring,1,Early Morning,1,0,1
2012-02-08,4,Wednesday,Spring,1,Early Morning,1,0,1
2012-02-08,5,Wednesday,Spring,1,Early Morning,20,0,20
2012-02-08,6,Wednesday,Spring,2,Morning Rush,98,3,95
2012-02-08,7,Wednesday,Spring,2,Morning Rush,281,5,276
2012-02-08,8,Wednesday,Spring,2,Morning Rush,508,13,495
2012-02-08,9,Wednesday,Spring,2,Morning Rush,253,8,245
2012-02-08,10,Wednesday,Spring,2,Mid-Day,108,1,107
2012-02-08,11,Wednesday,Spring,2,Mid-Day,102,5,97
2012-02-08,12,Wednesday,Spring,2,Mid-Day,138,14,124
2012-02-08,13,Wednesday,Spring,2,Mid-Day,126,15,111
2012-02-08,14,Wednesday,Spring,2,Mid-Day,108,8,100
2012-02-08,15,Wednesday,Spring,3,Mid-Day,54,5,49
2012-02-08,16,Wednesday,Spring,3,Evening Rush,75,2,73
2012-02-08,17,Wednesday,Spring,3,Evening Rush,155,8,147
2012-02-08,18,Wednesday,Spring,3,Evening Rush,167,4,163
2012-02-08,19,Wednesday,Spring,3,Evening Rush,161,3,158
2012-02-08,20,Wednesday,Spring,3,Night,125,3,122
2012-02-08,21,Wednesday,Spring,3,Night,129,3,126
2012-02-08,22,Wednesday,Spring,2,Night,98,3,95
2012-02-08,23,Wednesday,Spring,2,Night,60,3,57
2012-02-09,0,Thursday,Spring,2,Early Morning,26,3,23
2012-02-09,1,Thursday,Spring,2,Early Morning,12,2,10
2012-02-09,2,Thursday,Spring,1,Early Morning,2,0,2
2012-02-09,3,Thursday,Spring,1,Early Morning,4,0,4
2012-02-09,4,Thursday,Spring,2,Early Morning,1,0,1
2012-02-09,5,Thursday,Spring,1,Early Morning,18,0,18
2012-02-09,6,Thursday,Spring,1,Morning Rush,76,1,75
2012-02-09,7,Thursday,Spring,1,Morning Rush,267,4,263
2012-02-09,8,Thursday,Spring,1,Morning Rush,484,11,473
2012-02-09,9,Thursday,Spring,1,Morning Rush,238,9,229
2012-02-09,10,Thursday,Spring,1,Mid-Day,97,7,90
2012-02-09,11,Thursday,Spring,1,Mid-Day,99,4,95
2012-02-09,12,Thursday,Spring,1,Mid-Day,158,10,148
2012-02-09,13,Thursday,Spring,1,Mid-Day,154,10,144
2012-02-09,14,Thursday,Spring,1,Mid-Day,144,18,126
2012-02-09,15,Thursday,Spring,1,Mid-Day,134,14,120
2012-02-09,16,Thursday,Spring,1,Evening Rush,238,15,223
2012-02-09,17,Thursday,Spring,1,Evening Rush,399,12,387
2012-02-09,18,Thursday,Spring,1,Evening Rush,417,13,404
2012-02-09,19,Thursday,Spring,1,Evening Rush,295,8,287
2012-02-09,20,Thursday,Spring,1,Night,199,2,197
2012-02-09,21,Thursday,Spring,1,Night,177,8,169
2012-02-09,22,Thursday,Spring,2,Night,107,3,104
2012-02-09,23,Thursday,Spring,2,Night,84,9,75
2012-02-10,0,Friday,Spring,2,Early Morning,43,4,39
2012-02-10,1,Friday,Spring,2,Early Morning,13,2,11
2012-02-10,2,Friday,Spring,1,Early Morning,16,7,9
2012-02-10,3,Friday,Spring,1,Early Morning,5,0,5
2012-02-10,4,Friday,Spring,1,Early Morning,2,0,2
2012-02-10,5,Friday,Spring,1,Early Morning,17,0,17
2012-02-10,6,Friday,Spring,1,Morning Rush,64,3,61
2012-02-10,7,Friday,Spring,1,Morning Rush,230,5,225
2012-02-10,8,Friday,Spring,1,Morning Rush,448,1,447
2012-02-10,9,Friday,Spring,1,Morning Rush,275,10,265
2012-02-10,10,Friday,Spring,2,Mid-Day,124,5,119
2012-02-10,11,Friday,Spring,2,Mid-Day,153,19,134
2012-02-10,12,Friday,Spring,2,Mid-Day,176,8,168
2012-02-10,13,Friday,Spring,2,Mid-Day,192,22,170
2012-02-10,14,Friday,Spring,2,Mid-Day,146,8,138
2012-02-10,15,Friday,Spring,2,Mid-Day,191,27,164
2012-02-10,16,Friday,Spring,2,Evening Rush,268,28,240
2012-02-10,17,Friday,Spring,2,Evening Rush,396,15,381
2012-02-10,18,Friday,Spring,3,Evening Rush,359,14,345
2012-02-10,19,Friday,Spring,2,Evening Rush,262,16,246
2012-02-10,20,Friday,Spring,2,Night,151,7,144
2012-02-10,21,Friday,Spring,2,Night,122,14,108
2012-02-10,22,Friday,Spring,2,Night,113,11,102
2012-02-10,23,Friday,Spring,2,Night,65,1,64
2012-02-11,0,Saturday,Spring,2,Early Morning,53,3,50
2012-02-11,1,Saturday,Spring,3,Early Morning,45,2,43
2012-02-11,2,Saturday,Spring,3,Early Morning,26,2,24
2012-02-11,3,Saturday,Spring,3,Early Morning,9,0,9
2012-02-11,4,Saturday,Spring,3,Early Morning,4,0,4
2012-02-11,5,Saturday,Spring,3,Early Morning,2,0,2
2012-02-11,6,Saturday,Spring,3,Morning Rush,9,1,8
2012-02-11,7,Saturday,Spring,3,Morning Rush,19,0,19
2012-02-11,8,Saturday,Spring,3,Morning Rush,78,1,77
2012-02-11,9,Saturday,Spring,3,Morning Rush,90,5,85
2012-02-11,10,Saturday,Spring,3,Mid-Day,166,23,143
2012-02-11,11,Saturday,Spring,2,Mid-Day,183,26,157
2012-02-11,12,Saturday,Spring,2,Mid-Day,221,25,196
2012-02-11,13,Saturday,Spring,2,Mid-Day,235,18,217
2012-02-11,14,Saturday,Spring,2,Mid-Day,243,38,205
2012-02-11,15,Saturday,Spring,2,Mid-Day,124,12,112
2012-02-11,16,Saturday,Spring,3,Evening Rush,146,12,134
2012-02-11,17,Saturday,Spring,3,Evening Rush,144,13,131
2012-02-11,18,Saturday,Spring,2,Evening Rush,108,3,105
2012-02-11,19,Saturday,Spring,2,Evening Rush,87,2,85
2012-02-11,20,Saturday,Spring,2,Night,63,1,62
2012-02-11,21,Saturday,Spring,1,Night,48,5,43
2012-02-11,22,Saturday,Spring,2,Night,46,0,46
2012-02-11,23,Saturday,Spring,3,Night,20,0,20
2012-02-12,0,Sunday,Spring,3,Early Morning,21,0,21
2012-02-12,1,Sunday,Spring,3,Early Morning,24,0,24
2012-02-12,2,Sunday,Spring,2,Early Morning,27,1,26
2012-02-12,3,Sunday,Spring,2,Early Morning,14,0,14
2012-02-12,4,Sunday,Spring,2,Early Morning,1,0,1
2012-02-12,5,Sunday,Spring,1,Early Morning,3,0,3
2012-02-12,6,Sunday,Spring,1,Morning Rush,2,0,2
2012-02-12,7,Sunday,Spring,1,Morning Rush,18,0,18
2012-02-12,8,Sunday,Spring,1,Morning Rush,26,0,26
2012-02-12,9,Sunday,Spring,1,Morning Rush,63,3,60
2012-02-12,10,Sunday,Spring,1,Mid-Day,91,8,83
2012-02-12,11,Sunday,Spring,1,Mid-Day,124,3,121
2012-02-12,12,Sunday,Spring,1,Mid-Day,140,7,133
2012-02-12,13,Sunday,Spring,1,Mid-Day,138,10,128
2012-02-12,14,Sunday,Spring,1,Mid-Day,111,9,102
2012-02-12,15,Sunday,Spring,1,Mid-Day,155,5,150
2012-02-12,16,Sunday,Spring,1,Evening Rush,164,16,148
2012-02-12,17,Sunday,Spring,1,Evening Rush,87,4,83
2012-02-12,18,Sunday,Spring,1,Evening Rush,96,4,92
2012-02-12,19,Sunday,Spring,1,Evening Rush,80,2,78
2012-02-12,20,Sunday,Spring,1,Night,57,1,56
2012-02-12,21,Sunday,Spring,1,Night,36,0,36
2012-02-12,22,Sunday,Spring,1,Night,28,0,28
2012-02-12,23,Sunday,Spring,1,Night,23,0,23
2012-02-13,0,Monday,Spring,1,Early Morning,9,0,9
2012-02-13,1,Monday,Spring,1,Early Morning,6,0,6
2012-02-13,2,Monday,Spring,1,Early Morning,4,0,4
2012-02-13,3,Monday,Spring,1,Early Morning,1,0,1
2012-02-13,4,Monday,Spring,1,Early Morning,2,0,2
2012-02-13,5,Monday,Spring,1,Early Morning,17,0,17
2012-02-13,6,Monday,Spring,1,Morning Rush,72,1,71
2012-02-13,7,Monday,Spring,1,Morning Rush,195,1,194
2012-02-13,8,Monday,Spring,1,Morning Rush,417,4,413
2012-02-13,9,Monday,Spring,1,Morning Rush,205,7,198
2012-02-13,10,Monday,Spring,1,Mid-Day,71,1,70
2012-02-13,11,Monday,Spring,1,Mid-Day,90,5,85
2012-02-13,12,Monday,Spring,1,Mid-Day,118,7,111
2012-02-13,13,Monday,Spring,1,Mid-Day,140,11,129
2012-02-13,14,Monday,Spring,1,Mid-Day,135,10,125
2012-02-13,15,Monday,Spring,1,Mid-Day,155,10,145
2012-02-13,16,Monday,Spring,1,Evening Rush,211,5,206
2012-02-13,17,Monday,Spring,1,Evening Rush,407,8,399
2012-02-13,18,Monday,Spring,1,Evening Rush,405,6,399
2012-02-13,19,Monday,Spring,1,Evening Rush,263,7,256
2012-02-13,20,Monday,Spring,1,Night,214,4,210
2012-02-13,21,Monday,Spring,1,Night,147,2,145
2012-02-13,22,Monday,Spring,1,Night,102,3,99
2012-02-13,23,Monday,Spring,1,Night,36,2,34
2012-02-14,0,Tuesday,Spring,2,Early Morning,14,0,14
2012-02-14,1,Tuesday,Spring,2,Early Morning,6,0,6
2012-02-14,2,Tuesday,Spring,2,Early Morning,3,0,3
2012-02-14,3,Tuesday,Spring,2,Early Morning,3,0,3
2012-02-14,4,Tuesday,Spring,2,Early Morning,2,0,2
2012-02-14,5,Tuesday,Spring,2,Early Morning,22,2,20
2012-02-14,6,Tuesday,Spring,2,Morning Rush,90,1,89
2012-02-14,7,Tuesday,Spring,2,Morning Rush,280,4,276
2012-02-14,8,Tuesday,Spring,2,Morning Rush,513,3,510
2012-02-14,9,Tuesday,Spring,2,Morning Rush,262,6,256
2012-02-14,10,Tuesday,Spring,2,Mid-Day,98,8,90
2012-02-14,11,Tuesday,Spring,2,Mid-Day,112,5,107
2012-02-14,12,Tuesday,Spring,2,Mid-Day,172,10,162
2012-02-14,13,Tuesday,Spring,2,Mid-Day,173,6,167
2012-02-14,14,Tuesday,Spring,1,Mid-Day,124,13,111
2012-02-14,15,Tuesday,Spring,2,Mid-Day,145,7,138
2012-02-14,16,Tuesday,Spring,1,Evening Rush,266,15,251
2012-02-14,17,Tuesday,Spring,1,Evening Rush,523,19,504
2012-02-14,18,Tuesday,Spring,2,Evening Rush,406,8,398
2012-02-14,19,Tuesday,Spring,2,Evening Rush,281,11,270
2012-02-14,20,Tuesday,Spring,2,Night,184,6,178
2012-02-14,21,Tuesday,Spring,2,Night,109,4,105
2012-02-14,22,Tuesday,Spring,2,Night,77,5,72
2012-02-14,23,Tuesday,Spring,2,Night,57,2,55
2012-02-15,0,Wednesday,Spring,1,Early Morning,22,0,22
2012-02-15,1,Wednesday,Spring,1,Early Morning,5,0,5
2012-02-15,2,Wednesday,Spring,1,Early Morning,4,0,4
2012-02-15,3,Wednesday,Spring,1,Early Morning,3,0,3
2012-02-15,4,Wednesday,Spring,1,Early Morning,1,0,1
2012-02-15,5,Wednesday,Spring,1,Early Morning,25,0,25
2012-02-15,6,Wednesday,Spring,1,Morning Rush,95,3,92
2012-02-15,7,Wednesday,Spring,2,Morning Rush,321,3,318
2012-02-15,8,Wednesday,Spring,1,Morning Rush,515,7,508
2012-02-15,9,Wednesday,Spring,1,Morning Rush,231,5,226
2012-02-15,10,Wednesday,Spring,1,Mid-Day,120,12,108
2012-02-15,11,Wednesday,Spring,1,Mid-Day,138,13,125
2012-02-15,12,Wednesday,Spring,1,Mid-Day,163,11,152
2012-02-15,13,Wednesday,Spring,1,Mid-Day,170,11,159
2012-02-15,14,Wednesday,Spring,1,Mid-Day,134,6,128
2012-02-15,15,Wednesday,Spring,1,Mid-Day,171,7,164
2012-02-15,16,Wednesday,Spring,1,Evening Rush,231,9,222
2012-02-15,17,Wednesday,Spring,1,Evening Rush,487,17,470
2012-02-15,18,Wednesday,Spring,1,Evening Rush,468,9,459
2012-02-15,19,Wednesday,Spring,1,Evening Rush,311,9,302
2012-02-15,20,Wednesday,Spring,1,Night,211,4,207
2012-02-15,21,Wednesday,Spring,1,Night,178,8,170
2012-02-15,22,Wednesday,Spring,1,Night,107,3,104
2012-02-15,23,Wednesday,Spring,1,Night,58,4,54
2012-02-16,0,Thursday,Spring,2,Early Morning,23,1,22
2012-02-16,1,Thursday,Spring,2,Early Morning,5,0,5
2012-02-16,2,Thursday,Spring,2,Early Morning,7,1,6
2012-02-16,3,Thursday,Spring,2,Early Morning,1,0,1
2012-02-16,4,Thursday,Spring,3,Early Morning,3,0,3
2012-02-16,5,Thursday,Spring,2,Early Morning,20,0,20
2012-02-16,6,Thursday,Spring,2,Morning Rush,87,4,83
2012-02-16,7,Thursday,Spring,2,Morning Rush,288,3,285
2012-02-16,8,Thursday,Spring,2,Morning Rush,498,9,489
2012-02-16,9,Thursday,Spring,2,Morning Rush,202,3,199
2012-02-16,10,Thursday,Spring,3,Mid-Day,44,2,42
2012-02-16,11,Thursday,Spring,3,Mid-Day,71,2,69
2012-02-16,12,Thursday,Spring,3,Mid-Day,45,1,44
2012-02-16,13,Thursday,Spring,3,Mid-Day,64,2,62
2012-02-16,14,Thursday,Spring,3,Mid-Day,31,1,30
2012-02-16,15,Thursday,Spring,3,Mid-Day,53,3,50
2012-02-16,16,Thursday,Spring,3,Evening Rush,118,8,110
2012-02-16,17,Thursday,Spring,3,Evening Rush,289,8,281
2012-02-16,18,Thursday,Spring,3,Evening Rush,353,8,345
2012-02-16,19,Thursday,Spring,2,Evening Rush,258,4,254
2012-02-16,20,Thursday,Spring,2,Night,216,5,211
2012-02-16,21,Thursday,Spring,2,Night,145,3,142
2012-02-16,22,Thursday,Spring,2,Night,111,3,108
2012-02-16,23,Thursday,Spring,1,Night,73,3,70
2012-02-17,0,Friday,Spring,2,Early Morning,34,2,32
2012-02-17,1,Friday,Spring,2,Early Morning,18,2,16
2012-02-17,2,Friday,Spring,2,Early Morning,12,1,11
2012-02-17,3,Friday,Spring,2,Early Morning,1,0,1
2012-02-17,4,Friday,Spring,2,Early Morning,1,0,1
2012-02-17,5,Friday,Spring,2,Early Morning,16,0,16
2012-02-17,6,Friday,Spring,2,Morning Rush,71,1,70
2012-02-17,7,Friday,Spring,2,Morning Rush,226,4,222
2012-02-17,8,Friday,Spring,2,Morning Rush,520,4,516
2012-02-17,9,Friday,Spring,2,Morning Rush,283,8,275
2012-02-17,10,Friday,Spring,1,Mid-Day,116,13,103
2012-02-17,11,Friday,Spring,1,Mid-Day,142,9,133
2012-02-17,12,Friday,Spring,1,Mid-Day,198,21,177
2012-02-17,13,Friday,Spring,1,Mid-Day,205,34,171
2012-02-17,14,Friday,Spring,1,Mid-Day,170,33,137
2012-02-17,15,Friday,Spring,1,Mid-Day,221,41,180
2012-02-17,16,Friday,Spring,1,Evening Rush,307,56,251
2012-02-17,17,Friday,Spring,1,Evening Rush,465,36,429
2012-02-17,18,Friday,Spring,1,Evening Rush,377,15,362
2012-02-17,19,Friday,Spring,1,Evening Rush,282,16,266
2012-02-17,20,Friday,Spring,1,Night,171,13,158
2012-02-17,21,Friday,Spring,1,Night,129,15,114
2012-02-17,22,Friday,Spring,1,Night,107,15,92
2012-02-17,23,Friday,Spring,1,Night,82,10,72
2012-02-18,0,Saturday,Spring,1,Early Morning,86,5,81
2012-02-18,1,Saturday,Spring,1,Early Morning,45,7,38
2012-02-18,2,Saturday,Spring,1,Early Morning,45,6,39
2012-02-18,3,Saturday,Spring,1,Early Morning,18,3,15
2012-02-18,4,Saturday,Spring,1,Early Morning,7,3,4
2012-02-18,5,Saturday,Spring,1,Early Morning,1,0,1
2012-02-18,6,Saturday,Spring,1,Morning Rush,9,1,8
2012-02-18,7,Saturday,Spring,1,Morning Rush,41,8,33
2012-02-18,8,Saturday,Spring,1,Morning Rush,102,10,92
2012-02-18,9,Saturday,Spring,1,Morning Rush,138,22,116
2012-02-18,10,Saturday,Spring,1,Mid-Day,205,48,157
2012-02-18,11,Saturday,Spring,1,Mid-Day,286,102,184
2012-02-18,12,Saturday,Spring,1,Mid-Day,369,128,241
2012-02-18,13,Saturday,Spring,1,Mid-Day,384,165,219
2012-02-18,14,Saturday,Spring,1,Mid-Day,427,183,244
2012-02-18,15,Saturday,Spring,1,Mid-Day,499,229,270
2012-02-18,16,Saturday,Spring,1,Evening Rush,404,186,218
2012-02-18,17,Saturday,Spring,1,Evening Rush,364,142,222
2012-02-18,18,Saturday,Spring,1,Evening Rush,246,70,176
2012-02-18,19,Saturday,Spring,1,Evening Rush,188,38,150
2012-02-18,20,Saturday,Spring,1,Night,148,25,123
2012-02-18,21,Saturday,Spring,1,Night,114,25,89
2012-02-18,22,Saturday,Spring,1,Night,118,17,101
2012-02-18,23,Saturday,Spring,2,Night,74,12,62
2012-02-19,0,Sunday,Spring,2,Early Morning,74,9,65
2012-02-19,1,Sunday,Spring,2,Early Morning,72,10,62
2012-02-19,2,Sunday,Spring,2,Early Morning,48,3,45
2012-02-19,3,Sunday,Spring,2,Early Morning,15,3,12
2012-02-19,4,Sunday,Spring,2,Early Morning,3,0,3
2012-02-19,5,Sunday,Spring,2,Early Morning,2,1,1
2012-02-19,6,Sunday,Spring,1,Morning Rush,5,0,5
2012-02-19,7,Sunday,Spring,2,Morning Rush,14,2,12
2012-02-19,8,Sunday,Spring,2,Morning Rush,56,8,48
2012-02-19,9,Sunday,Spring,2,Morning Rush,93,20,73
2012-02-19,10,Sunday,Spring,2,Mid-Day,191,49,142
2012-02-19,11,Sunday,Spring,2,Mid-Day,226,82,144
2012-02-19,12,Sunday,Spring,2,Mid-Day,255,71,184
2012-02-19,13,Sunday,Spring,1,Mid-Day,261,64,197
2012-02-19,14,Sunday,Spring,2,Mid-Day,237,48,189
2012-02-19,15,Sunday,Spring,2,Mid-Day,253,85,168
2012-02-19,16,Sunday,Spring,2,Evening Rush,212,62,150
2012-02-19,17,Sunday,Spring,2,Evening Rush,157,22,135
2012-02-19,18,Sunday,Spring,2,Evening Rush,167,23,144
2012-02-19,19,Sunday,Spring,2,Evening Rush,119,18,101
2012-02-19,20,Sunday,Spring,2,Night,103,22,81
2012-02-19,21,Sunday,Spring,3,Night,36,3,33
2012-02-19,22,Sunday,Spring,3,Night,55,8,47
2012-02-19,23,Sunday,Spring,2,Night,35,5,30
2012-02-20,0,Monday,Spring,2,Early Morning,41,5,36
2012-02-20,1,Monday,Spring,2,Early Morning,15,3,12
2012-02-20,2,Monday,Spring,2,Early Morning,20,1,19
2012-02-20,3,Monday,Spring,2,Early Morning,8,0,8
2012-02-20,5,Monday,Spring,2,Early Morning,6,0,6
2012-02-20,6,Monday,Spring,1,Morning Rush,10,1,9
2012-02-20,7,Monday,Spring,2,Morning Rush,44,2,42
2012-02-20,8,Monday,Spring,1,Morning Rush,120,9,111
2012-02-20,9,Monday,Spring,1,Morning Rush,110,12,98
2012-02-20,10,Monday,Spring,1,Mid-Day,143,30,113
2012-02-20,11,Monday,Spring,1,Mid-Day,208,45,163
2012-02-20,12,Monday,Spring,1,Mid-Day,281,65,216
2012-02-20,13,Monday,Spring,1,Mid-Day,312,66,246
2012-02-20,14,Monday,Spring,1,Mid-Day,263,57,206
2012-02-20,15,Monday,Spring,1,Mid-Day,289,54,235
2012-02-20,16,Monday,Spring,1,Evening Rush,280,64,216
2012-02-20,17,Monday,Spring,1,Evening Rush,253,27,226
2012-02-20,18,Monday,Spring,1,Evening Rush,242,27,215
2012-02-20,19,Monday,Spring,1,Evening Rush,172,8,164
2012-02-20,20,Monday,Spring,1,Night,126,9,117
2012-02-20,21,Monday,Spring,1,Night,98,8,90
2012-02-20,22,Monday,Spring,1,Night,62,9,53
2012-02-20,23,Monday,Spring,1,Night,26,0,26
2012-02-21,0,Tuesday,Spring,1,Early Morning,12,1,11
2012-02-21,1,Tuesday,Spring,1,Early Morning,7,0,7
2012-02-21,2,Tuesday,Spring,1,Early Morning,3,0,3
2012-02-21,4,Tuesday,Spring,1,Early Morning,2,0,2
2012-02-21,5,Tuesday,Spring,1,Early Morning,15,0,15
2012-02-21,6,Tuesday,Spring,1,Morning Rush,86,3,83
2012-02-21,7,Tuesday,Spring,1,Morning Rush,279,6,273
2012-02-21,8,Tuesday,Spring,1,Morning Rush,464,5,459
2012-02-21,9,Tuesday,Spring,1,Morning Rush,217,6,211
2012-02-21,10,Tuesday,Spring,1,Mid-Day,85,8,77
2012-02-21,11,Tuesday,Spring,2,Mid-Day,86,5,81
2012-02-21,12,Tuesday,Spring,2,Mid-Day,163,16,147
2012-02-21,13,Tuesday,Spring,1,Mid-Day,131,8,123
2012-02-21,14,Tuesday,Spring,2,Mid-Day,124,16,108
2012-02-21,15,Tuesday,Spring,1,Mid-Day,160,23,137
2012-02-21,16,Tuesday,Spring,1,Evening Rush,254,14,240
2012-02-21,17,Tuesday,Spring,1,Evening Rush,432,21,411
2012-02-21,18,Tuesday,Spring,1,Evening Rush,425,11,414
2012-02-21,19,Tuesday,Spring,1,Evening Rush,304,5,299
2012-02-21,20,Tuesday,Spring,1,Night,227,4,223
2012-02-21,21,Tuesday,Spring,1,Night,154,7,147
2012-02-21,22,Tuesday,Spring,2,Night,100,3,97
2012-02-21,23,Tuesday,Spring,1,Night,47,1,46
2012-02-22,0,Wednesday,Spring,1,Early Morning,24,5,19
2012-02-22,1,Wednesday,Spring,1,Early Morning,7,3,4
2012-02-22,2,Wednesday,Spring,1,Early Morning,6,1,5
2012-02-22,3,Wednesday,Spring,2,Early Morning,4,1,3
2012-02-22,4,Wednesday,Spring,1,Early Morning,2,0,2
2012-02-22,5,Wednesday,Spring,1,Early Morning,30,1,29
2012-02-22,6,Wednesday,Spring,1,Morning Rush,90,5,85
2012-02-22,7,Wednesday,Spring,1,Morning Rush,302,10,292
2012-02-22,8,Wednesday,Spring,1,Morning Rush,576,9,567
2012-02-22,9,Wednesday,Spring,1,Morning Rush,252,11,241
2012-02-22,10,Wednesday,Spring,1,Mid-Day,139,17,122
2012-02-22,11,Wednesday,Spring,1,Mid-Day,171,22,149
2012-02-22,12,Wednesday,Spring,1,Mid-Day,207,21,186
2012-02-22,13,Wednesday,Spring,1,Mid-Day,190,15,175
2012-02-22,14,Wednesday,Spring,1,Mid-Day,177,35,142
2012-02-22,15,Wednesday,Spring,1,Mid-Day,195,34,161
2012-02-22,16,Wednesday,Spring,1,Evening Rush,298,30,268
2012-02-22,17,Wednesday,Spring,1,Evening Rush,529,43,486
2012-02-22,18,Wednesday,Spring,2,Evening Rush,525,42,483
2012-02-22,19,Wednesday,Spring,2,Evening Rush,327,22,305
2012-02-22,20,Wednesday,Spring,2,Night,274,25,249
2012-02-22,21,Wednesday,Spring,2,Night,239,19,220
2012-02-22,22,Wednesday,Spring,2,Night,147,18,129
2012-02-22,23,Wednesday,Spring,2,Night,62,5,57
2012-02-23,0,Thursday,Spring,2,Early Morning,42,12,30
2012-02-23,1,Thursday,Spring,2,Early Morning,15,3,12
2012-02-23,2,Thursday,Spring,2,Early Morning,9,5,4
2012-02-23,3,Thursday,Spring,3,Early Morning,6,2,4
2012-02-23,4,Thursday,Spring,1,Early Morning,1,0,1
2012-02-23,5,Thursday,Spring,1,Early Morning,32,2,30
2012-02-23,6,Thursday,Spring,1,Morning Rush,91,3,88
2012-02-23,7,Thursday,Spring,1,Morning Rush,326,9,317
2012-02-23,8,Thursday,Spring,1,Morning Rush,560,11,549
2012-02-23,9,Thursday,Spring,1,Morning Rush,242,14,228
2012-02-23,10,Thursday,Spring,1,Mid-Day,148,41,107
2012-02-23,11,Thursday,Spring,1,Mid-Day,182,54,128
2012-02-23,12,Thursday,Spring,1,Mid-Day,224,25,199
2012-02-23,13,Thursday,Spring,1,Mid-Day,218,30,188
2012-02-23,14,Thursday,Spring,1,Mid-Day,192,36,156
2012-02-23,15,Thursday,Spring,1,Mid-Day,217,46,171
2012-02-23,16,Thursday,Spring,1,Evening Rush,343,45,298
2012-02-23,17,Thursday,Spring,1,Evening Rush,610,49,561
2012-02-23,18,Thursday,Spring,1,Evening Rush,522,36,486
2012-02-23,19,Thursday,Spring,1,Evening Rush,369,20,349
2012-02-23,20,Thursday,Spring,1,Night,269,23,246
2012-02-23,21,Thursday,Spring,1,Night,222,17,205
2012-02-23,22,Thursday,Spring,1,Night,137,19,118
2012-02-23,23,Thursday,Spring,1,Night,85,14,71
2012-02-24,0,Friday,Spring,2,Early Morning,46,12,34
2012-02-24,1,Friday,Spring,1,Early Morning,18,3,15
2012-02-24,2,Friday,Spring,3,Early Morning,5,1,4
2012-02-24,3,Friday,Spring,1,Early Morning,5,0,5
2012-02-24,4,Friday,Spring,1,Early Morning,2,0,2
2012-02-24,5,Friday,Spring,2,Early Morning,26,1,25
2012-02-24,6,Friday,Spring,2,Morning Rush,82,2,80
2012-02-24,7,Friday,Spring,2,Morning Rush,272,7,265
2012-02-24,8,Friday,Spring,2,Morning Rush,469,17,452
2012-02-24,9,Friday,Spring,3,Morning Rush,244,15,229
2012-02-24,10,Friday,Spring,3,Mid-Day,141,22,119
2012-02-24,11,Friday,Spring,2,Mid-Day,163,27,136
2012-02-24,12,Friday,Spring,2,Mid-Day,228,27,201
2012-02-24,13,Friday,Spring,2,Mid-Day,183,30,153
2012-02-24,14,Friday,Spring,2,Mid-Day,31,5,26
2012-02-24,15,Friday,Spring,3,Mid-Day,94,11,83
2012-02-24,16,Friday,Spring,3,Evening Rush,178,12,166
2012-02-24,17,Friday,Spring,3,Evening Rush,256,14,242
2012-02-24,18,Friday,Spring,2,Evening Rush,300,11,289
2012-02-24,19,Friday,Spring,2,Evening Rush,233,6,227
2012-02-24,20,Friday,Spring,1,Night,167,8,159
2012-02-24,21,Friday,Spring,1,Night,152,1,151
2012-02-24,22,Friday,Spring,1,Night,106,4,102
2012-02-24,23,Friday,Spring,1,Night,86,10,76
2012-02-25,0,Saturday,Spring,1,Early Morning,61,5,56
2012-02-25,1,Saturday,Spring,1,Early Morning,46,4,42
2012-02-25,2,Saturday,Spring,1,Early Morning,38,1,37
2012-02-25,3,Saturday,Spring,1,Early Morning,7,0,7
2012-02-25,4,Saturday,Spring,1,Early Morning,2,0,2
2012-02-25,5,Saturday,Spring,2,Early Morning,3,0,3
2012-02-25,6,Saturday,Spring,2,Morning Rush,13,1,12
2012-02-25,7,Saturday,Spring,1,Morning Rush,23,3,20
2012-02-25,8,Saturday,Spring,1,Morning Rush,93,3,90
2012-02-25,9,Saturday,Spring,3,Morning Rush,122,15,107
2012-02-25,10,Saturday,Spring,1,Mid-Day,183,24,159
2012-02-25,11,Saturday,Spring,1,Mid-Day,210,23,187
2012-02-25,12,Saturday,Spring,1,Mid-Day,258,41,217
2012-02-25,13,Saturday,Spring,1,Mid-Day,226,48,178
2012-02-25,14,Saturday,Spring,1,Mid-Day,216,35,181
2012-02-25,15,Saturday,Spring,1,Mid-Day,232,21,211
2012-02-25,16,Saturday,Spring,1,Evening Rush,195,32,163
2012-02-25,17,Saturday,Spring,1,Evening Rush,159,16,143
2012-02-25,18,Saturday,Spring,1,Evening Rush,133,7,126
2012-02-25,19,Saturday,Spring,1,Evening Rush,149,12,137
2012-02-25,20,Saturday,Spring,1,Night,105,10,95
2012-02-25,21,Saturday,Spring,1,Night,85,5,80
2012-02-25,22,Saturday,Spring,1,Night,82,4,78
2012-02-25,23,Saturday,Spring,1,Night,91,7,84
2012-02-26,0,Sunday,Spring,1,Early Morning,70,7,63
2012-02-26,1,Sunday,Spring,1,Early Morning,55,5,50
2012-02-26,2,Sunday,Spring,1,Early Morning,42,5,37
2012-02-26,3,Sunday,Spring,1,Early Morning,21,0,21
2012-02-26,4,Sunday,Spring,1,Early Morning,6,1,5
2012-02-26,5,Sunday,Spring,1,Early Morning,5,0,5
2012-02-26,6,Sunday,Spring,1,Morning Rush,2,0,2
2012-02-26,7,Sunday,Spring,1,Morning Rush,22,2,20
2012-02-26,8,Sunday,Spring,1,Morning Rush,59,2,57
2012-02-26,9,Sunday,Spring,1,Morning Rush,87,11,76
2012-02-26,10,Sunday,Spring,1,Mid-Day,188,27,161
2012-02-26,11,Sunday,Spring,1,Mid-Day,227,43,184
2012-02-26,12,Sunday,Spring,1,Mid-Day,305,49,256
2012-02-26,13,Sunday,Spring,1,Mid-Day,325,58,267
2012-02-26,14,Sunday,Spring,1,Mid-Day,331,68,263
2012-02-26,15,Sunday,Spring,1,Mid-Day,353,72,281
2012-02-26,16,Sunday,Spring,1,Evening Rush,339,64,275
2012-02-26,17,Sunday,Spring,1,Evening Rush,287,46,241
2012-02-26,18,Sunday,Spring,1,Evening Rush,216,17,199
2012-02-26,19,Sunday,Spring,1,Evening Rush,143,13,130
2012-02-26,20,Sunday,Spring,1,Night,88,9,79
2012-02-26,21,Sunday,Spring,1,Night,83,8,75
2012-02-26,22,Sunday,Spring,1,Night,71,3,68
2012-02-26,23,Sunday,Spring,1,Night,64,5,59
2012-02-27,0,Monday,Spring,1,Early Morning,29,2,27
2012-02-27,1,Monday,Spring,1,Early Morning,6,0,6
2012-02-27,2,Monday,Spring,1,Early Morning,4,0,4
2012-02-27,3,Monday,Spring,1,Early Morning,2,0,2
2012-02-27,4,Monday,Spring,1,Early Morning,1,0,1
2012-02-27,5,Monday,Spring,1,Early Morning,16,0,16
2012-02-27,6,Monday,Spring,1,Morning Rush,90,1,89
2012-02-27,7,Monday,Spring,1,Morning Rush,280,2,278
2012-02-27,8,Monday,Spring,1,Morning Rush,528,14,514
2012-02-27,9,Monday,Spring,1,Morning Rush,230,11,219
2012-02-27,10,Monday,Spring,1,Mid-Day,104,16,88
2012-02-27,11,Monday,Spring,1,Mid-Day,103,11,92
2012-02-27,12,Monday,Spring,1,Mid-Day,177,13,164
2012-02-27,13,Monday,Spring,1,Mid-Day,182,23,159
2012-02-27,14,Monday,Spring,1,Mid-Day,158,24,134
2012-02-27,15,Monday,Spring,1,Mid-Day,174,24,150
2012-02-27,16,Monday,Spring,1,Evening Rush,286,20,266
2012-02-27,17,Monday,Spring,1,Evening Rush,529,26,503
2012-02-27,18,Monday,Spring,1,Evening Rush,527,10,517
2012-02-27,19,Monday,Spring,1,Evening Rush,334,16,318
2012-02-27,20,Monday,Spring,1,Night,219,11,208
2012-02-27,21,Monday,Spring,1,Night,195,14,181
2012-02-27,22,Monday,Spring,1,Night,92,9,83
2012-02-27,23,Monday,Spring,1,Night,56,6,50
2012-02-28,0,Tuesday,Spring,1,Early Morning,10,0,10
2012-02-28,1,Tuesday,Spring,1,Early Morning,6,0,6
2012-02-28,2,Tuesday,Spring,1,Early Morning,3,1,2
2012-02-28,3,Tuesday,Spring,1,Early Morning,6,0,6
2012-02-28,4,Tuesday,Spring,1,Early Morning,2,0,2
2012-02-28,5,Tuesday,Spring,1,Early Morning,21,1,20
2012-02-28,6,Tuesday,Spring,1,Morning Rush,101,1,100
2012-02-28,7,Tuesday,Spring,1,Morning Rush,325,12,313
2012-02-28,8,Tuesday,Spring,1,Morning Rush,559,16,543
2012-02-28,9,Tuesday,Spring,1,Morning Rush,232,7,225
2012-02-28,10,Tuesday,Spring,1,Mid-Day,132,14,118
2012-02-28,11,Tuesday,Spring,1,Mid-Day,163,8,155
2012-02-28,12,Tuesday,Spring,1,Mid-Day,183,19,164
2012-02-28,13,Tuesday,Spring,1,Mid-Day,190,16,174
2012-02-28,14,Tuesday,Spring,1,Mid-Day,134,13,121
2012-02-28,15,Tuesday,Spring,1,Mid-Day,166,17,149
2012-02-28,16,Tuesday,Spring,1,Evening Rush,287,17,270
2012-02-28,17,Tuesday,Spring,1,Evening Rush,530,33,497
2012-02-28,18,Tuesday,Spring,1,Evening Rush,449,17,432
2012-02-28,19,Tuesday,Spring,1,Evening Rush,306,15,291
2012-02-28,20,Tuesday,Spring,1,Night,204,2,202
2012-02-28,21,Tuesday,Spring,1,Night,188,10,178
2012-02-28,22,Tuesday,Spring,1,Night,101,6,95
2012-02-28,23,Tuesday,Spring,1,Night,65,4,61
2012-02-29,0,Wednesday,Spring,1,Early Morning,32,2,30
2012-02-29,1,Wednesday,Spring,1,Early Morning,6,0,6
2012-02-29,2,Wednesday,Spring,1,Early Morning,4,0,4
2012-02-29,3,Wednesday,Spring,1,Early Morning,2,0,2
2012-02-29,5,Wednesday,Spring,1,Early Morning,29,0,29
2012-02-29,6,Wednesday,Spring,2,Morning Rush,104,4,100
2012-02-29,7,Wednesday,Spring,2,Morning Rush,253,11,242
2012-02-29,8,Wednesday,Spring,2,Morning Rush,116,2,114
2012-02-29,9,Wednesday,Spring,3,Morning Rush,38,5,33
2012-02-29,10,Wednesday,Spring,3,Mid-Day,10,0,10
2012-02-29,11,Wednesday,Spring,3,Mid-Day,10,1,9
2012-02-29,12,Wednesday,Spring,3,Mid-Day,70,1,69
2012-02-29,13,Wednesday,Spring,2,Mid-Day,76,4,72
2012-02-29,14,Wednesday,Spring,2,Mid-Day,56,2,54
2012-02-29,15,Wednesday,Spring,2,Mid-Day,90,3,87
2012-02-29,16,Wednesday,Spring,3,Evening Rush,167,5,162
2012-02-29,17,Wednesday,Spring,2,Evening Rush,253,7,246
2012-02-29,18,Wednesday,Spring,3,Evening Rush,192,11,181
2012-02-29,19,Wednesday,Spring,2,Evening Rush,102,0,102
2012-02-29,20,Wednesday,Spring,3,Night,97,2,95
2012-02-29,21,Wednesday,Spring,3,Night,39,0,39
2012-02-29,22,Wednesday,Spring,3,Night,55,2,53
2012-02-29,23,Wednesday,Spring,3,Night,33,3,30
2012-03-01,0,Thursday,Spring,2,Early Morning,11,1,10
2012-03-01,1,Thursday,Spring,3,Early Morning,12,0,12
2012-03-01,2,Thursday,Spring,2,Early Morning,6,0,6
2012-03-01,3,Thursday,Spring,1,Early Morning,3,0,3
2012-03-01,4,Thursday,Spring,1,Early Morning,5,0,5
2012-03-01,5,Thursday,Spring,1,Early Morning,18,0,18
2012-03-01,6,Thursday,Spring,2,Morning Rush,109,2,107
2012-03-01,7,Thursday,Spring,2,Morning Rush,304,8,296
2012-03-01,8,Thursday,Spring,1,Morning Rush,594,15,579
2012-03-01,9,Thursday,Spring,1,Morning Rush,286,5,281
2012-03-01,10,Thursday,Spring,1,Mid-Day,133,11,122
2012-03-01,11,Thursday,Spring,1,Mid-Day,168,19,149
2012-03-01,12,Thursday,Spring,1,Mid-Day,220,16,204
2012-03-01,13,Thursday,Spring,1,Mid-Day,211,24,187
2012-03-01,14,Thursday,Spring,1,Mid-Day,211,37,174
2012-03-01,15,Thursday,Spring,1,Mid-Day,223,31,192
2012-03-01,16,Thursday,Spring,1,Evening Rush,361,38,323
2012-03-01,17,Thursday,Spring,1,Evening Rush,600,49,551
2012-03-01,18,Thursday,Spring,1,Evening Rush,525,27,498
2012-03-01,19,Thursday,Spring,1,Evening Rush,328,11,317
2012-03-01,20,Thursday,Spring,1,Night,254,12,242
2012-03-01,21,Thursday,Spring,1,Night,197,7,190
2012-03-01,22,Thursday,Spring,1,Night,126,3,123
2012-03-01,23,Thursday,Spring,1,Night,85,9,76
2012-03-02,0,Friday,Spring,1,Early Morning,46,1,45
2012-03-02,1,Friday,Spring,1,Early Morning,20,2,18
2012-03-02,2,Friday,Spring,1,Early Morning,6,2,4
2012-03-02,3,Friday,Spring,1,Early Morning,3,0,3
2012-03-02,4,Friday,Spring,1,Early Morning,2,0,2
2012-03-02,5,Friday,Spring,1,Early Morning,24,0,24
2012-03-02,6,Friday,Spring,1,Morning Rush,92,4,88
2012-03-02,7,Friday,Spring,1,Morning Rush,262,4,258
2012-03-02,8,Friday,Spring,1,Morning Rush,549,16,533
2012-03-02,9,Friday,Spring,1,Morning Rush,314,15,299
2012-03-02,10,Friday,Spring,1,Mid-Day,132,14,118
2012-03-02,11,Friday,Spring,1,Mid-Day,194,40,154
2012-03-02,12,Friday,Spring,1,Mid-Day,234,40,194
2012-03-02,13,Friday,Spring,1,Mid-Day,222,31,191
2012-03-02,14,Friday,Spring,2,Mid-Day,205,29,176
2012-03-02,15,Friday,Spring,2,Mid-Day,78,5,73
2012-03-02,16,Friday,Spring,3,Evening Rush,50,1,49
2012-03-02,17,Friday,Spring,3,Evening Rush,128,5,123
2012-03-02,18,Friday,Spring,3,Evening Rush,160,6,154
2012-03-02,19,Friday,Spring,3,Evening Rush,174,12,162
2012-03-02,20,Friday,Spring,2,Night,100,7,93
2012-03-02,21,Friday,Spring,3,Night,101,2,99
2012-03-02,22,Friday,Spring,2,Night,75,6,69
2012-03-02,23,Friday,Spring,2,Night,23,4,19
2012-03-03,0,Saturday,Spring,3,Early Morning,22,1,21
2012-03-03,1,Saturday,Spring,3,Early Morning,44,0,44
2012-03-03,2,Saturday,Spring,3,Early Morning,38,4,34
2012-03-03,3,Saturday,Spring,2,Early Morning,21,1,20
2012-03-03,4,Saturday,Spring,2,Early Morning,2,0,2
2012-03-03,5,Saturday,Spring,2,Early Morning,2,1,1
2012-03-03,6,Saturday,Spring,2,Morning Rush,7,1,6
2012-03-03,7,Saturday,Spring,2,Morning Rush,16,2,14
2012-03-03,8,Saturday,Spring,3,Morning Rush,48,2,46
2012-03-03,9,Saturday,Spring,3,Morning Rush,94,7,87
2012-03-03,10,Saturday,Spring,2,Mid-Day,168,31,137
2012-03-03,11,Saturday,Spring,2,Mid-Day,214,33,181
2012-03-03,12,Saturday,Spring,2,Mid-Day,299,47,252
2012-03-03,13,Saturday,Spring,1,Mid-Day,339,87,252
2012-03-03,14,Saturday,Spring,2,Mid-Day,430,151,279
2012-03-03,15,Saturday,Spring,1,Mid-Day,399,145,254
2012-03-03,16,Saturday,Spring,1,Evening Rush,467,167,300
2012-03-03,17,Saturday,Spring,1,Evening Rush,385,106,279
2012-03-03,18,Saturday,Spring,1,Evening Rush,303,53,250
2012-03-03,19,Saturday,Spring,1,Evening Rush,225,34,191
2012-03-03,20,Saturday,Spring,1,Night,149,28,121
2012-03-03,21,Saturday,Spring,1,Night,154,24,130
2012-03-03,22,Saturday,Spring,1,Night,134,19,115
2012-03-03,23,Saturday,Spring,1,Night,106,12,94
2012-03-04,0,Sunday,Spring,2,Early Morning,72,5,67
2012-03-04,1,Sunday,Spring,2,Early Morning,76,16,60
2012-03-04,2,Sunday,Spring,2,Early Morning,80,14,66
2012-03-04,3,Sunday,Spring,2,Early Morning,26,5,21
2012-03-04,4,Sunday,Spring,2,Early Morning,14,3,11
2012-03-04,5,Sunday,Spring,2,Early Morning,5,0,5
2012-03-04,6,Sunday,Spring,2,Morning Rush,5,0,5
2012-03-04,7,Sunday,Spring,2,Morning Rush,23,2,21
2012-03-04,8,Sunday,Spring,1,Morning Rush,66,12,54
2012-03-04,9,Sunday,Spring,1,Morning Rush,118,14,104
2012-03-04,10,Sunday,Spring,1,Mid-Day,192,31,161
2012-03-04,11,Sunday,Spring,1,Mid-Day,256,64,192
2012-03-04,12,Sunday,Spring,1,Mid-Day,327,71,256
2012-03-04,13,Sunday,Spring,1,Mid-Day,364,108,256
2012-03-04,14,Sunday,Spring,1,Mid-Day,332,106,226
2012-03-04,15,Sunday,Spring,1,Mid-Day,334,82,252
2012-03-04,16,Sunday,Spring,1,Evening Rush,299,68,231
2012-03-04,17,Sunday,Spring,1,Evening Rush,263,49,214
2012-03-04,18,Sunday,Spring,1,Evening Rush,184,20,164
2012-03-04,19,Sunday,Spring,1,Evening Rush,132,12,120
2012-03-04,20,Sunday,Spring,1,Night,88,8,80
2012-03-04,21,Sunday,Spring,1,Night,79,9,70
2012-03-04,22,Sunday,Spring,1,Night,62,9,53
2012-03-04,23,Sunday,Spring,1,Night,26,2,24
2012-03-05,0,Monday,Spring,1,Early Morning,17,2,15
2012-03-05,1,Monday,Spring,1,Early Morning,6,3,3
2012-03-05,2,Monday,Spring,1,Early Morning,4,1,3
2012-03-05,3,Monday,Spring,1,Early Morning,1,0,1
2012-03-05,4,Monday,Spring,1,Early Morning,1,0,1
2012-03-05,5,Monday,Spring,1,Early Morning,18,1,17
2012-03-05,6,Monday,Spring,1,Morning Rush,91,2,89
2012-03-05,7,Monday,Spring,1,Morning Rush,260,7,253
2012-03-05,8,Monday,Spring,1,Morning Rush,428,13,415
2012-03-05,9,Monday,Spring,2,Morning Rush,197,11,186
2012-03-05,10,Monday,Spring,2,Mid-Day,86,12,74
2012-03-05,11,Monday,Spring,2,Mid-Day,103,17,86
2012-03-05,12,Monday,Spring,2,Mid-Day,137,15,122
2012-03-05,13,Monday,Spring,2,Mid-Day,120,11,109
2012-03-05,14,Monday,Spring,2,Mid-Day,128,13,115
2012-03-05,15,Monday,Spring,2,Mid-Day,130,20,110
2012-03-05,16,Monday,Spring,1,Evening Rush,210,30,180
2012-03-05,17,Monday,Spring,3,Evening Rush,387,11,376
2012-03-05,18,Monday,Spring,3,Evening Rush,375,12,363
2012-03-05,19,Monday,Spring,1,Evening Rush,226,6,220
2012-03-05,20,Monday,Spring,1,Night,179,8,171
2012-03-05,21,Monday,Spring,1,Night,120,4,116
2012-03-05,22,Monday,Spring,1,Night,78,2,76
2012-03-05,23,Monday,Spring,1,Night,31,2,29
2012-03-06,0,Tuesday,Spring,1,Early Morning,8,0,8
2012-03-06,1,Tuesday,Spring,1,Early Morning,6,0,6
2012-03-06,2,Tuesday,Spring,1,Early Morning,4,0,4
2012-03-06,3,Tuesday,Spring,1,Early Morning,1,0,1
2012-03-06,4,Tuesday,Spring,1,Early Morning,3,0,3
2012-03-06,5,Tuesday,Spring,1,Early Morning,25,0,25
2012-03-06,6,Tuesday,Spring,1,Morning Rush,102,3,99
2012-03-06,7,Tuesday,Spring,1,Morning Rush,275,5,270
2012-03-06,8,Tuesday,Spring,1,Morning Rush,501,14,487
2012-03-06,9,Tuesday,Spring,1,Morning Rush,233,11,222
2012-03-06,10,Tuesday,Spring,1,Mid-Day,129,16,113
2012-03-06,11,Tuesday,Spring,1,Mid-Day,130,20,110
2012-03-06,12,Tuesday,Spring,1,Mid-Day,138,9,129
2012-03-06,13,Tuesday,Spring,1,Mid-Day,164,16,148
2012-03-06,14,Tuesday,Spring,1,Mid-Day,136,20,116
2012-03-06,15,Tuesday,Spring,1,Mid-Day,166,24,142
2012-03-06,16,Tuesday,Spring,1,Evening Rush,250,22,228
2012-03-06,17,Tuesday,Spring,1,Evening Rush,446,21,425
2012-03-06,18,Tuesday,Spring,1,Evening Rush,457,15,442
2012-03-06,19,Tuesday,Spring,1,Evening Rush,287,9,278
2012-03-06,20,Tuesday,Spring,1,Night,187,3,184
2012-03-06,21,Tuesday,Spring,1,Night,148,5,143
2012-03-06,22,Tuesday,Spring,1,Night,106,5,101
2012-03-06,23,Tuesday,Spring,1,Night,54,3,51
2012-03-07,0,Wednesday,Spring,1,Early Morning,15,3,12
2012-03-07,1,Wednesday,Spring,1,Early Morning,5,1,4
2012-03-07,2,Wednesday,Spring,1,Early Morning,4,0,4
2012-03-07,3,Wednesday,Spring,1,Early Morning,3,1,2
2012-03-07,4,Wednesday,Spring,1,Early Morning,3,0,3
2012-03-07,5,Wednesday,Spring,1,Early Morning,18,0,18
2012-03-07,6,Wednesday,Spring,1,Morning Rush,108,4,104
2012-03-07,7,Wednesday,Spring,1,Morning Rush,344,12,332
2012-03-07,8,Wednesday,Spring,1,Morning Rush,566,12,554
2012-03-07,9,Wednesday,Spring,1,Morning Rush,264,12,252
2012-03-07,10,Wednesday,Spring,1,Mid-Day,147,20,127
2012-03-07,11,Wednesday,Spring,1,Mid-Day,161,33,128
2012-03-07,12,Wednesday,Spring,1,Mid-Day,215,40,175
2012-03-07,13,Wednesday,Spring,1,Mid-Day,205,26,179
2012-03-07,14,Wednesday,Spring,1,Mid-Day,175,38,137
2012-03-07,15,Wednesday,Spring,1,Mid-Day,209,44,165
2012-03-07,16,Wednesday,Spring,1,Evening Rush,288,34,254
2012-03-07,17,Wednesday,Spring,1,Evening Rush,612,58,554
2012-03-07,18,Wednesday,Spring,1,Evening Rush,544,35,509
2012-03-07,19,Wednesday,Spring,1,Evening Rush,361,16,345
2012-03-07,20,Wednesday,Spring,1,Night,260,18,242
2012-03-07,21,Wednesday,Spring,1,Night,188,11,177
2012-03-07,22,Wednesday,Spring,1,Night,159,10,149
2012-03-07,23,Wednesday,Spring,1,Night,62,4,58
2012-03-08,0,Thursday,Spring,1,Early Morning,46,11,35
2012-03-08,1,Thursday,Spring,1,Early Morning,21,4,17
2012-03-08,2,Thursday,Spring,1,Early Morning,11,6,5
2012-03-08,3,Thursday,Spring,1,Early Morning,3,0,3
2012-03-08,4,Thursday,Spring,1,Early Morning,2,0,2
2012-03-08,5,Thursday,Spring,1,Early Morning,29,1,28
2012-03-08,6,Thursday,Spring,1,Morning Rush,109,4,105
2012-03-08,7,Thursday,Spring,1,Morning Rush,334,8,326
2012-03-08,8,Thursday,Spring,1,Morning Rush,585,12,573
2012-03-08,9,Thursday,Spring,1,Morning Rush,301,19,282
2012-03-08,10,Thursday,Spring,1,Mid-Day,138,19,119
2012-03-08,11,Thursday,Spring,2,Mid-Day,204,48,156
2012-03-08,12,Thursday,Spring,2,Mid-Day,251,27,224
2012-03-08,13,Thursday,Spring,2,Mid-Day,233,35,198
2012-03-08,14,Thursday,Spring,2,Mid-Day,203,48,155
2012-03-08,15,Thursday,Spring,1,Mid-Day,185,24,161
2012-03-08,16,Thursday,Spring,2,Evening Rush,342,37,305
2012-03-08,17,Thursday,Spring,1,Evening Rush,597,52,545
2012-03-08,18,Thursday,Spring,2,Evening Rush,590,45,545
2012-03-08,19,Thursday,Spring,2,Evening Rush,416,21,395
2012-03-08,20,Thursday,Spring,2,Night,302,20,282
2012-03-08,21,Thursday,Spring,1,Night,233,27,206
2012-03-08,22,Thursday,Spring,1,Night,153,12,141
2012-03-08,23,Thursday,Spring,2,Night,94,6,88
2012-03-09,0,Friday,Spring,2,Early Morning,54,3,51
2012-03-09,1,Friday,Spring,3,Early Morning,26,4,22
2012-03-09,2,Friday,Spring,3,Early Morning,11,2,9
2012-03-09,3,Friday,Spring,1,Early Morning,7,0,7
2012-03-09,4,Friday,Spring,3,Early Morning,1,0,1
2012-03-09,5,Friday,Spring,3,Early Morning,29,2,27
2012-03-09,6,Friday,Spring,2,Morning Rush,85,2,83
2012-03-09,7,Friday,Spring,2,Morning Rush,268,6,262
2012-03-09,8,Friday,Spring,2,Morning Rush,501,17,484
2012-03-09,9,Friday,Spring,2,Morning Rush,284,17,267
2012-03-09,10,Friday,Spring,2,Mid-Day,159,14,145
2012-03-09,11,Friday,Spring,2,Mid-Day,187,17,170
2012-03-09,12,Friday,Spring,1,Mid-Day,201,27,174
2012-03-09,13,Friday,Spring,2,Mid-Day,224,49,175
2012-03-09,14,Friday,Spring,1,Mid-Day,178,49,129
2012-03-09,15,Friday,Spring,1,Mid-Day,238,50,188
2012-03-09,16,Friday,Spring,1,Evening Rush,343,51,292
2012-03-09,17,Friday,Spring,1,Evening Rush,566,68,498
2012-03-09,18,Friday,Spring,1,Evening Rush,470,30,440
2012-03-09,19,Friday,Spring,1,Evening Rush,244,12,232
2012-03-09,20,Friday,Spring,1,Night,159,3,156
2012-03-09,21,Friday,Spring,1,Night,141,8,133
2012-03-09,22,Friday,Spring,1,Night,107,7,100
2012-03-09,23,Friday,Spring,1,Night,86,9,77
2012-03-10,0,Saturday,Spring,1,Early Morning,77,9,68
2012-03-10,1,Saturday,Spring,1,Early Morning,51,1,50
2012-03-10,2,Saturday,Spring,1,Early Morning,42,12,30
2012-03-10,3,Saturday,Spring,1,Early Morning,16,0,16
2012-03-10,4,Saturday,Spring,1,Early Morning,4,1,3
2012-03-10,5,Saturday,Spring,1,Early Morning,10,3,7
2012-03-10,6,Saturday,Spring,1,Morning Rush,12,1,11
2012-03-10,7,Saturday,Spring,1,Morning Rush,40,4,36
2012-03-10,8,Saturday,Spring,1,Morning Rush,111,15,96
2012-03-10,9,Saturday,Spring,1,Morning Rush,148,21,127
2012-03-10,10,Saturday,Spring,1,Mid-Day,223,47,176
2012-03-10,11,Saturday,Spring,1,Mid-Day,274,56,218
2012-03-10,12,Saturday,Spring,1,Mid-Day,329,88,241
2012-03-10,13,Saturday,Spring,1,Mid-Day,357,89,268
2012-03-10,14,Saturday,Spring,1,Mid-Day,379,117,262
2012-03-10,15,Saturday,Spring,1,Mid-Day,406,132,274
2012-03-10,16,Saturday,Spring,1,Evening Rush,390,115,275
2012-03-10,17,Saturday,Spring,1,Evening Rush,354,104,250
2012-03-10,18,Saturday,Spring,1,Evening Rush,297,67,230
2012-03-10,19,Saturday,Spring,1,Evening Rush,184,25,159
2012-03-10,20,Saturday,Spring,1,Night,121,20,101
2012-03-10,21,Saturday,Spring,1,Night,110,16,94
2012-03-10,22,Saturday,Spring,1,Night,100,19,81
2012-03-10,23,Saturday,Spring,1,Night,83,6,77
2012-03-11,0,Sunday,Spring,1,Early Morning,69,7,62
2012-03-11,1,Sunday,Spring,1,Early Morning,61,4,57
2012-03-11,3,Sunday,Spring,1,Early Morning,66,15,51
2012-03-11,4,Sunday,Spring,1,Early Morning,22,7,15
2012-03-11,5,Sunday,Spring,1,Early Morning,7,2,5
2012-03-11,6,Sunday,Spring,1,Morning Rush,10,2,8
2012-03-11,7,Sunday,Spring,1,Morning Rush,17,2,15
2012-03-11,8,Sunday,Spring,1,Morning Rush,72,4,68
2012-03-11,9,Sunday,Spring,1,Morning Rush,90,20,70
2012-03-11,10,Sunday,Spring,1,Mid-Day,218,71,147
2012-03-11,11,Sunday,Spring,1,Mid-Day,299,90,209
2012-03-11,12,Sunday,Spring,1,Mid-Day,410,146,264
2012-03-11,13,Sunday,Spring,1,Mid-Day,464,176,288
2012-03-11,14,Sunday,Spring,1,Mid-Day,501,212,289
2012-03-11,15,Sunday,Spring,1,Mid-Day,487,201,286
2012-03-11,16,Sunday,Spring,1,Evening Rush,509,208,301
2012-03-11,17,Sunday,Spring,1,Evening Rush,498,199,299
2012-03-11,18,Sunday,Spring,1,Evening Rush,389,133,256
2012-03-11,19,Sunday,Spring,1,Evening Rush,258,55,203
2012-03-11,20,Sunday,Spring,1,Night,171,42,129
2012-03-11,21,Sunday,Spring,1,Night,147,37,110
2012-03-11,22,Sunday,Spring,1,Night,94,13,81
2012-03-11,23,Sunday,Spring,1,Night,52,12,40
2012-03-12,0,Monday,Spring,1,Early Morning,24,4,20
2012-03-12,1,Monday,Spring,1,Early Morning,10,1,9
2012-03-12,2,Monday,Spring,1,Early Morning,9,4,5
2012-03-12,3,Monday,Spring,1,Early Morning,2,0,2
2012-03-12,4,Monday,Spring,1,Early Morning,3,0,3
2012-03-12,5,Monday,Spring,1,Early Morning,16,1,15
2012-03-12,6,Monday,Spring,1,Morning Rush,88,2,86
2012-03-12,7,Monday,Spring,1,Morning Rush,268,9,259
2012-03-12,8,Monday,Spring,1,Morning Rush,564,17,547
2012-03-12,9,Monday,Spring,1,Morning Rush,281,21,260
2012-03-12,10,Monday,Spring,1,Mid-Day,137,39,98
2012-03-12,11,Monday,Spring,1,Mid-Day,150,39,111
2012-03-12,12,Monday,Spring,1,Mid-Day,221,59,162
2012-03-12,13,Monday,Spring,2,Mid-Day,250,74,176
2012-03-12,14,Monday,Spring,2,Mid-Day,221,76,145
2012-03-12,15,Monday,Spring,1,Mid-Day,233,74,159
2012-03-12,16,Monday,Spring,1,Evening Rush,332,77,255
2012-03-12,17,Monday,Spring,2,Evening Rush,644,87,557
2012-03-12,18,Monday,Spring,2,Evening Rush,712,89,623
2012-03-12,19,Monday,Spring,2,Evening Rush,446,67,379
2012-03-12,20,Monday,Spring,2,Night,286,49,237
2012-03-12,21,Monday,Spring,2,Night,205,22,183
2012-03-12,22,Monday,Spring,2,Night,133,17,116
2012-03-12,23,Monday,Spring,1,Night,63,10,53
2012-03-13,0,Tuesday,Spring,2,Early Morning,26,5,21
2012-03-13,1,Tuesday,Spring,2,Early Morning,16,2,14
2012-03-13,2,Tuesday,Spring,3,Early Morning,1,0,1
2012-03-13,3,Tuesday,Spring,3,Early Morning,2,0,2
2012-03-13,4,Tuesday,Spring,2,Early Morning,1,0,1
2012-03-13,5,Tuesday,Spring,2,Early Morning,24,0,24
2012-03-13,6,Tuesday,Spring,3,Morning Rush,113,5,108
2012-03-13,7,Tuesday,Spring,2,Morning Rush,308,16,292
2012-03-13,8,Tuesday,Spring,1,Morning Rush,593,22,571
2012-03-13,9,Tuesday,Spring,1,Morning Rush,342,18,324
2012-03-13,10,Tuesday,Spring,1,Mid-Day,143,28,115
2012-03-13,11,Tuesday,Spring,1,Mid-Day,219,64,155
2012-03-13,12,Tuesday,Spring,1,Mid-Day,244,47,197
2012-03-13,13,Tuesday,Spring,1,Mid-Day,233,53,180
2012-03-13,14,Tuesday,Spring,1,Mid-Day,212,52,160
2012-03-13,15,Tuesday,Spring,1,Mid-Day,264,68,196
2012-03-13,16,Tuesday,Spring,1,Evening Rush,365,53,312
2012-03-13,17,Tuesday,Spring,1,Evening Rush,676,62,614
2012-03-13,18,Tuesday,Spring,1,Evening Rush,734,96,638
2012-03-13,19,Tuesday,Spring,1,Evening Rush,479,50,429
2012-03-13,20,Tuesday,Spring,1,Night,351,45,306
2012-03-13,21,Tuesday,Spring,1,Night,244,44,200
2012-03-13,22,Tuesday,Spring,1,Night,170,24,146
2012-03-13,23,Tuesday,Spring,1,Night,87,8,79
2012-03-14,0,Wednesday,Spring,1,Early Morning,39,5,34
2012-03-14,1,Wednesday,Spring,1,Early Morning,27,2,25
2012-03-14,2,Wednesday,Spring,1,Early Morning,2,0,2
2012-03-14,3,Wednesday,Spring,1,Early Morning,4,1,3
2012-03-14,4,Wednesday,Spring,1,Early Morning,5,1,4
2012-03-14,5,Wednesday,Spring,1,Early Morning,27,2,25
2012-03-14,6,Wednesday,Spring,1,Morning Rush,121,1,120
2012-03-14,7,Wednesday,Spring,1,Morning Rush,368,20,348
2012-03-14,8,Wednesday,Spring,1,Morning Rush,662,34,628
2012-03-14,9,Wednesday,Spring,1,Morning Rush,351,26,325
2012-03-14,10,Wednesday,Spring,1,Mid-Day,188,38,150
2012-03-14,11,Wednesday,Spring,2,Mid-Day,220,65,155
2012-03-14,12,Wednesday,Spring,2,Mid-Day,267,55,212
2012-03-14,13,Wednesday,Spring,1,Mid-Day,254,57,197
2012-03-14,14,Wednesday,Spring,1,Mid-Day,224,61,163
2012-03-14,15,Wednesday,Spring,1,Mid-Day,283,86,197
2012-03-14,16,Wednesday,Spring,1,Evening Rush,356,78,278
2012-03-14,17,Wednesday,Spring,1,Evening Rush,782,140,642
2012-03-14,18,Wednesday,Spring,1,Evening Rush,749,102,647
2012-03-14,19,Wednesday,Spring,1,Evening Rush,472,70,402
2012-03-14,20,Wednesday,Spring,1,Night,330,44,286
2012-03-14,21,Wednesday,Spring,1,Night,288,47,241
2012-03-14,22,Wednesday,Spring,1,Night,202,43,159
2012-03-14,23,Wednesday,Spring,1,Night,91,19,72
2012-03-15,0,Thursday,Spring,1,Early Morning,60,14,46
2012-03-15,1,Thursday,Spring,1,Early Morning,23,15,8
2012-03-15,2,Thursday,Spring,1,Early Morning,19,14,5
2012-03-15,3,Thursday,Spring,1,Early Morning,7,0,7
2012-03-15,4,Thursday,Spring,1,Early Morning,14,11,3
2012-03-15,5,Thursday,Spring,1,Early Morning,26,2,24
2012-03-15,6,Thursday,Spring,1,Morning Rush,117,4,113
2012-03-15,7,Thursday,Spring,1,Morning Rush,381,14,367
2012-03-15,8,Thursday,Spring,1,Morning Rush,623,21,602
2012-03-15,9,Thursday,Spring,1,Morning Rush,315,30,285
2012-03-15,10,Thursday,Spring,1,Mid-Day,164,34,130
2012-03-15,11,Thursday,Spring,1,Mid-Day,211,60,151
2012-03-15,12,Thursday,Spring,2,Mid-Day,265,59,206
2012-03-15,13,Thursday,Spring,2,Mid-Day,273,62,211
2012-03-15,14,Thursday,Spring,2,Mid-Day,258,81,177
2012-03-15,15,Thursday,Spring,1,Mid-Day,287,100,187
2012-03-15,16,Thursday,Spring,1,Evening Rush,426,95,331
2012-03-15,17,Thursday,Spring,1,Evening Rush,713,79,634
2012-03-15,18,Thursday,Spring,1,Evening Rush,746,98,648
2012-03-15,19,Thursday,Spring,2,Evening Rush,425,72,353
2012-03-15,20,Thursday,Spring,2,Night,330,60,270
2012-03-15,21,Thursday,Spring,1,Night,243,36,207
2012-03-15,22,Thursday,Spring,1,Night,169,32,137
2012-03-15,23,Thursday,Spring,1,Night,97,12,85
2012-03-16,0,Friday,Spring,1,Early Morning,57,8,49
2012-03-16,1,Friday,Spring,2,Early Morning,26,4,22
2012-03-16,2,Friday,Spring,2,Early Morning,4,0,4
2012-03-16,3,Friday,Spring,2,Early Morning,3,0,3
2012-03-16,4,Friday,Spring,2,Early Morning,3,0,3
2012-03-16,5,Friday,Spring,2,Early Morning,32,2,30
2012-03-16,6,Friday,Spring,2,Morning Rush,99,3,96
2012-03-16,7,Friday,Spring,2,Morning Rush,278,13,265
2012-03-16,8,Friday,Spring,2,Morning Rush,562,28,534
2012-03-16,9,Friday,Spring,2,Morning Rush,312,35,277
2012-03-16,10,Friday,Spring,2,Mid-Day,180,44,136
2012-03-16,11,Friday,Spring,2,Mid-Day,207,40,167
2012-03-16,12,Friday,Spring,2,Mid-Day,294,72,222
2012-03-16,13,Friday,Spring,2,Mid-Day,260,52,208
2012-03-16,14,Friday,Spring,2,Mid-Day,202,56,146
2012-03-16,15,Friday,Spring,3,Mid-Day,107,19,88
2012-03-16,16,Friday,Spring,3,Evening Rush,129,18,111
2012-03-16,17,Friday,Spring,3,Evening Rush,258,23,235
2012-03-16,18,Friday,Spring,3,Evening Rush,408,31,377
2012-03-16,19,Friday,Spring,2,Evening Rush,296,23,273
2012-03-16,20,Friday,Spring,1,Night,235,31,204
2012-03-16,21,Friday,Spring,2,Night,152,8,144
2012-03-16,22,Friday,Spring,2,Night,148,16,132
2012-03-16,23,Friday,Spring,2,Night,126,22,104
2012-03-17,0,Saturday,Spring,2,Early Morning,100,13,87
2012-03-17,1,Saturday,Spring,2,Early Morning,69,12,57
2012-03-17,2,Saturday,Spring,2,Early Morning,42,10,32
2012-03-17,3,Saturday,Spring,2,Early Morning,26,2,24
2012-03-17,4,Saturday,Spring,2,Early Morning,2,0,2
2012-03-17,5,Saturday,Spring,2,Early Morning,8,5,3
2012-03-17,6,Saturday,Spring,2,Morning Rush,30,1,29
2012-03-17,7,Saturday,Spring,2,Morning Rush,86,29,57
2012-03-17,8,Saturday,Spring,2,Morning Rush,218,63,155
2012-03-17,9,Saturday,Spring,2,Morning Rush,321,104,217
2012-03-17,10,Saturday,Spring,2,Mid-Day,443,140,303
2012-03-17,11,Saturday,Spring,2,Mid-Day,585,226,359
2012-03-17,12,Saturday,Spring,1,Mid-Day,651,286,365
2012-03-17,13,Saturday,Spring,1,Mid-Day,686,286,400
2012-03-17,14,Saturday,Spring,1,Mid-Day,690,352,338
2012-03-17,15,Saturday,Spring,1,Mid-Day,679,357,322
2012-03-17,16,Saturday,Spring,1,Evening Rush,685,367,318
2012-03-17,17,Saturday,Spring,1,Evening Rush,648,291,357
2012-03-17,18,Saturday,Spring,1,Evening Rush,560,221,339
2012-03-17,19,Saturday,Spring,1,Evening Rush,417,155,262
2012-03-17,20,Saturday,Spring,1,Night,271,89,182
2012-03-17,21,Saturday,Spring,1,Night,223,54,169
2012-03-17,22,Saturday,Spring,1,Night,211,58,153
2012-03-17,23,Saturday,Spring,1,Night,185,34,151
2012-03-18,0,Sunday,Spring,1,Early Morning,107,27,80
2012-03-18,1,Sunday,Spring,1,Early Morning,113,25,88
2012-03-18,2,Sunday,Spring,2,Early Morning,56,15,41
2012-03-18,3,Sunday,Spring,2,Early Morning,18,3,15
2012-03-18,4,Sunday,Spring,2,Early Morning,14,6,8
2012-03-18,5,Sunday,Spring,2,Early Morning,6,0,6
2012-03-18,6,Sunday,Spring,2,Morning Rush,11,2,9
2012-03-18,7,Sunday,Spring,3,Morning Rush,42,17,25
2012-03-18,8,Sunday,Spring,2,Morning Rush,96,25,71
2012-03-18,9,Sunday,Spring,2,Morning Rush,178,65,113
2012-03-18,10,Sunday,Spring,2,Mid-Day,351,139,212
2012-03-18,11,Sunday,Spring,2,Mid-Day,368,129,239
2012-03-18,12,Sunday,Spring,2,Mid-Day,503,222,281
2012-03-18,13,Sunday,Spring,2,Mid-Day,544,198,346
2012-03-18,14,Sunday,Spring,2,Mid-Day,521,218,303
2012-03-18,15,Sunday,Spring,1,Mid-Day,554,240,314
2012-03-18,16,Sunday,Spring,1,Evening Rush,541,229,312
2012-03-18,17,Sunday,Spring,1,Evening Rush,541,233,308
2012-03-18,18,Sunday,Spring,1,Evening Rush,459,165,294
2012-03-18,19,Sunday,Spring,1,Evening Rush,352,118,234
2012-03-18,20,Sunday,Spring,1,Night,198,59,139
2012-03-18,21,Sunday,Spring,1,Night,173,44,129
2012-03-18,22,Sunday,Spring,1,Night,100,21,79
2012-03-18,23,Sunday,Spring,1,Night,46,7,39
2012-03-19,0,Monday,Spring,1,Early Morning,23,4,19
2012-03-19,1,Monday,Spring,1,Early Morning,15,0,15
2012-03-19,2,Monday,Spring,1,Early Morning,8,1,7
2012-03-19,3,Monday,Spring,1,Early Morning,2,0,2
2012-03-19,4,Monday,Spring,1,Early Morning,3,0,3
2012-03-19,5,Monday,Spring,1,Early Morning,31,0,31
2012-03-19,6,Monday,Spring,1,Morning Rush,120,2,118
2012-03-19,7,Monday,Spring,1,Morning Rush,354,25,329
2012-03-19,8,Monday,Spring,1,Morning Rush,579,16,563
2012-03-19,9,Monday,Spring,1,Morning Rush,331,55,276
2012-03-19,10,Monday,Spring,1,Mid-Day,184,56,128
2012-03-19,11,Monday,Spring,1,Mid-Day,201,56,145
2012-03-19,12,Monday,Spring,1,Mid-Day,282,71,211
2012-03-19,13,Monday,Spring,1,Mid-Day,263,69,194
2012-03-19,14,Monday,Spring,2,Mid-Day,260,60,200
2012-03-19,15,Monday,Spring,1,Mid-Day,286,97,189
2012-03-19,16,Monday,Spring,1,Evening Rush,385,65,320
2012-03-19,17,Monday,Spring,1,Evening Rush,721,106,615
2012-03-19,18,Monday,Spring,1,Evening Rush,801,120,681
2012-03-19,19,Monday,Spring,1,Evening Rush,549,86,463
2012-03-19,20,Monday,Spring,1,Night,330,34,296
2012-03-19,21,Monday,Spring,1,Night,223,33,190
2012-03-19,22,Monday,Spring,2,Night,148,17,131
2012-03-19,23,Monday,Spring,2,Night,54,9,45
2012-03-20,0,Tuesday,Spring,2,Early Morning,29,5,24
2012-03-20,1,Tuesday,Spring,1,Early Morning,15,6,9
2012-03-20,2,Tuesday,Spring,1,Early Morning,10,2,8
2012-03-20,3,Tuesday,Spring,2,Early Morning,3,0,3
2012-03-20,4,Tuesday,Spring,2,Early Morning,6,0,6
2012-03-20,5,Tuesday,Spring,2,Early Morning,20,0,20
2012-03-20,6,Tuesday,Spring,2,Morning Rush,100,6,94
2012-03-20,7,Tuesday,Spring,3,Morning Rush,170,3,167
2012-03-20,8,Tuesday,Spring,2,Morning Rush,516,28,488
2012-03-20,9,Tuesday,Spring,2,Morning Rush,325,41,284
2012-03-20,10,Tuesday,Spring,1,Mid-Day,163,44,119
2012-03-20,11,Tuesday,Spring,1,Mid-Day,230,74,156
2012-03-20,12,Tuesday,Spring,1,Mid-Day,261,56,205
2012-03-20,13,Tuesday,Spring,1,Mid-Day,284,77,207
2012-03-20,14,Tuesday,Spring,2,Mid-Day,248,66,182
2012-03-20,15,Tuesday,Spring,2,Mid-Day,244,67,177
2012-03-20,16,Tuesday,Spring,1,Evening Rush,431,99,332
2012-03-20,17,Tuesday,Spring,1,Evening Rush,750,108,642
2012-03-20,18,Tuesday,Spring,1,Evening Rush,801,136,665
2012-03-20,19,Tuesday,Spring,1,Evening Rush,555,75,480
2012-03-20,20,Tuesday,Spring,1,Night,377,78,299
2012-03-20,21,Tuesday,Spring,1,Night,277,38,239
2012-03-20,22,Tuesday,Spring,1,Night,188,32,156
2012-03-20,23,Tuesday,Spring,1,Night,90,10,80
2012-03-21,0,Wednesday,Summer,1,Early Morning,33,4,29
2012-03-21,1,Wednesday,Summer,1,Early Morning,26,4,22
2012-03-21,2,Wednesday,Summer,1,Early Morning,10,2,8
2012-03-21,3,Wednesday,Summer,2,Early Morning,8,1,7
2012-03-21,4,Wednesday,Summer,2,Early Morning,4,0,4
2012-03-21,5,Wednesday,Summer,2,Early Morning,39,4,35
2012-03-21,6,Wednesday,Summer,2,Morning Rush,149,10,139
2012-03-21,7,Wednesday,Summer,3,Morning Rush,372,34,338
2012-03-21,8,Wednesday,Summer,3,Morning Rush,535,33,502
2012-03-21,9,Wednesday,Summer,2,Morning Rush,293,38,255
2012-03-21,10,Wednesday,Summer,2,Mid-Day,154,30,124
2012-03-21,11,Wednesday,Summer,2,Mid-Day,192,38,154
2012-03-21,12,Wednesday,Summer,2,Mid-Day,229,58,171
2012-03-21,13,Wednesday,Summer,2,Mid-Day,303,81,222
2012-03-21,14,Wednesday,Summer,2,Mid-Day,225,74,151
2012-03-21,15,Wednesday,Summer,2,Mid-Day,243,68,175
2012-03-21,16,Wednesday,Summer,1,Evening Rush,378,91,287
2012-03-21,17,Wednesday,Summer,1,Evening Rush,729,113,616
2012-03-21,18,Wednesday,Summer,1,Evening Rush,779,152,627
2012-03-21,19,Wednesday,Summer,1,Evening Rush,582,86,496
2012-03-21,20,Wednesday,Summer,1,Night,374,76,298
2012-03-21,21,Wednesday,Summer,1,Night,251,47,204
2012-03-21,22,Wednesday,Summer,1,Night,197,41,156
2012-03-21,23,Wednesday,Summer,1,Night,125,37,88
2012-03-22,0,Thursday,Summer,1,Early Morning,41,9,32
2012-03-22,1,Thursday,Summer,1,Early Morning,30,14,16
2012-03-22,2,Thursday,Summer,1,Early Morning,6,1,5
2012-03-22,3,Thursday,Summer,1,Early Morning,7,0,7
2012-03-22,4,Thursday,Summer,2,Early Morning,6,0,6
2012-03-22,5,Thursday,Summer,2,Early Morning,34,2,32
2012-03-22,6,Thursday,Summer,2,Morning Rush,136,10,126
2012-03-22,7,Thursday,Summer,2,Morning Rush,361,29,332
2012-03-22,8,Thursday,Summer,2,Morning Rush,649,51,598
2012-03-22,9,Thursday,Summer,2,Morning Rush,318,41,277
2012-03-22,10,Thursday,Summer,2,Mid-Day,142,32,110
2012-03-22,11,Thursday,Summer,2,Mid-Day,219,53,166
2012-03-22,12,Thursday,Summer,2,Mid-Day,272,48,224
2012-03-22,13,Thursday,Summer,1,Mid-Day,298,83,215
2012-03-22,14,Thursday,Summer,1,Mid-Day,257,96,161
2012-03-22,15,Thursday,Summer,1,Mid-Day,304,102,202
2012-03-22,16,Thursday,Summer,1,Evening Rush,425,125,300
2012-03-22,17,Thursday,Summer,1,Evening Rush,810,154,656
2012-03-22,18,Thursday,Summer,1,Evening Rush,801,147,654
2012-03-22,19,Thursday,Summer,1,Evening Rush,586,117,469
2012-03-22,20,Thursday,Summer,1,Night,424,64,360
2012-03-22,21,Thursday,Summer,1,Night,374,66,308
2012-03-22,22,Thursday,Summer,1,Night,220,56,164
2012-03-22,23,Thursday,Summer,1,Night,151,34,117
2012-03-23,0,Friday,Summer,1,Early Morning,95,30,65
2012-03-23,1,Friday,Summer,1,Early Morning,50,18,32
2012-03-23,2,Friday,Summer,1,Early Morning,32,12,20
2012-03-23,3,Friday,Summer,1,Early Morning,10,4,6
2012-03-23,4,Friday,Summer,2,Early Morning,3,0,3
2012-03-23,5,Friday,Summer,2,Early Morning,34,5,29
2012-03-23,6,Friday,Summer,2,Morning Rush,116,6,110
2012-03-23,7,Friday,Summer,2,Morning Rush,346,28,318
2012-03-23,8,Friday,Summer,2,Morning Rush,662,47,615
2012-03-23,9,Friday,Summer,2,Morning Rush,380,75,305
2012-03-23,10,Friday,Summer,2,Mid-Day,275,125,150
2012-03-23,11,Friday,Summer,2,Mid-Day,318,131,187
2012-03-23,12,Friday,Summer,2,Mid-Day,471,199,272
2012-03-23,13,Friday,Summer,2,Mid-Day,428,172,256
2012-03-23,14,Friday,Summer,2,Mid-Day,432,208,224
2012-03-23,15,Friday,Summer,2,Mid-Day,472,191,281
2012-03-23,16,Friday,Summer,2,Evening Rush,589,219,370
2012-03-23,17,Friday,Summer,2,Evening Rush,957,264,693
2012-03-23,18,Friday,Summer,1,Evening Rush,830,237,593
2012-03-23,19,Friday,Summer,1,Evening Rush,686,213,473
2012-03-23,20,Friday,Summer,1,Night,445,117,328
2012-03-23,21,Friday,Summer,1,Night,284,64,220
2012-03-23,22,Friday,Summer,1,Night,271,53,218
2012-03-23,23,Friday,Summer,1,Night,176,51,125
2012-03-24,0,Saturday,Summer,1,Early Morning,156,45,111
2012-03-24,1,Saturday,Summer,1,Early Morning,128,20,108
2012-03-24,2,Saturday,Summer,1,Early Morning,69,14,55
2012-03-24,3,Saturday,Summer,1,Early Morning,32,10,22
2012-03-24,4,Saturday,Summer,1,Early Morning,7,1,6
2012-03-24,5,Saturday,Summer,2,Early Morning,4,0,4
2012-03-24,6,Saturday,Summer,2,Morning Rush,28,4,24
2012-03-24,7,Saturday,Summer,2,Morning Rush,70,25,45
2012-03-24,8,Saturday,Summer,2,Morning Rush,154,41,113
2012-03-24,9,Saturday,Summer,2,Morning Rush,249,96,153
2012-03-24,10,Saturday,Summer,2,Mid-Day,345,148,197
2012-03-24,11,Saturday,Summer,2,Mid-Day,273,98,175
2012-03-24,12,Saturday,Summer,3,Mid-Day,183,61,122
2012-03-24,13,Saturday,Summer,3,Mid-Day,196,62,134
2012-03-24,14,Saturday,Summer,3,Mid-Day,223,63,160
2012-03-24,15,Saturday,Summer,3,Mid-Day,290,118,172
2012-03-24,16,Saturday,Summer,3,Evening Rush,177,49,128
2012-03-24,17,Saturday,Summer,3,Evening Rush,115,47,68
2012-03-24,18,Saturday,Summer,3,Evening Rush,137,27,110
2012-03-24,19,Saturday,Summer,3,Evening Rush,133,28,105
2012-03-24,20,Saturday,Summer,3,Night,111,31,80
2012-03-24,21,Saturday,Summer,3,Night,104,16,88
2012-03-24,22,Saturday,Summer,3,Night,83,12,71
2012-03-24,23,Saturday,Summer,2,Night,105,17,88
2012-03-25,0,Sunday,Summer,2,Early Morning,80,18,62
2012-03-25,1,Sunday,Summer,2,Early Morning,89,24,65
2012-03-25,2,Sunday,Summer,3,Early Morning,35,6,29
2012-03-25,3,Sunday,Summer,3,Early Morning,18,8,10
2012-03-25,4,Sunday,Summer,2,Early Morning,8,1,7
2012-03-25,5,Sunday,Summer,2,Early Morning,6,0,6
2012-03-25,6,Sunday,Summer,2,Morning Rush,18,5,13
2012-03-25,7,Sunday,Summer,2,Morning Rush,39,14,25
2012-03-25,8,Sunday,Summer,2,Morning Rush,89,21,68
2012-03-25,9,Sunday,Summer,2,Morning Rush,118,26,92
2012-03-25,10,Sunday,Summer,2,Mid-Day,250,78,172
2012-03-25,11,Sunday,Summer,2,Mid-Day,323,106,217
2012-03-25,12,Sunday,Summer,2,Mid-Day,360,122,238
2012-03-25,13,Sunday,Summer,2,Mid-Day,367,110,257
2012-03-25,14,Sunday,Summer,2,Mid-Day,414,123,291
2012-03-25,15,Sunday,Summer,2,Mid-Day,421,139,282
2012-03-25,16,Sunday,Summer,1,Evening Rush,492,153,339
2012-03-25,17,Sunday,Summer,1,Evening Rush,419,146,273
2012-03-25,18,Sunday,Summer,1,Evening Rush,491,202,289
2012-03-25,19,Sunday,Summer,1,Evening Rush,375,114,261
2012-03-25,20,Sunday,Summer,1,Night,259,63,196
2012-03-25,21,Sunday,Summer,1,Night,149,25,124
2012-03-25,22,Sunday,Summer,1,Night,111,19,92
2012-03-25,23,Sunday,Summer,1,Night,65,9,56
2012-03-26,0,Monday,Summer,2,Early Morning,33,10,23
2012-03-26,1,Monday,Summer,1,Early Morning,28,18,10
2012-03-26,2,Monday,Summer,1,Early Morning,20,14,6
2012-03-26,3,Monday,Summer,1,Early Morning,1,0,1
2012-03-26,4,Monday,Summer,1,Early Morning,4,0,4
2012-03-26,5,Monday,Summer,1,Early Morning,36,0,36
2012-03-26,6,Monday,Summer,1,Morning Rush,117,7,110
2012-03-26,7,Monday,Summer,1,Morning Rush,370,15,355
2012-03-26,8,Monday,Summer,1,Morning Rush,657,32,625
2012-03-26,9,Monday,Summer,1,Morning Rush,282,37,245
2012-03-26,10,Monday,Summer,1,Mid-Day,153,55,98
2012-03-26,11,Monday,Summer,1,Mid-Day,178,47,131
2012-03-26,12,Monday,Summer,1,Mid-Day,279,63,216
2012-03-26,13,Monday,Summer,1,Mid-Day,301,79,222
2012-03-26,14,Monday,Summer,1,Mid-Day,217,58,159
2012-03-26,15,Monday,Summer,1,Mid-Day,223,66,157
2012-03-26,16,Monday,Summer,1,Evening Rush,305,60,245
2012-03-26,17,Monday,Summer,1,Evening Rush,664,65,599
2012-03-26,18,Monday,Summer,1,Evening Rush,684,90,594
2012-03-26,19,Monday,Summer,1,Evening Rush,458,41,417
2012-03-26,20,Monday,Summer,1,Night,221,12,209
2012-03-26,21,Monday,Summer,1,Night,186,11,175
2012-03-26,22,Monday,Summer,1,Night,93,13,80
2012-03-26,23,Monday,Summer,1,Night,48,2,46
2012-03-27,0,Tuesday,Summer,1,Early Morning,10,1,9
2012-03-27,1,Tuesday,Summer,1,Early Morning,5,1,4
2012-03-27,2,Tuesday,Summer,1,Early Morning,7,1,6
2012-03-27,3,Tuesday,Summer,1,Early Morning,4,0,4
2012-03-27,4,Tuesday,Summer,1,Early Morning,3,0,3
2012-03-27,5,Tuesday,Summer,1,Early Morning,17,1,16
2012-03-27,6,Tuesday,Summer,1,Morning Rush,101,5,96
2012-03-27,7,Tuesday,Summer,1,Morning Rush,286,9,277
2012-03-27,8,Tuesday,Summer,1,Morning Rush,581,14,567
2012-03-27,9,Tuesday,Summer,1,Morning Rush,267,8,259
2012-03-27,10,Tuesday,Summer,1,Mid-Day,138,20,118
2012-03-27,11,Tuesday,Summer,1,Mid-Day,175,34,141
2012-03-27,12,Tuesday,Summer,1,Mid-Day,220,34,186
2012-03-27,13,Tuesday,Summer,1,Mid-Day,211,46,165
2012-03-27,14,Tuesday,Summer,1,Mid-Day,184,37,147
2012-03-27,15,Tuesday,Summer,1,Mid-Day,200,42,158
2012-03-27,16,Tuesday,Summer,1,Evening Rush,305,38,267
2012-03-27,17,Tuesday,Summer,1,Evening Rush,614,72,542
2012-03-27,18,Tuesday,Summer,1,Evening Rush,644,67,577
2012-03-27,19,Tuesday,Summer,1,Evening Rush,417,40,377
2012-03-27,20,Tuesday,Summer,1,Night,294,28,266
2012-03-27,21,Tuesday,Summer,1,Night,221,21,200
2012-03-27,22,Tuesday,Summer,1,Night,134,7,127
2012-03-27,23,Tuesday,Summer,1,Night,64,5,59
2012-03-28,0,Wednesday,Summer,1,Early Morning,30,1,29
2012-03-28,1,Wednesday,Summer,1,Early Morning,8,0,8
2012-03-28,2,Wednesday,Summer,1,Early Morning,3,0,3
2012-03-28,3,Wednesday,Summer,1,Early Morning,5,1,4
2012-03-28,4,Wednesday,Summer,1,Early Morning,1,1,0
2012-03-28,5,Wednesday,Summer,1,Early Morning,40,2,38
2012-03-28,6,Wednesday,Summer,1,Morning Rush,115,4,111
2012-03-28,7,Wednesday,Summer,1,Morning Rush,358,10,348
2012-03-28,8,Wednesday,Summer,1,Morning Rush,658,19,639
2012-03-28,9,Wednesday,Summer,1,Morning Rush,314,16,298
2012-03-28,10,Wednesday,Summer,1,Mid-Day,173,33,140
2012-03-28,11,Wednesday,Summer,1,Mid-Day,222,54,168
2012-03-28,12,Wednesday,Summer,2,Mid-Day,268,50,218
2012-03-28,13,Wednesday,Summer,1,Mid-Day,273,60,213
2012-03-28,14,Wednesday,Summer,1,Mid-Day,221,52,169
2012-03-28,15,Wednesday,Summer,2,Mid-Day,199,47,152
2012-03-28,16,Wednesday,Summer,3,Evening Rush,221,51,170
2012-03-28,17,Wednesday,Summer,1,Evening Rush,604,72,532
2012-03-28,18,Wednesday,Summer,1,Evening Rush,641,61,580
2012-03-28,19,Wednesday,Summer,1,Evening Rush,456,41,415
2012-03-28,20,Wednesday,Summer,1,Night,362,38,324
2012-03-28,21,Wednesday,Summer,1,Night,261,28,233
2012-03-28,22,Wednesday,Summer,1,Night,172,21,151
2012-03-28,23,Wednesday,Summer,1,Night,93,12,81
2012-03-29,0,Thursday,Summer,1,Early Morning,48,10,38
2012-03-29,1,Thursday,Summer,1,Early Morning,33,15,18
2012-03-29,2,Thursday,Summer,1,Early Morning,6,0,6
2012-03-29,3,Thursday,Summer,1,Early Morning,5,1,4
2012-03-29,4,Thursday,Summer,1,Early Morning,9,1,8
2012-03-29,5,Thursday,Summer,1,Early Morning,32,2,30
2012-03-29,6,Thursday,Summer,1,Morning Rush,117,3,114
2012-03-29,7,Thursday,Summer,1,Morning Rush,367,14,353
2012-03-29,8,Thursday,Summer,1,Morning Rush,654,26,628
2012-03-29,9,Thursday,Summer,1,Morning Rush,321,22,299
2012-03-29,10,Thursday,Summer,1,Mid-Day,166,42,124
2012-03-29,11,Thursday,Summer,1,Mid-Day,220,54,166
2012-03-29,12,Thursday,Summer,1,Mid-Day,292,64,228
2012-03-29,13,Thursday,Summer,1,Mid-Day,273,50,223
2012-03-29,14,Thursday,Summer,1,Mid-Day,238,63,175
2012-03-29,15,Thursday,Summer,1,Mid-Day,307,109,198
2012-03-29,16,Thursday,Summer,1,Evening Rush,388,67,321
2012-03-29,17,Thursday,Summer,1,Evening Rush,703,83,620
2012-03-29,18,Thursday,Summer,1,Evening Rush,681,83,598
2012-03-29,19,Thursday,Summer,1,Evening Rush,468,47,421
2012-03-29,20,Thursday,Summer,1,Night,335,34,301
2012-03-29,21,Thursday,Summer,1,Night,224,10,214
2012-03-29,22,Thursday,Summer,1,Night,152,17,135
2012-03-29,23,Thursday,Summer,1,Night,94,17,77
2012-03-30,0,Friday,Summer,1,Early Morning,59,10,49
2012-03-30,1,Friday,Summer,1,Early Morning,27,6,21
2012-03-30,2,Friday,Summer,1,Early Morning,7,1,6
2012-03-30,3,Friday,Summer,1,Early Morning,7,0,7
2012-03-30,4,Friday,Summer,1,Early Morning,2,1,1
2012-03-30,5,Friday,Summer,1,Early Morning,26,0,26
2012-03-30,6,Friday,Summer,1,Morning Rush,86,5,81
2012-03-30,7,Friday,Summer,1,Morning Rush,289,9,280
2012-03-30,8,Friday,Summer,1,Morning Rush,593,38,555
2012-03-30,9,Friday,Summer,1,Morning Rush,321,29,292
2012-03-30,10,Friday,Summer,2,Mid-Day,187,50,137
2012-03-30,11,Friday,Summer,2,Mid-Day,201,48,153
2012-03-30,12,Friday,Summer,2,Mid-Day,270,62,208
2012-03-30,13,Friday,Summer,3,Mid-Day,242,44,198
2012-03-30,14,Friday,Summer,3,Mid-Day,229,56,173
2012-03-30,15,Friday,Summer,3,Mid-Day,280,73,207
2012-03-30,16,Friday,Summer,3,Evening Rush,367,75,292
2012-03-30,17,Friday,Summer,2,Evening Rush,606,93,513
2012-03-30,18,Friday,Summer,1,Evening Rush,560,68,492
2012-03-30,19,Friday,Summer,1,Evening Rush,395,42,353
2012-03-30,20,Friday,Summer,1,Night,209,17,192
2012-03-30,21,Friday,Summer,1,Night,220,30,190
2012-03-30,22,Friday,Summer,1,Night,153,23,130
2012-03-30,23,Friday,Summer,1,Night,123,16,107
2012-03-31,0,Saturday,Summer,1,Early Morning,92,12,80
2012-03-31,1,Saturday,Summer,2,Early Morning,82,17,65
2012-03-31,2,Saturday,Summer,2,Early Morning,69,14,55
2012-03-31,3,Saturday,Summer,1,Early Morning,31,10,21
2012-03-31,4,Saturday,Summer,1,Early Morning,8,4,4
2012-03-31,5,Saturday,Summer,1,Early Morning,5,0,5
2012-03-31,6,Saturday,Summer,2,Morning Rush,23,7,16
2012-03-31,7,Saturday,Summer,2,Morning Rush,44,5,39
2012-03-31,8,Saturday,Summer,2,Morning Rush,145,19,126
2012-03-31,9,Saturday,Summer,2,Morning Rush,223,62,161
2012-03-31,10,Saturday,Summer,2,Mid-Day,313,108,205
2012-03-31,11,Saturday,Summer,1,Mid-Day,463,184,279
2012-03-31,12,Saturday,Summer,1,Mid-Day,621,263,358
2012-03-31,13,Saturday,Summer,1,Mid-Day,638,265,373
2012-03-31,14,Saturday,Summer,2,Mid-Day,551,240,311
2012-03-31,15,Saturday,Summer,2,Mid-Day,605,275,330
2012-03-31,16,Saturday,Summer,2,Evening Rush,535,243,292
2012-03-31,17,Saturday,Summer,1,Evening Rush,543,238,305
2012-03-31,18,Saturday,Summer,2,Evening Rush,341,102,239
2012-03-31,19,Saturday,Summer,1,Evening Rush,284,93,191
2012-03-31,20,Saturday,Summer,2,Night,208,52,156
2012-03-31,21,Saturday,Summer,2,Night,143,36,107
2012-03-31,22,Saturday,Summer,2,Night,156,40,116
2012-03-31,23,Saturday,Summer,2,Night,112,12,100
2012-04-01,0,Sunday,Summer,2,Early Morning,67,8,59
2012-04-01,1,Sunday,Summer,2,Early Morning,62,13,49
2012-04-01,2,Sunday,Summer,2,Early Morning,81,20,61
2012-04-01,3,Sunday,Summer,2,Early Morning,25,4,21
2012-04-01,4,Sunday,Summer,2,Early Morning,12,3,9
2012-04-01,5,Sunday,Summer,2,Early Morning,18,8,10
2012-04-01,6,Sunday,Summer,2,Morning Rush,97,9,88
2012-04-01,7,Sunday,Summer,2,Morning Rush,84,29,55
2012-04-01,8,Sunday,Summer,2,Morning Rush,125,37,88
2012-04-01,9,Sunday,Summer,2,Morning Rush,275,102,173
2012-04-01,10,Sunday,Summer,2,Mid-Day,360,132,228
2012-04-01,11,Sunday,Summer,2,Mid-Day,451,180,271
2012-04-01,12,Sunday,Summer,2,Mid-Day,445,187,258
2012-04-01,13,Sunday,Summer,2,Mid-Day,464,190,274
2012-04-01,14,Sunday,Summer,2,Mid-Day,561,283,278
2012-04-01,15,Sunday,Summer,1,Mid-Day,573,295,278
2012-04-01,16,Sunday,Summer,1,Evening Rush,511,236,275
2012-04-01,17,Sunday,Summer,1,Evening Rush,555,232,323
2012-04-01,18,Sunday,Summer,1,Evening Rush,432,153,279
2012-04-01,19,Sunday,Summer,1,Evening Rush,346,110,236
2012-04-01,20,Sunday,Summer,2,Night,232,66,166
2012-04-01,21,Sunday,Summer,2,Night,134,33,101
2012-04-01,22,Sunday,Summer,3,Night,68,7,61
2012-04-01,23,Sunday,Summer,3,Night,63,10,53
2012-04-02,0,Monday,Summer,3,Early Morning,17,6,11
2012-04-02,1,Monday,Summer,3,Early Morning,5,0,5
2012-04-02,2,Monday,Summer,3,Early Morning,5,2,3
2012-04-02,4,Monday,Summer,1,Early Morning,4,2,2
2012-04-02,5,Monday,Summer,1,Early Morning,24,2,22
2012-04-02,6,Monday,Summer,1,Morning Rush,110,6,104
2012-04-02,7,Monday,Summer,1,Morning Rush,306,12,294
2012-04-02,8,Monday,Summer,1,Morning Rush,589,36,553
2012-04-02,9,Monday,Summer,1,Morning Rush,317,52,265
2012-04-02,10,Monday,Summer,1,Mid-Day,204,85,119
2012-04-02,11,Monday,Summer,1,Mid-Day,209,81,128
2012-04-02,12,Monday,Summer,1,Mid-Day,281,100,181
2012-04-02,13,Monday,Summer,1,Mid-Day,281,97,184
2012-04-02,14,Monday,Summer,1,Mid-Day,268,127,141
2012-04-02,15,Monday,Summer,1,Mid-Day,324,132,192
2012-04-02,16,Monday,Summer,1,Evening Rush,395,104,291
2012-04-02,17,Monday,Summer,1,Evening Rush,729,128,601
2012-04-02,18,Monday,Summer,1,Evening Rush,618,75,543
2012-04-02,19,Monday,Summer,1,Evening Rush,494,66,428
2012-04-02,20,Monday,Summer,1,Night,329,48,281
2012-04-02,21,Monday,Summer,1,Night,238,24,214
2012-04-02,22,Monday,Summer,1,Night,123,17,106
2012-04-02,23,Monday,Summer,1,Night,66,6,60
2012-04-03,0,Tuesday,Summer,1,Early Morning,33,1,32
2012-04-03,1,Tuesday,Summer,1,Early Morning,11,0,11
2012-04-03,2,Tuesday,Summer,1,Early Morning,5,0,5
2012-04-03,3,Tuesday,Summer,1,Early Morning,3,0,3
2012-04-03,4,Tuesday,Summer,1,Early Morning,1,0,1
2012-04-03,5,Tuesday,Summer,1,Early Morning,27,2,25
2012-04-03,6,Tuesday,Summer,1,Morning Rush,100,2,98
2012-04-03,7,Tuesday,Summer,1,Morning Rush,341,14,327
2012-04-03,8,Tuesday,Summer,1,Morning Rush,604,27,577
2012-04-03,9,Tuesday,Summer,1,Morning Rush,408,54,354
2012-04-03,10,Tuesday,Summer,1,Mid-Day,219,77,142
2012-04-03,11,Tuesday,Summer,1,Mid-Day,258,91,167
2012-04-03,12,Tuesday,Summer,1,Mid-Day,331,101,230
2012-04-03,13,Tuesday,Summer,1,Mid-Day,345,120,225
2012-04-03,14,Tuesday,Summer,1,Mid-Day,311,120,191
2012-04-03,15,Tuesday,Summer,1,Mid-Day,316,109,207
2012-04-03,16,Tuesday,Summer,1,Evening Rush,485,145,340
2012-04-03,17,Tuesday,Summer,1,Evening Rush,757,123,634
2012-04-03,18,Tuesday,Summer,1,Evening Rush,800,139,661
2012-04-03,19,Tuesday,Summer,1,Evening Rush,558,98,460
2012-04-03,20,Tuesday,Summer,1,Night,379,54,325
2012-04-03,21,Tuesday,Summer,1,Night,243,33,210
2012-04-03,22,Tuesday,Summer,1,Night,158,25,133
2012-04-03,23,Tuesday,Summer,1,Night,79,13,66
2012-04-04,0,Wednesday,Summer,1,Early Morning,41,18,23
2012-04-04,1,Wednesday,Summer,1,Early Morning,11,0,11
2012-04-04,2,Wednesday,Summer,1,Early Morning,5,0,5
2012-04-04,3,Wednesday,Summer,1,Early Morning,3,0,3
2012-04-04,4,Wednesday,Summer,1,Early Morning,1,0,1
2012-04-04,5,Wednesday,Summer,1,Early Morning,27,0,27
2012-04-04,6,Wednesday,Summer,2,Morning Rush,126,6,120
2012-04-04,7,Wednesday,Summer,2,Morning Rush,366,12,354
2012-04-04,8,Wednesday,Summer,2,Morning Rush,684,31,653
2012-04-04,9,Wednesday,Summer,2,Morning Rush,363,47,316
2012-04-04,10,Wednesday,Summer,2,Mid-Day,167,68,99
2012-04-04,11,Wednesday,Summer,2,Mid-Day,213,61,152
2012-04-04,12,Wednesday,Summer,2,Mid-Day,283,73,210
2012-04-04,13,Wednesday,Summer,2,Mid-Day,251,70,181
2012-04-04,14,Wednesday,Summer,2,Mid-Day,258,82,176
2012-04-04,15,Wednesday,Summer,2,Mid-Day,268,86,182
2012-04-04,16,Wednesday,Summer,2,Evening Rush,390,86,304
2012-04-04,17,Wednesday,Summer,1,Evening Rush,744,99,645
2012-04-04,18,Wednesday,Summer,1,Evening Rush,759,113,646
2012-04-04,19,Wednesday,Summer,1,Evening Rush,494,75,419
2012-04-04,20,Wednesday,Summer,1,Night,372,39,333
2012-04-04,21,Wednesday,Summer,1,Night,298,43,255
2012-04-04,22,Wednesday,Summer,1,Night,181,30,151
2012-04-04,23,Wednesday,Summer,1,Night,131,19,112
2012-04-05,0,Thursday,Summer,1,Early Morning,45,12,33
2012-04-05,1,Thursday,Summer,1,Early Morning,13,4,9
2012-04-05,2,Thursday,Summer,1,Early Morning,18,7,11
2012-04-05,3,Thursday,Summer,1,Early Morning,5,0,5
2012-04-05,4,Thursday,Summer,1,Early Morning,1,0,1
2012-04-05,5,Thursday,Summer,1,Early Morning,29,1,28
2012-04-05,6,Thursday,Summer,1,Morning Rush,126,8,118
2012-04-05,7,Thursday,Summer,1,Morning Rush,354,15,339
2012-04-05,8,Thursday,Summer,1,Morning Rush,638,28,610
2012-04-05,9,Thursday,Summer,1,Morning Rush,351,61,290
2012-04-05,10,Thursday,Summer,1,Mid-Day,246,88,158
2012-04-05,11,Thursday,Summer,2,Mid-Day,268,109,159
2012-04-05,12,Thursday,Summer,1,Mid-Day,276,66,210
2012-04-05,13,Thursday,Summer,1,Mid-Day,291,89,202
2012-04-05,14,Thursday,Summer,1,Mid-Day,287,143,144
2012-04-05,15,Thursday,Summer,1,Mid-Day,269,98,171
2012-04-05,16,Thursday,Summer,1,Evening Rush,402,84,318
2012-04-05,17,Thursday,Summer,1,Evening Rush,822,145,677
2012-04-05,18,Thursday,Summer,1,Evening Rush,698,80,618
2012-04-05,19,Thursday,Summer,1,Evening Rush,487,64,423
2012-04-05,20,Thursday,Summer,1,Night,312,33,279
2012-04-05,21,Thursday,Summer,1,Night,234,25,209
2012-04-05,22,Thursday,Summer,1,Night,149,20,129
2012-04-05,23,Thursday,Summer,1,Night,136,12,124
2012-04-06,0,Friday,Summer,1,Early Morning,61,12,49
2012-04-06,1,Friday,Summer,1,Early Morning,38,10,28
2012-04-06,2,Friday,Summer,1,Early Morning,11,6,5
2012-04-06,3,Friday,Summer,1,Early Morning,8,3,5
2012-04-06,4,Friday,Summer,1,Early Morning,5,2,3
2012-04-06,5,Friday,Summer,1,Early Morning,23,0,23
2012-04-06,6,Friday,Summer,1,Morning Rush,80,0,80
2012-04-06,7,Friday,Summer,1,Morning Rush,246,15,231
2012-04-06,8,Friday,Summer,1,Morning Rush,508,19,489
2012-04-06,9,Friday,Summer,1,Morning Rush,376,58,318
2012-04-06,10,Friday,Summer,1,Mid-Day,238,81,157
2012-04-06,11,Friday,Summer,1,Mid-Day,291,112,179
2012-04-06,12,Friday,Summer,1,Mid-Day,337,113,224
2012-04-06,13,Friday,Summer,1,Mid-Day,411,173,238
2012-04-06,14,Friday,Summer,1,Mid-Day,490,240,250
2012-04-06,15,Friday,Summer,1,Mid-Day,537,218,319
2012-04-06,16,Friday,Summer,1,Evening Rush,536,184,352
2012-04-06,17,Friday,Summer,1,Evening Rush,655,172,483
2012-04-06,18,Friday,Summer,1,Evening Rush,484,104,380
2012-04-06,19,Friday,Summer,1,Evening Rush,412,115,297
2012-04-06,20,Friday,Summer,1,Night,252,61,191
2012-04-06,21,Friday,Summer,1,Night,190,54,136
2012-04-06,22,Friday,Summer,1,Night,158,34,124
2012-04-06,23,Friday,Summer,1,Night,113,21,92
2012-04-07,0,Saturday,Summer,1,Early Morning,94,9,85
2012-04-07,1,Saturday,Summer,1,Early Morning,69,9,60
2012-04-07,2,Saturday,Summer,1,Early Morning,36,11,25
2012-04-07,3,Saturday,Summer,1,Early Morning,28,7,21
2012-04-07,4,Saturday,Summer,1,Early Morning,7,3,4
2012-04-07,5,Saturday,Summer,1,Early Morning,2,0,2
2012-04-07,6,Saturday,Summer,1,Morning Rush,19,1,18
2012-04-07,7,Saturday,Summer,1,Morning Rush,54,14,40
2012-04-07,8,Saturday,Summer,1,Morning Rush,123,29,94
2012-04-07,9,Saturday,Summer,1,Morning Rush,276,103,173
2012-04-07,10,Saturday,Summer,1,Mid-Day,363,187,176
2012-04-07,11,Saturday,Summer,1,Mid-Day,495,251,244
2012-04-07,12,Saturday,Summer,1,Mid-Day,590,320,270
2012-04-07,13,Saturday,Summer,1,Mid-Day,643,355,288
2012-04-07,14,Saturday,Summer,1,Mid-Day,578,326,252
2012-04-07,15,Saturday,Summer,1,Mid-Day,626,321,305
2012-04-07,16,Saturday,Summer,1,Evening Rush,615,354,261
2012-04-07,17,Saturday,Summer,1,Evening Rush,567,299,268
2012-04-07,18,Saturday,Summer,1,Evening Rush,517,227,290
2012-04-07,19,Saturday,Summer,1,Evening Rush,413,170,243
2012-04-07,20,Saturday,Summer,1,Night,208,73,135
2012-04-07,21,Saturday,Summer,1,Night,234,75,159
2012-04-07,22,Saturday,Summer,1,Night,182,76,106
2012-04-07,23,Saturday,Summer,1,Night,118,32,86
2012-04-08,0,Sunday,Summer,1,Early Morning,85,21,64
2012-04-08,1,Sunday,Summer,1,Early Morning,64,14,50
2012-04-08,2,Sunday,Summer,1,Early Morning,32,7,25
2012-04-08,3,Sunday,Summer,1,Early Morning,26,8,18
2012-04-08,4,Sunday,Summer,1,Early Morning,7,0,7
2012-04-08,5,Sunday,Summer,1,Early Morning,12,4,8
2012-04-08,6,Sunday,Summer,1,Morning Rush,28,7,21
2012-04-08,7,Sunday,Summer,1,Morning Rush,37,12,25
2012-04-08,8,Sunday,Summer,1,Morning Rush,84,19,65
2012-04-08,9,Sunday,Summer,1,Morning Rush,179,71,108
2012-04-08,10,Sunday,Summer,1,Mid-Day,299,113,186
2012-04-08,11,Sunday,Summer,1,Mid-Day,404,195,209
2012-04-08,12,Sunday,Summer,1,Mid-Day,457,198,259
2012-04-08,13,Sunday,Summer,1,Mid-Day,483,229,254
2012-04-08,14,Sunday,Summer,1,Mid-Day,503,254,249
2012-04-08,15,Sunday,Summer,1,Mid-Day,486,260,226
2012-04-08,16,Sunday,Summer,1,Evening Rush,476,232,244
2012-04-08,17,Sunday,Summer,1,Evening Rush,411,185,226
2012-04-08,18,Sunday,Summer,1,Evening Rush,310,151,159
2012-04-08,19,Sunday,Summer,1,Evening Rush,276,89,187
2012-04-08,20,Sunday,Summer,1,Night,211,65,146
2012-04-08,21,Sunday,Summer,1,Night,130,53,77
2012-04-08,22,Sunday,Summer,1,Night,118,33,85
2012-04-08,23,Sunday,Summer,1,Night,51,10,41
2012-04-09,0,Monday,Summer,1,Early Morning,37,8,29
2012-04-09,1,Monday,Summer,1,Early Morning,16,4,12
2012-04-09,2,Monday,Summer,1,Early Morning,6,2,4
2012-04-09,3,Monday,Summer,1,Early Morning,3,0,3
2012-04-09,4,Monday,Summer,1,Early Morning,5,2,3
2012-04-09,5,Monday,Summer,1,Early Morning,32,2,30
2012-04-09,6,Monday,Summer,1,Morning Rush,111,3,108
2012-04-09,7,Monday,Summer,1,Morning Rush,331,11,320
2012-04-09,8,Monday,Summer,1,Morning Rush,617,22,595
2012-04-09,9,Monday,Summer,1,Morning Rush,286,50,236
2012-04-09,10,Monday,Summer,1,Mid-Day,178,65,113
2012-04-09,11,Monday,Summer,1,Mid-Day,223,96,127
2012-04-09,12,Monday,Summer,1,Mid-Day,280,94,186
2012-04-09,13,Monday,Summer,1,Mid-Day,281,108,173
2012-04-09,14,Monday,Summer,1,Mid-Day,218,66,152
2012-04-09,15,Monday,Summer,1,Mid-Day,255,82,173
2012-04-09,16,Monday,Summer,1,Evening Rush,391,81,310
2012-04-09,17,Monday,Summer,1,Evening Rush,632,67,565
2012-04-09,18,Monday,Summer,1,Evening Rush,646,60,586
2012-04-09,19,Monday,Summer,1,Evening Rush,421,35,386
2012-04-09,20,Monday,Summer,1,Night,276,21,255
2012-04-09,21,Monday,Summer,3,Night,165,14,151
2012-04-09,22,Monday,Summer,2,Night,108,6,102
2012-04-09,23,Monday,Summer,1,Night,67,6,61
2012-04-10,0,Tuesday,Summer,2,Early Morning,26,3,23
2012-04-10,1,Tuesday,Summer,1,Early Morning,9,0,9
2012-04-10,2,Tuesday,Summer,1,Early Morning,2,0,2
2012-04-10,3,Tuesday,Summer,1,Early Morning,2,0,2
2012-04-10,4,Tuesday,Summer,1,Early Morning,2,0,2
2012-04-10,5,Tuesday,Summer,1,Early Morning,24,0,24
2012-04-10,6,Tuesday,Summer,1,Morning Rush,103,3,100
2012-04-10,7,Tuesday,Summer,1,Morning Rush,384,16,368
2012-04-10,8,Tuesday,Summer,1,Morning Rush,692,22,670
2012-04-10,9,Tuesday,Summer,1,Morning Rush,319,16,303
2012-04-10,10,Tuesday,Summer,1,Mid-Day,181,49,132
2012-04-10,11,Tuesday,Summer,1,Mid-Day,239,78,161
2012-04-10,12,Tuesday,Summer,1,Mid-Day,259,75,184
2012-04-10,13,Tuesday,Summer,1,Mid-Day,283,81,202
2012-04-10,14,Tuesday,Summer,1,Mid-Day,224,75,149
2012-04-10,15,Tuesday,Summer,1,Mid-Day,203,46,157
2012-04-10,16,Tuesday,Summer,1,Evening Rush,362,66,296
2012-04-10,17,Tuesday,Summer,1,Evening Rush,744,88,656
2012-04-10,18,Tuesday,Summer,1,Evening Rush,704,78,626
2012-04-10,19,Tuesday,Summer,1,Evening Rush,479,51,428
2012-04-10,20,Tuesday,Summer,1,Night,282,34,248
2012-04-10,21,Tuesday,Summer,1,Night,206,15,191
2012-04-10,22,Tuesday,Summer,1,Night,127,9,118
2012-04-10,23,Tuesday,Summer,1,Night,62,14,48
2012-04-11,0,Wednesday,Summer,1,Early Morning,30,8,22
2012-04-11,1,Wednesday,Summer,1,Early Morning,12,3,9
2012-04-11,2,Wednesday,Summer,1,Early Morning,2,0,2
2012-04-11,3,Wednesday,Summer,1,Early Morning,2,0,2
2012-04-11,5,Wednesday,Summer,1,Early Morning,27,1,26
2012-04-11,6,Wednesday,Summer,1,Morning Rush,106,3,103
2012-04-11,7,Wednesday,Summer,1,Morning Rush,321,18,303
2012-04-11,8,Wednesday,Summer,1,Morning Rush,595,14,581
2012-04-11,9,Wednesday,Summer,2,Morning Rush,302,20,282
2012-04-11,10,Wednesday,Summer,2,Mid-Day,153,26,127
2012-04-11,11,Wednesday,Summer,2,Mid-Day,180,38,142
2012-04-11,12,Wednesday,Summer,2,Mid-Day,182,35,147
2012-04-11,13,Wednesday,Summer,2,Mid-Day,163,16,147
2012-04-11,14,Wednesday,Summer,1,Mid-Day,135,34,101
2012-04-11,15,Wednesday,Summer,3,Mid-Day,202,50,152
2012-04-11,16,Wednesday,Summer,1,Evening Rush,307,51,256
2012-04-11,17,Wednesday,Summer,1,Evening Rush,579,52,527
2012-04-11,18,Wednesday,Summer,3,Evening Rush,585,39,546
2012-04-11,19,Wednesday,Summer,1,Evening Rush,384,28,356
2012-04-11,20,Wednesday,Summer,1,Night,235,22,213
2012-04-11,21,Wednesday,Summer,1,Night,165,11,154
2012-04-11,22,Wednesday,Summer,1,Night,134,4,130
2012-04-11,23,Wednesday,Summer,1,Night,61,9,52
2012-04-12,0,Thursday,Summer,1,Early Morning,23,1,22
2012-04-12,1,Thursday,Summer,1,Early Morning,9,2,7
2012-04-12,2,Thursday,Summer,1,Early Morning,4,0,4
2012-04-12,3,Thursday,Summer,1,Early Morning,5,2,3
2012-04-12,4,Thursday,Summer,1,Early Morning,1,0,1
2012-04-12,5,Thursday,Summer,1,Early Morning,21,0,21
2012-04-12,6,Thursday,Summer,1,Morning Rush,96,2,94
2012-04-12,7,Thursday,Summer,1,Morning Rush,306,12,294
2012-04-12,8,Thursday,Summer,1,Morning Rush,624,20,604
2012-04-12,9,Thursday,Summer,1,Morning Rush,287,16,271
2012-04-12,10,Thursday,Summer,1,Mid-Day,141,38,103
2012-04-12,11,Thursday,Summer,1,Mid-Day,224,50,174
2012-04-12,12,Thursday,Summer,1,Mid-Day,259,60,199
2012-04-12,13,Thursday,Summer,1,Mid-Day,203,55,148
2012-04-12,14,Thursday,Summer,1,Mid-Day,224,74,150
2012-04-12,15,Thursday,Summer,1,Mid-Day,211,42,169
2012-04-12,16,Thursday,Summer,1,Evening Rush,353,54,299
2012-04-12,17,Thursday,Summer,1,Evening Rush,656,60,596
2012-04-12,18,Thursday,Summer,1,Evening Rush,610,63,547
2012-04-12,19,Thursday,Summer,1,Evening Rush,433,50,383
2012-04-12,20,Thursday,Summer,1,Night,280,26,254
2012-04-12,21,Thursday,Summer,1,Night,187,13,174
2012-04-12,22,Thursday,Summer,1,Night,158,15,143
2012-04-12,23,Thursday,Summer,1,Night,94,8,86
2012-04-13,0,Friday,Summer,1,Early Morning,55,14,41
2012-04-13,1,Friday,Summer,1,Early Morning,30,2,28
2012-04-13,2,Friday,Summer,1,Early Morning,11,6,5
2012-04-13,3,Friday,Summer,1,Early Morning,11,3,8
2012-04-13,4,Friday,Summer,2,Early Morning,5,1,4
2012-04-13,5,Friday,Summer,2,Early Morning,21,2,19
2012-04-13,6,Friday,Summer,1,Morning Rush,84,0,84
2012-04-13,7,Friday,Summer,1,Morning Rush,296,13,283
2012-04-13,8,Friday,Summer,1,Morning Rush,563,24,539
2012-04-13,9,Friday,Summer,1,Morning Rush,330,36,294
2012-04-13,10,Friday,Summer,1,Mid-Day,192,59,133
2012-04-13,11,Friday,Summer,1,Mid-Day,233,75,158
2012-04-13,12,Friday,Summer,1,Mid-Day,322,104,218
2012-04-13,13,Friday,Summer,1,Mid-Day,358,112,246
2012-04-13,14,Friday,Summer,1,Mid-Day,348,125,223
2012-04-13,15,Friday,Summer,1,Mid-Day,352,115,237
2012-04-13,16,Friday,Summer,1,Evening Rush,463,113,350
2012-04-13,17,Friday,Summer,1,Evening Rush,738,117,621
2012-04-13,18,Friday,Summer,1,Evening Rush,671,107,564
2012-04-13,19,Friday,Summer,1,Evening Rush,427,75,352
2012-04-13,20,Friday,Summer,1,Night,286,44,242
2012-04-13,21,Friday,Summer,1,Night,189,36,153
2012-04-13,22,Friday,Summer,1,Night,215,34,181
2012-04-13,23,Friday,Summer,1,Night,198,35,163
2012-04-14,0,Saturday,Summer,1,Early Morning,96,11,85
2012-04-14,1,Saturday,Summer,1,Early Morning,70,10,60
2012-04-14,2,Saturday,Summer,1,Early Morning,56,3,53
2012-04-14,3,Saturday,Summer,1,Early Morning,32,6,26
2012-04-14,4,Saturday,Summer,1,Early Morning,14,5,9
2012-04-14,5,Saturday,Summer,1,Early Morning,7,2,5
2012-04-14,6,Saturday,Summer,1,Morning Rush,21,2,19
2012-04-14,7,Saturday,Summer,1,Morning Rush,64,8,56
2012-04-14,8,Saturday,Summer,1,Morning Rush,160,24,136
2012-04-14,9,Saturday,Summer,1,Morning Rush,265,59,206
2012-04-14,10,Saturday,Summer,1,Mid-Day,406,139,267
2012-04-14,11,Saturday,Summer,1,Mid-Day,564,207,357
2012-04-14,12,Saturday,Summer,1,Mid-Day,678,274,404
2012-04-14,13,Saturday,Summer,1,Mid-Day,678,308,370
2012-04-14,14,Saturday,Summer,2,Mid-Day,660,288,372
2012-04-14,15,Saturday,Summer,2,Mid-Day,658,311,347
2012-04-14,16,Saturday,Summer,2,Evening Rush,582,253,329
2012-04-14,17,Saturday,Summer,2,Evening Rush,560,251,309
2012-04-14,18,Saturday,Summer,2,Evening Rush,481,197,284
2012-04-14,19,Saturday,Summer,2,Evening Rush,459,163,296
2012-04-14,20,Saturday,Summer,2,Night,321,112,209
2012-04-14,21,Saturday,Summer,2,Night,220,53,167
2012-04-14,22,Saturday,Summer,2,Night,212,64,148
2012-04-14,23,Saturday,Summer,2,Night,196,45,151
2012-04-15,0,Sunday,Summer,2,Early Morning,124,30,94
2012-04-15,1,Sunday,Summer,2,Early Morning,106,17,89
2012-04-15,2,Sunday,Summer,2,Early Morning,74,20,54
2012-04-15,3,Sunday,Summer,2,Early Morning,45,18,27
2012-04-15,4,Sunday,Summer,2,Early Morning,12,2,10
2012-04-15,5,Sunday,Summer,1,Early Morning,10,4,6
2012-04-15,6,Sunday,Summer,1,Morning Rush,16,5,11
2012-04-15,7,Sunday,Summer,1,Morning Rush,46,16,30
2012-04-15,8,Sunday,Summer,1,Morning Rush,97,33,64
2012-04-15,9,Sunday,Summer,1,Morning Rush,251,97,154
2012-04-15,10,Sunday,Summer,1,Mid-Day,421,186,235
2012-04-15,11,Sunday,Summer,1,Mid-Day,528,227,301
2012-04-15,12,Sunday,Summer,1,Mid-Day,635,275,360
2012-04-15,13,Sunday,Summer,1,Mid-Day,681,298,383
2012-04-15,14,Sunday,Summer,1,Mid-Day,628,282,346
2012-04-15,15,Sunday,Summer,1,Mid-Day,617,266,351
2012-04-15,16,Sunday,Summer,1,Evening Rush,616,286,330
2012-04-15,17,Sunday,Summer,1,Evening Rush,623,262,361
2012-04-15,18,Sunday,Summer,1,Evening Rush,479,184,295
2012-04-15,19,Sunday,Summer,1,Evening Rush,379,114,265
2012-04-15,20,Sunday,Summer,1,Night,291,86,205
2012-04-15,21,Sunday,Summer,1,Night,229,76,153
2012-04-15,22,Sunday,Summer,1,Night,134,37,97
2012-04-15,23,Sunday,Summer,1,Night,90,25,65
2012-04-16,0,Monday,Summer,1,Early Morning,41,15,26
2012-04-16,1,Monday,Summer,1,Early Morning,28,7,21
2012-04-16,2,Monday,Summer,1,Early Morning,14,5,9
2012-04-16,3,Monday,Summer,1,Early Morning,8,3,5
2012-04-16,4,Monday,Summer,1,Early Morning,6,0,6
2012-04-16,5,Monday,Summer,1,Early Morning,38,4,34
2012-04-16,6,Monday,Summer,1,Morning Rush,133,10,123
2012-04-16,7,Monday,Summer,1,Morning Rush,387,20,367
2012-04-16,8,Monday,Summer,2,Morning Rush,597,48,549
2012-04-16,9,Monday,Summer,1,Morning Rush,297,59,238
2012-04-16,10,Monday,Summer,1,Mid-Day,224,75,149
2012-04-16,11,Monday,Summer,1,Mid-Day,251,115,136
2012-04-16,12,Monday,Summer,1,Mid-Day,271,75,196
2012-04-16,13,Monday,Summer,1,Mid-Day,263,79,184
2012-04-16,14,Monday,Summer,1,Mid-Day,288,105,183
2012-04-16,15,Monday,Summer,1,Mid-Day,275,81,194
2012-04-16,16,Monday,Summer,1,Evening Rush,358,92,266
2012-04-16,17,Monday,Summer,1,Evening Rush,712,111,601
2012-04-16,18,Monday,Summer,1,Evening Rush,676,87,589
2012-04-16,19,Monday,Summer,1,Evening Rush,522,61,461
2012-04-16,20,Monday,Summer,1,Night,375,48,327
2012-04-16,21,Monday,Summer,1,Night,271,39,232
2012-04-16,22,Monday,Summer,1,Night,214,35,179
2012-04-16,23,Monday,Summer,1,Night,121,24,97
2012-04-17,0,Tuesday,Summer,1,Early Morning,43,10,33
2012-04-17,1,Tuesday,Summer,1,Early Morning,11,6,5
2012-04-17,2,Tuesday,Summer,1,Early Morning,4,1,3
2012-04-17,3,Tuesday,Summer,1,Early Morning,6,0,6
2012-04-17,4,Tuesday,Summer,1,Early Morning,9,3,6
2012-04-17,5,Tuesday,Summer,1,Early Morning,30,1,29
2012-04-17,6,Tuesday,Summer,1,Morning Rush,144,8,136
2012-04-17,7,Tuesday,Summer,1,Morning Rush,461,18,443
2012-04-17,8,Tuesday,Summer,1,Morning Rush,673,42,631
2012-04-17,9,Tuesday,Summer,1,Morning Rush,400,71,329
2012-04-17,10,Tuesday,Summer,1,Mid-Day,217,52,165
2012-04-17,11,Tuesday,Summer,1,Mid-Day,239,65,174
2012-04-17,12,Tuesday,Summer,1,Mid-Day,244,65,179
2012-04-17,13,Tuesday,Summer,1,Mid-Day,239,52,187
2012-04-17,14,Tuesday,Summer,1,Mid-Day,257,59,198
2012-04-17,15,Tuesday,Summer,1,Mid-Day,308,91,217
2012-04-17,16,Tuesday,Summer,1,Evening Rush,370,50,320
2012-04-17,17,Tuesday,Summer,1,Evening Rush,781,108,673
2012-04-17,18,Tuesday,Summer,1,Evening Rush,775,105,670
2012-04-17,19,Tuesday,Summer,1,Evening Rush,537,73,464
2012-04-17,20,Tuesday,Summer,1,Night,402,44,358
2012-04-17,21,Tuesday,Summer,1,Night,297,37,260
2012-04-17,22,Tuesday,Summer,1,Night,162,18,144
2012-04-17,23,Tuesday,Summer,1,Night,82,10,72
2012-04-18,0,Wednesday,Summer,1,Early Morning,38,3,35
2012-04-18,1,Wednesday,Summer,1,Early Morning,14,1,13
2012-04-18,2,Wednesday,Summer,2,Early Morning,9,1,8
2012-04-18,3,Wednesday,Summer,2,Early Morning,6,0,6
2012-04-18,4,Wednesday,Summer,2,Early Morning,7,0,7
2012-04-18,5,Wednesday,Summer,2,Early Morning,34,0,34
2012-04-18,6,Wednesday,Summer,2,Morning Rush,134,6,128
2012-04-18,7,Wednesday,Summer,2,Morning Rush,418,10,408
2012-04-18,8,Wednesday,Summer,3,Morning Rush,576,25,551
2012-04-18,9,Wednesday,Summer,3,Morning Rush,265,20,245
2012-04-18,10,Wednesday,Summer,3,Mid-Day,147,31,116
2012-04-18,11,Wednesday,Summer,3,Mid-Day,119,14,105
2012-04-18,12,Wednesday,Summer,3,Mid-Day,110,15,95
2012-04-18,13,Wednesday,Summer,3,Mid-Day,64,13,51
2012-04-18,14,Wednesday,Summer,3,Mid-Day,51,8,43
2012-04-18,15,Wednesday,Summer,3,Mid-Day,98,10,88
2012-04-18,16,Wednesday,Summer,2,Evening Rush,235,36,199
2012-04-18,17,Wednesday,Summer,2,Evening Rush,488,46,442
2012-04-18,18,Wednesday,Summer,2,Evening Rush,505,27,478
2012-04-18,19,Wednesday,Summer,2,Evening Rush,368,26,342
2012-04-18,20,Wednesday,Summer,2,Night,260,8,252
2012-04-18,21,Wednesday,Summer,2,Night,189,24,165
2012-04-18,22,Wednesday,Summer,2,Night,162,9,153
2012-04-18,23,Wednesday,Summer,2,Night,70,14,56
2012-04-19,0,Thursday,Summer,3,Early Morning,25,5,20
2012-04-19,1,Thursday,Summer,3,Early Morning,13,2,11
2012-04-19,2,Thursday,Summer,2,Early Morning,6,2,4
2012-04-19,3,Thursday,Summer,2,Early Morning,4,1,3
2012-04-19,4,Thursday,Summer,2,Early Morning,4,0,4
2012-04-19,5,Thursday,Summer,1,Early Morning,30,0,30
2012-04-19,6,Thursday,Summer,2,Morning Rush,120,4,116
2012-04-19,7,Thursday,Summer,2,Morning Rush,406,15,391
2012-04-19,8,Thursday,Summer,2,Morning Rush,677,26,651
2012-04-19,9,Thursday,Summer,2,Morning Rush,301,31,270
2012-04-19,10,Thursday,Summer,1,Mid-Day,189,46,143
2012-04-19,11,Thursday,Summer,1,Mid-Day,229,46,183
2012-04-19,12,Thursday,Summer,1,Mid-Day,264,51,213
2012-04-19,13,Thursday,Summer,1,Mid-Day,238,52,186
2012-04-19,14,Thursday,Summer,1,Mid-Day,237,54,183
2012-04-19,15,Thursday,Summer,1,Mid-Day,262,66,196
2012-04-19,16,Thursday,Summer,1,Evening Rush,387,63,324
2012-04-19,17,Thursday,Summer,1,Evening Rush,748,85,663
2012-04-19,18,Thursday,Summer,1,Evening Rush,776,99,677
2012-04-19,19,Thursday,Summer,1,Evening Rush,586,70,516
2012-04-19,20,Thursday,Summer,1,Night,404,52,352
2012-04-19,21,Thursday,Summer,1,Night,267,27,240
2012-04-19,22,Thursday,Summer,1,Night,248,29,219
2012-04-19,23,Thursday,Summer,1,Night,144,20,124
2012-04-20,0,Friday,Summer,1,Early Morning,64,5,59
2012-04-20,1,Friday,Summer,1,Early Morning,25,3,22
2012-04-20,2,Friday,Summer,1,Early Morning,21,3,18
2012-04-20,3,Friday,Summer,1,Early Morning,10,1,9
2012-04-20,4,Friday,Summer,1,Early Morning,3,0,3
2012-04-20,5,Friday,Summer,1,Early Morning,25,1,24
2012-04-20,6,Friday,Summer,1,Morning Rush,113,8,105
2012-04-20,7,Friday,Summer,1,Morning Rush,359,9,350
2012-04-20,8,Friday,Summer,1,Morning Rush,700,32,668
2012-04-20,9,Friday,Summer,1,Morning Rush,359,30,329
2012-04-20,10,Friday,Summer,1,Mid-Day,237,67,170
2012-04-20,11,Friday,Summer,1,Mid-Day,254,64,190
2012-04-20,12,Friday,Summer,1,Mid-Day,362,102,260
2012-04-20,13,Friday,Summer,1,Mid-Day,381,105,276
2012-04-20,14,Friday,Summer,1,Mid-Day,394,156,238
2012-04-20,15,Friday,Summer,1,Mid-Day,407,145,262
2012-04-20,16,Friday,Summer,1,Evening Rush,580,151,429
2012-04-20,17,Friday,Summer,1,Evening Rush,819,122,697
2012-04-20,18,Friday,Summer,1,Evening Rush,668,110,558
2012-04-20,19,Friday,Summer,1,Evening Rush,492,82,410
2012-04-20,20,Friday,Summer,1,Night,341,52,289
2012-04-20,21,Friday,Summer,1,Night,287,35,252
2012-04-20,22,Friday,Summer,1,Night,202,26,176
2012-04-20,23,Friday,Summer,1,Night,187,31,156
2012-04-21,0,Saturday,Summer,1,Early Morning,142,31,111
2012-04-21,1,Saturday,Summer,1,Early Morning,88,24,64
2012-04-21,2,Saturday,Summer,1,Early Morning,81,12,69
2012-04-21,3,Saturday,Summer,1,Early Morning,29,4,25
2012-04-21,4,Saturday,Summer,1,Early Morning,9,0,9
2012-04-21,5,Saturday,Summer,1,Early Morning,1,0,1
2012-04-21,6,Saturday,Summer,1,Morning Rush,31,10,21
2012-04-21,7,Saturday,Summer,1,Morning Rush,76,21,55
2012-04-21,8,Saturday,Summer,1,Morning Rush,201,52,149
2012-04-21,9,Saturday,Summer,1,Morning Rush,331,115,216
2012-04-21,10,Saturday,Summer,1,Mid-Day,482,183,299
2012-04-21,11,Saturday,Summer,1,Mid-Day,608,260,348
2012-04-21,12,Saturday,Summer,1,Mid-Day,640,262,378
2012-04-21,13,Saturday,Summer,1,Mid-Day,649,291,358
2012-04-21,14,Saturday,Summer,1,Mid-Day,609,278,331
2012-04-21,15,Saturday,Summer,1,Mid-Day,628,267,361
2012-04-21,16,Saturday,Summer,1,Evening Rush,639,267,372
2012-04-21,17,Saturday,Summer,2,Evening Rush,568,259,309
2012-04-21,18,Saturday,Summer,2,Evening Rush,416,133,283
2012-04-21,19,Saturday,Summer,3,Evening Rush,54,9,45
2012-04-21,20,Saturday,Summer,3,Night,39,5,34
2012-04-21,21,Saturday,Summer,3,Night,102,20,82
2012-04-21,22,Saturday,Summer,1,Night,110,20,90
2012-04-21,23,Saturday,Summer,2,Night,91,18,73
2012-04-22,0,Sunday,Summer,2,Early Morning,117,32,85
2012-04-22,1,Sunday,Summer,2,Early Morning,73,10,63
2012-04-22,2,Sunday,Summer,1,Early Morning,56,7,49
2012-04-22,3,Sunday,Summer,2,Early Morning,40,7,33
2012-04-22,4,Sunday,Summer,2,Early Morning,7,0,7
2012-04-22,5,Sunday,Summer,2,Early Morning,6,0,6
2012-04-22,6,Sunday,Summer,2,Morning Rush,12,6,6
2012-04-22,7,Sunday,Summer,3,Morning Rush,24,2,22
2012-04-22,8,Sunday,Summer,3,Morning Rush,51,8,43
2012-04-22,9,Sunday,Summer,3,Morning Rush,79,8,71
2012-04-22,10,Sunday,Summer,3,Mid-Day,68,11,57
2012-04-22,11,Sunday,Summer,3,Mid-Day,77,7,70
2012-04-22,12,Sunday,Summer,3,Mid-Day,61,5,56
2012-04-22,13,Sunday,Summer,3,Mid-Day,52,5,47
2012-04-22,14,Sunday,Summer,3,Mid-Day,53,3,50
2012-04-22,15,Sunday,Summer,3,Mid-Day,38,0,38
2012-04-22,16,Sunday,Summer,3,Evening Rush,36,4,32
2012-04-22,17,Sunday,Summer,3,Evening Rush,27,2,25
2012-04-22,18,Sunday,Summer,3,Evening Rush,39,1,38
2012-04-22,19,Sunday,Summer,3,Evening Rush,35,1,34
2012-04-22,20,Sunday,Summer,3,Night,35,1,34
2012-04-22,21,Sunday,Summer,3,Night,11,0,11
2012-04-22,22,Sunday,Summer,3,Night,13,0,13
2012-04-22,23,Sunday,Summer,3,Night,17,0,17
2012-04-23,0,Monday,Summer,3,Early Morning,6,0,6
2012-04-23,1,Monday,Summer,3,Early Morning,2,1,1
2012-04-23,2,Monday,Summer,2,Early Morning,4,1,3
2012-04-23,3,Monday,Summer,2,Early Morning,1,0,1
2012-04-23,4,Monday,Summer,3,Early Morning,3,0,3
2012-04-23,5,Monday,Summer,3,Early Morning,14,0,14
2012-04-23,6,Monday,Summer,2,Morning Rush,45,2,43
2012-04-23,7,Monday,Summer,3,Morning Rush,207,1,206
2012-04-23,8,Monday,Summer,2,Morning Rush,482,11,471
2012-04-23,9,Monday,Summer,2,Morning Rush,272,17,255
2012-04-23,10,Monday,Summer,2,Mid-Day,100,12,88
2012-04-23,11,Monday,Summer,2,Mid-Day,101,10,91
2012-04-23,12,Monday,Summer,3,Mid-Day,129,12,117
2012-04-23,13,Monday,Summer,3,Mid-Day,107,9,98
2012-04-23,14,Monday,Summer,3,Mid-Day,114,12,102
2012-04-23,15,Monday,Summer,2,Mid-Day,112,11,101
2012-04-23,16,Monday,Summer,3,Evening Rush,103,10,93
2012-04-23,17,Monday,Summer,3,Evening Rush,232,13,219
2012-04-23,18,Monday,Summer,3,Evening Rush,379,10,369
2012-04-23,19,Monday,Summer,2,Evening Rush,298,11,287
2012-04-23,20,Monday,Summer,2,Night,203,17,186
2012-04-23,21,Monday,Summer,2,Night,152,7,145
2012-04-23,22,Monday,Summer,1,Night,89,18,71
2012-04-23,23,Monday,Summer,1,Night,59,10,49
2012-04-24,0,Tuesday,Summer,2,Early Morning,13,0,13
2012-04-24,1,Tuesday,Summer,2,Early Morning,7,1,6
2012-04-24,2,Tuesday,Summer,1,Early Morning,3,0,3
2012-04-24,3,Tuesday,Summer,1,Early Morning,2,0,2
2012-04-24,4,Tuesday,Summer,1,Early Morning,3,0,3
2012-04-24,5,Tuesday,Summer,1,Early Morning,22,0,22
2012-04-24,6,Tuesday,Summer,1,Morning Rush,120,3,117
2012-04-24,7,Tuesday,Summer,1,Morning Rush,390,3,387
2012-04-24,8,Tuesday,Summer,1,Morning Rush,611,12,599
2012-04-24,9,Tuesday,Summer,1,Morning Rush,308,6,302
2012-04-24,10,Tuesday,Summer,1,Mid-Day,162,33,129
2012-04-24,11,Tuesday,Summer,1,Mid-Day,184,27,157
2012-04-24,12,Tuesday,Summer,1,Mid-Day,224,36,188
2012-04-24,13,Tuesday,Summer,1,Mid-Day,224,35,189
2012-04-24,14,Tuesday,Summer,1,Mid-Day,216,50,166
2012-04-24,15,Tuesday,Summer,1,Mid-Day,236,60,176
2012-04-24,16,Tuesday,Summer,1,Evening Rush,362,54,308
2012-04-24,17,Tuesday,Summer,1,Evening Rush,691,72,619
2012-04-24,18,Tuesday,Summer,1,Evening Rush,632,52,580
2012-04-24,19,Tuesday,Summer,1,Evening Rush,482,33,449
2012-04-24,20,Tuesday,Summer,1,Night,285,16,269
2012-04-24,21,Tuesday,Summer,2,Night,226,13,213
2012-04-24,22,Tuesday,Summer,1,Night,157,8,149
2012-04-24,23,Tuesday,Summer,1,Night,73,4,69
2012-04-25,0,Wednesday,Summer,1,Early Morning,36,13,23
2012-04-25,1,Wednesday,Summer,1,Early Morning,25,8,17
2012-04-25,2,Wednesday,Summer,1,Early Morning,7,1,6
2012-04-25,3,Wednesday,Summer,1,Early Morning,3,0,3
2012-04-25,4,Wednesday,Summer,1,Early Morning,6,0,6
2012-04-25,5,Wednesday,Summer,1,Early Morning,24,0,24
2012-04-25,6,Wednesday,Summer,1,Morning Rush,106,3,103
2012-04-25,7,Wednesday,Summer,1,Morning Rush,389,13,376
2012-04-25,8,Wednesday,Summer,1,Morning Rush,654,20,634
2012-04-25,9,Wednesday,Summer,1,Morning Rush,321,33,288
2012-04-25,10,Wednesday,Summer,1,Mid-Day,182,44,138
2012-04-25,11,Wednesday,Summer,1,Mid-Day,219,42,177
2012-04-25,12,Wednesday,Summer,1,Mid-Day,269,49,220
2012-04-25,13,Wednesday,Summer,1,Mid-Day,228,35,193
2012-04-25,14,Wednesday,Summer,1,Mid-Day,223,47,176
2012-04-25,15,Wednesday,Summer,1,Mid-Day,229,47,182
2012-04-25,16,Wednesday,Summer,1,Evening Rush,376,49,327
2012-04-25,17,Wednesday,Summer,1,Evening Rush,732,68,664
2012-04-25,18,Wednesday,Summer,1,Evening Rush,709,60,649
2012-04-25,19,Wednesday,Summer,1,Evening Rush,543,42,501
2012-04-25,20,Wednesday,Summer,1,Night,380,22,358
2012-04-25,21,Wednesday,Summer,1,Night,239,27,212
2012-04-25,22,Wednesday,Summer,1,Night,192,22,170
2012-04-25,23,Wednesday,Summer,2,Night,104,10,94
2012-04-26,0,Thursday,Summer,2,Early Morning,43,1,42
2012-04-26,1,Thursday,Summer,2,Early Morning,23,1,22
2012-04-26,2,Thursday,Summer,2,Early Morning,13,3,10
2012-04-26,3,Thursday,Summer,2,Early Morning,6,1,5
2012-04-26,4,Thursday,Summer,2,Early Morning,3,1,2
2012-04-26,5,Thursday,Summer,2,Early Morning,17,0,17
2012-04-26,6,Thursday,Summer,2,Morning Rush,127,5,122
2012-04-26,7,Thursday,Summer,3,Morning Rush,225,3,222
2012-04-26,8,Thursday,Summer,3,Morning Rush,362,4,358
2012-04-26,9,Thursday,Summer,3,Morning Rush,201,12,189
2012-04-26,10,Thursday,Summer,2,Mid-Day,139,14,125
2012-04-26,11,Thursday,Summer,2,Mid-Day,151,16,135
2012-04-26,12,Thursday,Summer,2,Mid-Day,204,24,180
2012-04-26,13,Thursday,Summer,2,Mid-Day,197,19,178
2012-04-26,14,Thursday,Summer,2,Mid-Day,169,37,132
2012-04-26,15,Thursday,Summer,2,Mid-Day,204,39,165
2012-04-26,16,Thursday,Summer,2,Evening Rush,318,37,281
2012-04-26,17,Thursday,Summer,1,Evening Rush,614,49,565
2012-04-26,18,Thursday,Summer,2,Evening Rush,664,75,589
2012-04-26,19,Thursday,Summer,2,Evening Rush,464,57,407
2012-04-26,20,Thursday,Summer,1,Night,337,23,314
2012-04-26,21,Thursday,Summer,1,Night,250,28,222
2012-04-26,22,Thursday,Summer,1,Night,183,20,163
2012-04-26,23,Thursday,Summer,1,Night,112,6,106
2012-04-27,0,Friday,Summer,1,Early Morning,73,12,61
2012-04-27,1,Friday,Summer,1,Early Morning,35,3,32
2012-04-27,2,Friday,Summer,1,Early Morning,22,4,18
2012-04-27,3,Friday,Summer,1,Early Morning,3,1,2
2012-04-27,4,Friday,Summer,1,Early Morning,6,0,6
2012-04-27,5,Friday,Summer,1,Early Morning,19,0,19
2012-04-27,6,Friday,Summer,1,Morning Rush,120,5,115
2012-04-27,7,Friday,Summer,1,Morning Rush,315,10,305
2012-04-27,8,Friday,Summer,1,Morning Rush,592,17,575
2012-04-27,9,Friday,Summer,1,Morning Rush,334,42,292
2012-04-27,10,Friday,Summer,1,Mid-Day,236,64,172
2012-04-27,11,Friday,Summer,1,Mid-Day,233,47,186
2012-04-27,12,Friday,Summer,1,Mid-Day,307,63,244
2012-04-27,13,Friday,Summer,1,Mid-Day,306,94,212
2012-04-27,14,Friday,Summer,1,Mid-Day,300,94,206
2012-04-27,15,Friday,Summer,1,Mid-Day,324,101,223
2012-04-27,16,Friday,Summer,1,Evening Rush,440,105,335
2012-04-27,17,Friday,Summer,1,Evening Rush,702,89,613
2012-04-27,18,Friday,Summer,1,Evening Rush,654,94,560
2012-04-27,19,Friday,Summer,1,Evening Rush,441,62,379
2012-04-27,20,Friday,Summer,1,Night,289,49,240
2012-04-27,21,Friday,Summer,1,Night,208,23,185
2012-04-27,22,Friday,Summer,1,Night,158,24,134
2012-04-27,23,Friday,Summer,1,Night,116,11,105
2012-04-28,0,Saturday,Summer,1,Early Morning,103,4,99
2012-04-28,1,Saturday,Summer,1,Early Morning,67,7,60
2012-04-28,2,Saturday,Summer,1,Early Morning,57,8,49
2012-04-28,3,Saturday,Summer,1,Early Morning,26,3,23
2012-04-28,4,Saturday,Summer,1,Early Morning,2,0,2
2012-04-28,5,Saturday,Summer,1,Early Morning,5,2,3
2012-04-28,6,Saturday,Summer,1,Morning Rush,28,10,18
2012-04-28,7,Saturday,Summer,1,Morning Rush,55,10,45
2012-04-28,8,Saturday,Summer,1,Morning Rush,158,24,134
2012-04-28,9,Saturday,Summer,2,Morning Rush,214,45,169
2012-04-28,10,Saturday,Summer,2,Mid-Day,291,60,231
2012-04-28,11,Saturday,Summer,2,Mid-Day,358,96,262
2012-04-28,12,Saturday,Summer,2,Mid-Day,381,105,276
2012-04-28,13,Saturday,Summer,2,Mid-Day,389,120,269
2012-04-28,14,Saturday,Summer,1,Mid-Day,440,147,293
2012-04-28,15,Saturday,Summer,1,Mid-Day,408,148,260
2012-04-28,16,Saturday,Summer,2,Evening Rush,376,132,244
2012-04-28,17,Saturday,Summer,2,Evening Rush,322,98,224
2012-04-28,18,Saturday,Summer,3,Evening Rush,90,17,73
2012-04-28,19,Saturday,Summer,3,Evening Rush,139,29,110
2012-04-28,20,Saturday,Summer,2,Night,102,21,81
2012-04-28,21,Saturday,Summer,3,Night,84,12,72
2012-04-28,22,Saturday,Summer,2,Night,83,17,66
2012-04-28,23,Saturday,Summer,2,Night,42,5,37
2012-04-29,0,Sunday,Summer,3,Early Morning,36,0,36
2012-04-29,1,Sunday,Summer,2,Early Morning,42,5,37
2012-04-29,2,Sunday,Summer,2,Early Morning,40,4,36
2012-04-29,3,Sunday,Summer,2,Early Morning,16,2,14
2012-04-29,4,Sunday,Summer,2,Early Morning,4,0,4
2012-04-29,5,Sunday,Summer,1,Early Morning,6,0,6
2012-04-29,6,Sunday,Summer,1,Morning Rush,7,1,6
2012-04-29,7,Sunday,Summer,2,Morning Rush,27,7,20
2012-04-29,8,Sunday,Summer,1,Morning Rush,107,26,81
2012-04-29,9,Sunday,Summer,1,Morning Rush,185,52,133
2012-04-29,10,Sunday,Summer,1,Mid-Day,380,127,253
2012-04-29,11,Sunday,Summer,1,Mid-Day,411,128,283
2012-04-29,12,Sunday,Summer,1,Mid-Day,584,223,361
2012-04-29,13,Sunday,Summer,1,Mid-Day,595,226,369
2012-04-29,14,Sunday,Summer,1,Mid-Day,653,281,372
2012-04-29,15,Sunday,Summer,1,Mid-Day,603,279,324
2012-04-29,16,Sunday,Summer,1,Evening Rush,587,240,347
2012-04-29,17,Sunday,Summer,1,Evening Rush,522,188,334
2012-04-29,18,Sunday,Summer,1,Evening Rush,487,164,323
2012-04-29,19,Sunday,Summer,1,Evening Rush,375,128,247
2012-04-29,20,Sunday,Summer,1,Night,243,45,198
2012-04-29,21,Sunday,Summer,1,Night,204,65,139
2012-04-29,22,Sunday,Summer,1,Night,108,23,85
2012-04-29,23,Sunday,Summer,1,Night,82,15,67
2012-04-30,0,Monday,Summer,1,Early Morning,48,12,36
2012-04-30,1,Monday,Summer,1,Early Morning,24,9,15
2012-04-30,2,Monday,Summer,1,Early Morning,8,3,5
2012-04-30,3,Monday,Summer,1,Early Morning,4,0,4
2012-04-30,4,Monday,Summer,1,Early Morning,2,0,2
2012-04-30,5,Monday,Summer,1,Early Morning,20,1,19
2012-04-30,6,Monday,Summer,1,Morning Rush,123,2,121
2012-04-30,7,Monday,Summer,1,Morning Rush,349,6,343
2012-04-30,8,Monday,Summer,1,Morning Rush,596,17,579
2012-04-30,9,Monday,Summer,2,Morning Rush,268,29,239
2012-04-30,10,Monday,Summer,2,Mid-Day,157,41,116
2012-04-30,11,Monday,Summer,2,Mid-Day,163,52,111
2012-04-30,12,Monday,Summer,2,Mid-Day,225,45,180
2012-04-30,13,Monday,Summer,2,Mid-Day,247,48,199
2012-04-30,14,Monday,Summer,2,Mid-Day,218,56,162
2012-04-30,15,Monday,Summer,2,Mid-Day,231,55,176
2012-04-30,16,Monday,Summer,1,Evening Rush,347,44,303
2012-04-30,17,Monday,Summer,1,Evening Rush,683,66,617
2012-04-30,18,Monday,Summer,2,Evening Rush,664,53,611
2012-04-30,19,Monday,Summer,2,Evening Rush,471,51,420
2012-04-30,20,Monday,Summer,2,Night,309,28,281
2012-04-30,21,Monday,Summer,2,Night,221,26,195
2012-04-30,22,Monday,Summer,2,Night,134,11,123
2012-04-30,23,Monday,Summer,2,Night,60,10,50
2012-05-01,0,Tuesday,Summer,2,Early Morning,35,7,28
2012-05-01,1,Tuesday,Summer,2,Early Morning,21,0,21
2012-05-01,2,Tuesday,Summer,2,Early Morning,8,1,7
2012-05-01,3,Tuesday,Summer,2,Early Morning,3,1,2
2012-05-01,4,Tuesday,Summer,2,Early Morning,8,1,7
2012-05-01,5,Tuesday,Summer,2,Early Morning,17,0,17
2012-05-01,6,Tuesday,Summer,3,Morning Rush,26,2,24
2012-05-01,7,Tuesday,Summer,2,Morning Rush,169,8,161
2012-05-01,8,Tuesday,Summer,2,Morning Rush,557,19,538
2012-05-01,9,Tuesday,Summer,2,Morning Rush,349,18,331
2012-05-01,10,Tuesday,Summer,1,Mid-Day,174,30,144
2012-05-01,11,Tuesday,Summer,2,Mid-Day,229,50,179
2012-05-01,12,Tuesday,Summer,2,Mid-Day,269,41,228
2012-05-01,13,Tuesday,Summer,2,Mid-Day,249,41,208
2012-05-01,14,Tuesday,Summer,2,Mid-Day,204,37,167
2012-05-01,15,Tuesday,Summer,2,Mid-Day,234,48,186
2012-05-01,16,Tuesday,Summer,1,Evening Rush,354,41,313
2012-05-01,17,Tuesday,Summer,1,Evening Rush,681,65,616
2012-05-01,18,Tuesday,Summer,1,Evening Rush,743,81,662
2012-05-01,19,Tuesday,Summer,1,Evening Rush,487,58,429
2012-05-01,20,Tuesday,Summer,1,Night,335,36,299
2012-05-01,21,Tuesday,Summer,1,Night,282,31,251
2012-05-01,22,Tuesday,Summer,1,Night,211,21,190
2012-05-01,23,Tuesday,Summer,1,Night,95,16,79
2012-05-02,0,Wednesday,Summer,1,Early Morning,47,4,43
2012-05-02,1,Wednesday,Summer,1,Early Morning,15,8,7
2012-05-02,2,Wednesday,Summer,1,Early Morning,16,7,9
2012-05-02,3,Wednesday,Summer,1,Early Morning,6,0,6
2012-05-02,4,Wednesday,Summer,1,Early Morning,4,2,2
2012-05-02,5,Wednesday,Summer,1,Early Morning,33,2,31
2012-05-02,6,Wednesday,Summer,3,Morning Rush,120,3,117
2012-05-02,7,Wednesday,Summer,2,Morning Rush,358,14,344
2012-05-02,8,Wednesday,Summer,2,Morning Rush,666,26,640
2012-05-02,9,Wednesday,Summer,2,Morning Rush,315,26,289
2012-05-02,10,Wednesday,Summer,2,Mid-Day,175,28,147
2012-05-02,11,Wednesday,Summer,2,Mid-Day,184,39,145
2012-05-02,12,Wednesday,Summer,2,Mid-Day,245,35,210
2012-05-02,13,Wednesday,Summer,2,Mid-Day,228,49,179
2012-05-02,14,Wednesday,Summer,1,Mid-Day,240,51,189
2012-05-02,15,Wednesday,Summer,1,Mid-Day,256,52,204
2012-05-02,16,Wednesday,Summer,1,Evening Rush,367,54,313
2012-05-02,17,Wednesday,Summer,1,Evening Rush,729,70,659
2012-05-02,18,Wednesday,Summer,1,Evening Rush,813,43,770
2012-05-02,19,Wednesday,Summer,1,Evening Rush,504,43,461
2012-05-02,20,Wednesday,Summer,1,Night,338,42,296
2012-05-02,21,Wednesday,Summer,1,Night,239,21,218
2012-05-02,22,Wednesday,Summer,1,Night,173,27,146
2012-05-02,23,Wednesday,Summer,2,Night,98,21,77
2012-05-03,0,Thursday,Summer,2,Early Morning,90,15,75
2012-05-03,1,Thursday,Summer,2,Early Morning,24,9,15
2012-05-03,2,Thursday,Summer,2,Early Morning,17,4,13
2012-05-03,3,Thursday,Summer,2,Early Morning,6,2,4
2012-05-03,4,Thursday,Summer,2,Early Morning,2,0,2
2012-05-03,5,Thursday,Summer,2,Early Morning,21,1,20
2012-05-03,6,Thursday,Summer,2,Morning Rush,136,8,128
2012-05-03,7,Thursday,Summer,3,Morning Rush,384,8,376
2012-05-03,8,Thursday,Summer,3,Morning Rush,627,19,608
2012-05-03,9,Thursday,Summer,2,Morning Rush,304,25,279
2012-05-03,10,Thursday,Summer,2,Mid-Day,168,36,132
2012-05-03,11,Thursday,Summer,1,Mid-Day,201,34,167
2012-05-03,12,Thursday,Summer,1,Mid-Day,301,64,237
2012-05-03,13,Thursday,Summer,1,Mid-Day,265,48,217
2012-05-03,14,Thursday,Summer,1,Mid-Day,204,33,171
2012-05-03,15,Thursday,Summer,1,Mid-Day,283,63,220
2012-05-03,16,Thursday,Summer,1,Evening Rush,370,45,325
2012-05-03,17,Thursday,Summer,1,Evening Rush,704,87,617
2012-05-03,18,Thursday,Summer,1,Evening Rush,706,64,642
2012-05-03,19,Thursday,Summer,1,Evening Rush,522,55,467
2012-05-03,20,Thursday,Summer,1,Night,420,52,368
2012-05-03,21,Thursday,Summer,1,Night,299,42,257
2012-05-03,22,Thursday,Summer,1,Night,246,29,217
2012-05-03,23,Thursday,Summer,1,Night,121,21,100
2012-05-04,0,Friday,Summer,1,Early Morning,89,19,70
2012-05-04,1,Friday,Summer,1,Early Morning,48,15,33
2012-05-04,2,Friday,Summer,1,Early Morning,11,0,11
2012-05-04,3,Friday,Summer,1,Early Morning,14,0,14
2012-05-04,4,Friday,Summer,1,Early Morning,4,0,4
2012-05-04,5,Friday,Summer,1,Early Morning,24,0,24
2012-05-04,6,Friday,Summer,1,Morning Rush,135,8,127
2012-05-04,7,Friday,Summer,1,Morning Rush,356,9,347
2012-05-04,8,Friday,Summer,1,Morning Rush,618,34,584
2012-05-04,9,Friday,Summer,1,Morning Rush,294,32,262
2012-05-04,10,Friday,Summer,2,Mid-Day,199,45,154
2012-05-04,11,Friday,Summer,2,Mid-Day,258,77,181
2012-05-04,12,Friday,Summer,3,Mid-Day,171,46,125
2012-05-04,13,Friday,Summer,2,Mid-Day,278,71,207
2012-05-04,14,Friday,Summer,2,Mid-Day,242,83,159
2012-05-04,15,Friday,Summer,2,Mid-Day,343,103,240
2012-05-04,16,Friday,Summer,1,Evening Rush,440,82,358
2012-05-04,17,Friday,Summer,1,Evening Rush,643,96,547
2012-05-04,18,Friday,Summer,1,Evening Rush,641,77,564
2012-05-04,19,Friday,Summer,1,Evening Rush,452,64,388
2012-05-04,20,Friday,Summer,1,Night,313,58,255
2012-05-04,21,Friday,Summer,1,Night,235,49,186
2012-05-04,22,Friday,Summer,1,Night,232,50,182
2012-05-04,23,Friday,Summer,1,Night,256,51,205
2012-05-05,0,Saturday,Summer,1,Early Morning,153,42,111
2012-05-05,1,Saturday,Summer,1,Early Morning,107,28,79
2012-05-05,2,Saturday,Summer,1,Early Morning,75,24,51
2012-05-05,3,Saturday,Summer,1,Early Morning,32,11,21
2012-05-05,4,Saturday,Summer,1,Early Morning,9,0,9
2012-05-05,5,Saturday,Summer,1,Early Morning,22,8,14
2012-05-05,6,Saturday,Summer,2,Morning Rush,42,9,33
2012-05-05,7,Saturday,Summer,1,Morning Rush,87,8,79
2012-05-05,8,Saturday,Summer,1,Morning Rush,197,42,155
2012-05-05,9,Saturday,Summer,1,Morning Rush,284,61,223
2012-05-05,10,Saturday,Summer,1,Mid-Day,432,148,284
2012-05-05,11,Saturday,Summer,1,Mid-Day,575,221,354
2012-05-05,12,Saturday,Summer,1,Mid-Day,550,220,330
2012-05-05,13,Saturday,Summer,1,Mid-Day,524,217,307
2012-05-05,14,Saturday,Summer,3,Mid-Day,428,187,241
2012-05-05,15,Saturday,Summer,3,Mid-Day,541,241,300
2012-05-05,16,Saturday,Summer,2,Evening Rush,540,230,310
2012-05-05,17,Saturday,Summer,2,Evening Rush,502,204,298
2012-05-05,18,Saturday,Summer,2,Evening Rush,434,156,278
2012-05-05,19,Saturday,Summer,2,Evening Rush,405,151,254
2012-05-05,20,Saturday,Summer,1,Night,309,100,209
2012-05-05,21,Saturday,Summer,2,Night,269,86,183
2012-05-05,22,Saturday,Summer,2,Night,217,67,150
2012-05-05,23,Saturday,Summer,2,Night,149,35,114
2012-05-06,0,Sunday,Summer,2,Early Morning,134,23,111
2012-05-06,1,Sunday,Summer,2,Early Morning,121,37,84
2012-05-06,2,Sunday,Summer,2,Early Morning,93,29,64
2012-05-06,3,Sunday,Summer,2,Early Morning,28,9,19
2012-05-06,4,Sunday,Summer,3,Early Morning,16,9,7
2012-05-06,5,Sunday,Summer,3,Early Morning,11,1,10
2012-05-06,6,Sunday,Summer,3,Morning Rush,17,3,14
2012-05-06,7,Sunday,Summer,3,Morning Rush,36,5,31
2012-05-06,8,Sunday,Summer,2,Morning Rush,114,23,91
2012-05-06,9,Sunday,Summer,2,Morning Rush,191,63,128
2012-05-06,10,Sunday,Summer,2,Mid-Day,333,112,221
2012-05-06,11,Sunday,Summer,1,Mid-Day,414,144,270
2012-05-06,12,Sunday,Summer,2,Mid-Day,558,207,351
2012-05-06,13,Sunday,Summer,2,Mid-Day,565,197,368
2012-05-06,14,Sunday,Summer,2,Mid-Day,518,226,292
2012-05-06,15,Sunday,Summer,2,Mid-Day,571,229,342
2012-05-06,16,Sunday,Summer,2,Evening Rush,544,181,363
2012-05-06,17,Sunday,Summer,2,Evening Rush,511,195,316
2012-05-06,18,Sunday,Summer,2,Evening Rush,463,131,332
2012-05-06,19,Sunday,Summer,2,Evening Rush,383,117,266
2012-05-06,20,Sunday,Summer,1,Night,276,73,203
2012-05-06,21,Sunday,Summer,1,Night,203,55,148
2012-05-06,22,Sunday,Summer,1,Night,157,44,113
2012-05-06,23,Sunday,Summer,1,Night,102,22,80
2012-05-07,0,Monday,Summer,2,Early Morning,34,13,21
2012-05-07,1,Monday,Summer,2,Early Morning,9,1,8
2012-05-07,2,Monday,Summer,1,Early Morning,6,1,5
2012-05-07,3,Monday,Summer,1,Early Morning,5,2,3
2012-05-07,4,Monday,Summer,2,Early Morning,2,0,2
2012-05-07,5,Monday,Summer,1,Early Morning,23,2,21
2012-05-07,6,Monday,Summer,1,Morning Rush,142,8,134
2012-05-07,7,Monday,Summer,2,Morning Rush,385,18,367
2012-05-07,8,Monday,Summer,2,Morning Rush,639,31,608
2012-05-07,9,Monday,Summer,2,Morning Rush,350,61,289
2012-05-07,10,Monday,Summer,2,Mid-Day,190,62,128
2012-05-07,11,Monday,Summer,2,Mid-Day,213,64,149
2012-05-07,12,Monday,Summer,2,Mid-Day,263,74,189
2012-05-07,13,Monday,Summer,2,Mid-Day,272,75,197
2012-05-07,14,Monday,Summer,2,Mid-Day,239,59,180
2012-05-07,15,Monday,Summer,2,Mid-Day,262,76,186
2012-05-07,16,Monday,Summer,2,Evening Rush,388,68,320
2012-05-07,17,Monday,Summer,2,Evening Rush,769,102,667
2012-05-07,18,Monday,Summer,2,Evening Rush,680,78,602
2012-05-07,19,Monday,Summer,1,Evening Rush,546,83,463
2012-05-07,20,Monday,Summer,1,Night,323,46,277
2012-05-07,21,Monday,Summer,2,Night,247,37,210
2012-05-07,22,Monday,Summer,2,Night,173,26,147
2012-05-07,23,Monday,Summer,2,Night,113,21,92
2012-05-08,0,Tuesday,Summer,2,Early Morning,38,10,28
2012-05-08,1,Tuesday,Summer,2,Early Morning,9,6,3
2012-05-08,2,Tuesday,Summer,2,Early Morning,16,9,7
2012-05-08,3,Tuesday,Summer,2,Early Morning,6,2,4
2012-05-08,4,Tuesday,Summer,2,Early Morning,5,0,5
2012-05-08,5,Tuesday,Summer,2,Early Morning,20,0,20
2012-05-08,6,Tuesday,Summer,1,Morning Rush,165,7,158
2012-05-08,7,Tuesday,Summer,1,Morning Rush,463,21,442
2012-05-08,8,Tuesday,Summer,2,Morning Rush,641,36,605
2012-05-08,9,Tuesday,Summer,2,Morning Rush,295,37,258
2012-05-08,10,Tuesday,Summer,2,Mid-Day,157,46,111
2012-05-08,11,Tuesday,Summer,2,Mid-Day,217,60,157
2012-05-08,12,Tuesday,Summer,2,Mid-Day,263,60,203
2012-05-08,13,Tuesday,Summer,3,Mid-Day,219,53,166
2012-05-08,14,Tuesday,Summer,3,Mid-Day,71,8,63
2012-05-08,15,Tuesday,Summer,3,Mid-Day,134,40,94
2012-05-08,16,Tuesday,Summer,3,Evening Rush,389,54,335
2012-05-08,17,Tuesday,Summer,2,Evening Rush,717,77,640
2012-05-08,18,Tuesday,Summer,2,Evening Rush,710,69,641
2012-05-08,19,Tuesday,Summer,2,Evening Rush,458,59,399
2012-05-08,20,Tuesday,Summer,2,Night,302,40,262
2012-05-08,21,Tuesday,Summer,2,Night,223,21,202
2012-05-08,22,Tuesday,Summer,3,Night,147,13,134
2012-05-08,23,Tuesday,Summer,3,Night,63,10,53
2012-05-09,0,Wednesday,Summer,2,Early Morning,35,8,27
2012-05-09,1,Wednesday,Summer,2,Early Morning,14,3,11
2012-05-09,2,Wednesday,Summer,3,Early Morning,1,0,1
2012-05-09,3,Wednesday,Summer,3,Early Morning,2,0,2
2012-05-09,4,Wednesday,Summer,3,Early Morning,5,0,5
2012-05-09,5,Wednesday,Summer,2,Early Morning,28,1,27
2012-05-09,6,Wednesday,Summer,2,Morning Rush,126,5,121
2012-05-09,7,Wednesday,Summer,2,Morning Rush,418,17,401
2012-05-09,8,Wednesday,Summer,2,Morning Rush,622,28,594
2012-05-09,9,Wednesday,Summer,2,Morning Rush,325,40,285
2012-05-09,10,Wednesday,Summer,2,Mid-Day,153,40,113
2012-05-09,11,Wednesday,Summer,2,Mid-Day,201,45,156
2012-05-09,12,Wednesday,Summer,2,Mid-Day,280,58,222
2012-05-09,13,Wednesday,Summer,2,Mid-Day,266,50,216
2012-05-09,14,Wednesday,Summer,2,Mid-Day,243,68,175
2012-05-09,15,Wednesday,Summer,2,Mid-Day,259,68,191
2012-05-09,16,Wednesday,Summer,2,Evening Rush,357,68,289
2012-05-09,17,Wednesday,Summer,2,Evening Rush,705,76,629
2012-05-09,18,Wednesday,Summer,3,Evening Rush,372,23,349
2012-05-09,19,Wednesday,Summer,3,Evening Rush,98,2,96
2012-05-09,20,Wednesday,Summer,3,Night,51,3,48
2012-05-09,21,Wednesday,Summer,3,Night,34,4,30
2012-05-09,22,Wednesday,Summer,3,Night,67,5,62
2012-05-09,23,Wednesday,Summer,3,Night,55,8,47
2012-05-10,0,Thursday,Summer,3,Early Morning,33,2,31
2012-05-10,1,Thursday,Summer,2,Early Morning,11,2,9
2012-05-10,2,Thursday,Summer,2,Early Morning,3,0,3
2012-05-10,3,Thursday,Summer,1,Early Morning,3,0,3
2012-05-10,4,Thursday,Summer,1,Early Morning,2,0,2
2012-05-10,5,Thursday,Summer,1,Early Morning,24,1,23
2012-05-10,6,Thursday,Summer,1,Morning Rush,139,9,130
2012-05-10,7,Thursday,Summer,1,Morning Rush,401,8,393
2012-05-10,8,Thursday,Summer,1,Morning Rush,630,27,603
2012-05-10,9,Thursday,Summer,1,Morning Rush,361,62,299
2012-05-10,10,Thursday,Summer,1,Mid-Day,154,42,112
2012-05-10,11,Thursday,Summer,1,Mid-Day,256,77,179
2012-05-10,12,Thursday,Summer,1,Mid-Day,272,65,207
2012-05-10,13,Thursday,Summer,1,Mid-Day,318,90,228
2012-05-10,14,Thursday,Summer,1,Mid-Day,247,61,186
2012-05-10,15,Thursday,Summer,1,Mid-Day,271,79,192
2012-05-10,16,Thursday,Summer,1,Evening Rush,421,87,334
2012-05-10,17,Thursday,Summer,1,Evening Rush,732,84,648
2012-05-10,18,Thursday,Summer,1,Evening Rush,770,109,661
2012-05-10,19,Thursday,Summer,1,Evening Rush,553,84,469
2012-05-10,20,Thursday,Summer,1,Night,374,59,315
2012-05-10,21,Thursday,Summer,1,Night,230,19,211
2012-05-10,22,Thursday,Summer,1,Night,232,36,196
2012-05-10,23,Thursday,Summer,1,Night,135,23,112
2012-05-11,0,Friday,Summer,1,Early Morning,64,17,47
2012-05-11,1,Friday,Summer,1,Early Morning,46,14,32
2012-05-11,2,Friday,Summer,1,Early Morning,31,15,16
2012-05-11,3,Friday,Summer,1,Early Morning,13,5,8
2012-05-11,4,Friday,Summer,1,Early Morning,9,3,6
2012-05-11,5,Friday,Summer,1,Early Morning,26,3,23
2012-05-11,6,Friday,Summer,1,Morning Rush,135,7,128
2012-05-11,7,Friday,Summer,1,Morning Rush,351,6,345
2012-05-11,8,Friday,Summer,1,Morning Rush,620,41,579
2012-05-11,9,Friday,Summer,1,Morning Rush,322,34,288
2012-05-11,10,Friday,Summer,1,Mid-Day,210,69,141
2012-05-11,11,Friday,Summer,1,Mid-Day,291,88,203
2012-05-11,12,Friday,Summer,1,Mid-Day,348,89,259
2012-05-11,13,Friday,Summer,1,Mid-Day,363,100,263
2012-05-11,14,Friday,Summer,1,Mid-Day,334,116,218
2012-05-11,15,Friday,Summer,1,Mid-Day,439,140,299
2012-05-11,16,Friday,Summer,1,Evening Rush,525,128,397
2012-05-11,17,Friday,Summer,1,Evening Rush,779,102,677
2012-05-11,18,Friday,Summer,1,Evening Rush,596,78,518
2012-05-11,19,Friday,Summer,1,Evening Rush,503,73,430
2012-05-11,20,Friday,Summer,1,Night,341,64,277
2012-05-11,21,Friday,Summer,1,Night,270,45,225
2012-05-11,22,Friday,Summer,1,Night,234,44,190
2012-05-11,23,Friday,Summer,1,Night,180,38,142
2012-05-12,0,Saturday,Summer,1,Early Morning,136,25,111
2012-05-12,1,Saturday,Summer,1,Early Morning,93,14,79
2012-05-12,2,Saturday,Summer,1,Early Morning,56,10,46
2012-05-12,3,Saturday,Summer,1,Early Morning,34,14,20
2012-05-12,4,Saturday,Summer,1,Early Morning,9,3,6
2012-05-12,5,Saturday,Summer,1,Early Morning,13,5,8
2012-05-12,6,Saturday,Summer,1,Morning Rush,33,10,23
2012-05-12,7,Saturday,Summer,1,Morning Rush,67,10,57
2012-05-12,8,Saturday,Summer,1,Morning Rush,178,22,156
2012-05-12,9,Saturday,Summer,1,Morning Rush,335,87,248
2012-05-12,10,Saturday,Summer,1,Mid-Day,411,132,279
2012-05-12,11,Saturday,Summer,1,Mid-Day,522,157,365
2012-05-12,12,Saturday,Summer,1,Mid-Day,559,206,353
2012-05-12,13,Saturday,Summer,1,Mid-Day,659,293,366
2012-05-12,14,Saturday,Summer,1,Mid-Day,615,257,358
2012-05-12,15,Saturday,Summer,1,Mid-Day,590,269,321
2012-05-12,16,Saturday,Summer,2,Evening Rush,591,254,337
2012-05-12,17,Saturday,Summer,2,Evening Rush,576,233,343
2012-05-12,18,Saturday,Summer,2,Evening Rush,546,164,382
2012-05-12,19,Saturday,Summer,2,Evening Rush,439,166,273
2012-05-12,20,Saturday,Summer,1,Night,287,113,174
2012-05-12,21,Saturday,Summer,2,Night,230,74,156
2012-05-12,22,Saturday,Summer,1,Night,274,62,212
2012-05-12,23,Saturday,Summer,1,Night,176,42,134
2012-05-13,0,Sunday,Summer,1,Early Morning,98,19,79
2012-05-13,1,Sunday,Summer,2,Early Morning,94,22,72
2012-05-13,2,Sunday,Summer,2,Early Morning,82,22,60
2012-05-13,3,Sunday,Summer,2,Early Morning,28,2,26
2012-05-13,4,Sunday,Summer,2,Early Morning,9,2,7
2012-05-13,5,Sunday,Summer,1,Early Morning,12,4,8
2012-05-13,6,Sunday,Summer,1,Morning Rush,21,6,15
2012-05-13,7,Sunday,Summer,1,Morning Rush,60,18,42
2012-05-13,8,Sunday,Summer,1,Morning Rush,156,32,124
2012-05-13,9,Sunday,Summer,1,Morning Rush,222,79,143
2012-05-13,10,Sunday,Summer,1,Mid-Day,350,128,222
2012-05-13,11,Sunday,Summer,1,Mid-Day,428,150,278
2012-05-13,12,Sunday,Summer,1,Mid-Day,531,189,342
2012-05-13,13,Sunday,Summer,1,Mid-Day,602,255,347
2012-05-13,14,Sunday,Summer,1,Mid-Day,552,228,324
2012-05-13,15,Sunday,Summer,1,Mid-Day,499,190,309
2012-05-13,16,Sunday,Summer,1,Evening Rush,564,225,339
2012-05-13,17,Sunday,Summer,1,Evening Rush,478,191,287
2012-05-13,18,Sunday,Summer,2,Evening Rush,389,129,260
2012-05-13,19,Sunday,Summer,2,Evening Rush,339,107,232
2012-05-13,20,Sunday,Summer,2,Night,230,67,163
2012-05-13,21,Sunday,Summer,2,Night,169,48,121
2012-05-13,22,Sunday,Summer,2,Night,131,42,89
2012-05-13,23,Sunday,Summer,2,Night,74,17,57
2012-05-14,0,Monday,Summer,2,Early Morning,35,21,14
2012-05-14,1,Monday,Summer,2,Early Morning,11,5,6
2012-05-14,2,Monday,Summer,1,Early Morning,2,1,1
2012-05-14,3,Monday,Summer,2,Early Morning,2,0,2
2012-05-14,4,Monday,Summer,2,Early Morning,6,3,3
2012-05-14,5,Monday,Summer,2,Early Morning,26,1,25
2012-05-14,6,Monday,Summer,3,Morning Rush,65,3,62
2012-05-14,7,Monday,Summer,3,Morning Rush,75,3,72
2012-05-14,8,Monday,Summer,3,Morning Rush,156,1,155
2012-05-14,9,Monday,Summer,3,Morning Rush,110,5,105
2012-05-14,10,Monday,Summer,3,Mid-Day,59,6,53
2012-05-14,11,Monday,Summer,2,Mid-Day,79,12,67
2012-05-14,12,Monday,Summer,2,Mid-Day,185,53,132
2012-05-14,13,Monday,Summer,2,Mid-Day,176,33,143
2012-05-14,14,Monday,Summer,2,Mid-Day,171,43,128
2012-05-14,15,Monday,Summer,2,Mid-Day,196,40,156
2012-05-14,16,Monday,Summer,3,Evening Rush,111,20,91
2012-05-14,17,Monday,Summer,3,Evening Rush,229,25,204
2012-05-14,18,Monday,Summer,2,Evening Rush,300,17,283
2012-05-14,19,Monday,Summer,3,Evening Rush,304,10,294
2012-05-14,20,Monday,Summer,2,Night,189,11,178
2012-05-14,21,Monday,Summer,2,Night,152,7,145
2012-05-14,22,Monday,Summer,2,Night,129,11,118
2012-05-14,23,Monday,Summer,2,Night,75,11,64
2012-05-15,0,Tuesday,Summer,2,Early Morning,32,7,25
2012-05-15,1,Tuesday,Summer,3,Early Morning,19,5,14
2012-05-15,2,Tuesday,Summer,2,Early Morning,4,1,3
2012-05-15,3,Tuesday,Summer,3,Early Morning,6,1,5
2012-05-15,4,Tuesday,Summer,3,Early Morning,5,1,4
2012-05-15,5,Tuesday,Summer,3,Early Morning,8,0,8
2012-05-15,6,Tuesday,Summer,3,Morning Rush,24,2,22
2012-05-15,7,Tuesday,Summer,3,Morning Rush,92,1,91
2012-05-15,8,Tuesday,Summer,2,Morning Rush,409,8,401
2012-05-15,9,Tuesday,Summer,2,Morning Rush,355,28,327
2012-05-15,10,Tuesday,Summer,1,Mid-Day,171,27,144
2012-05-15,11,Tuesday,Summer,1,Mid-Day,224,38,186
2012-05-15,12,Tuesday,Summer,1,Mid-Day,264,44,220
2012-05-15,13,Tuesday,Summer,3,Mid-Day,239,35,204
2012-05-15,14,Tuesday,Summer,2,Mid-Day,184,39,145
2012-05-15,15,Tuesday,Summer,2,Mid-Day,256,51,205
2012-05-15,16,Tuesday,Summer,1,Evening Rush,374,74,300
2012-05-15,17,Tuesday,Summer,1,Evening Rush,678,75,603
2012-05-15,18,Tuesday,Summer,1,Evening Rush,733,68,665
2012-05-15,19,Tuesday,Summer,1,Evening Rush,512,57,455
2012-05-15,20,Tuesday,Summer,3,Night,263,30,233
2012-05-15,21,Tuesday,Summer,3,Night,109,11,98
2012-05-15,22,Tuesday,Summer,1,Night,83,9,74
2012-05-15,23,Tuesday,Summer,3,Night,71,13,58
2012-05-16,0,Wednesday,Summer,2,Early Morning,39,12,27
2012-05-16,1,Wednesday,Summer,2,Early Morning,21,7,14
2012-05-16,2,Wednesday,Summer,1,Early Morning,19,5,14
2012-05-16,3,Wednesday,Summer,1,Early Morning,6,1,5
2012-05-16,4,Wednesday,Summer,1,Early Morning,4,1,3
2012-05-16,5,Wednesday,Summer,1,Early Morning,38,4,34
2012-05-16,6,Wednesday,Summer,1,Morning Rush,158,8,150
2012-05-16,7,Wednesday,Summer,1,Morning Rush,440,14,426
2012-05-16,8,Wednesday,Summer,1,Morning Rush,650,33,617
2012-05-16,9,Wednesday,Summer,2,Morning Rush,347,33,314
2012-05-16,10,Wednesday,Summer,1,Mid-Day,192,43,149
2012-05-16,11,Wednesday,Summer,1,Mid-Day,267,55,212
2012-05-16,12,Wednesday,Summer,1,Mid-Day,330,59,271
2012-05-16,13,Wednesday,Summer,1,Mid-Day,350,77,273
2012-05-16,14,Wednesday,Summer,1,Mid-Day,263,42,221
2012-05-16,15,Wednesday,Summer,2,Mid-Day,274,52,222
2012-05-16,16,Wednesday,Summer,1,Evening Rush,446,70,376
2012-05-16,17,Wednesday,Summer,1,Evening Rush,873,104,769
2012-05-16,18,Wednesday,Summer,1,Evening Rush,846,97,749
2012-05-16,19,Wednesday,Summer,1,Evening Rush,590,91,499
2012-05-16,20,Wednesday,Summer,1,Night,459,61,398
2012-05-16,21,Wednesday,Summer,1,Night,393,63,330
2012-05-16,22,Wednesday,Summer,1,Night,286,33,253
2012-05-16,23,Wednesday,Summer,1,Night,133,26,107
2012-05-17,0,Thursday,Summer,1,Early Morning,79,30,49
2012-05-17,1,Thursday,Summer,1,Early Morning,28,12,16
2012-05-17,2,Thursday,Summer,1,Early Morning,16,8,8
2012-05-17,3,Thursday,Summer,1,Early Morning,3,0,3
2012-05-17,4,Thursday,Summer,1,Early Morning,16,3,13
2012-05-17,5,Thursday,Summer,1,Early Morning,35,1,34
2012-05-17,6,Thursday,Summer,1,Morning Rush,159,10,149
2012-05-17,7,Thursday,Summer,1,Morning Rush,474,25,449
2012-05-17,8,Thursday,Summer,1,Morning Rush,634,29,605
2012-05-17,9,Thursday,Summer,1,Morning Rush,346,57,289
2012-05-17,10,Thursday,Summer,1,Mid-Day,205,43,162
2012-05-17,11,Thursday,Summer,1,Mid-Day,279,77,202
2012-05-17,12,Thursday,Summer,1,Mid-Day,348,72,276
2012-05-17,13,Thursday,Summer,1,Mid-Day,327,86,241
2012-05-17,14,Thursday,Summer,1,Mid-Day,270,68,202
2012-05-17,15,Thursday,Summer,1,Mid-Day,316,83,233
2012-05-17,16,Thursday,Summer,1,Evening Rush,430,86,344
2012-05-17,17,Thursday,Summer,1,Evening Rush,852,133,719
2012-05-17,18,Thursday,Summer,1,Evening Rush,868,134,734
2012-05-17,19,Thursday,Summer,1,Evening Rush,537,86,451
2012-05-17,20,Thursday,Summer,1,Night,446,83,363
2012-05-17,21,Thursday,Summer,1,Night,299,45,254
2012-05-17,22,Thursday,Summer,1,Night,251,42,209
2012-05-17,23,Thursday,Summer,1,Night,166,29,137
2012-05-18,0,Friday,Summer,1,Early Morning,70,13,57
2012-05-18,1,Friday,Summer,1,Early Morning,49,16,33
2012-05-18,2,Friday,Summer,1,Early Morning,21,12,9
2012-05-18,3,Friday,Summer,1,Early Morning,14,6,8
2012-05-18,4,Friday,Summer,1,Early Morning,11,0,11
2012-05-18,5,Friday,Summer,1,Early Morning,34,1,33
2012-05-18,6,Friday,Summer,1,Morning Rush,182,14,168
2012-05-18,7,Friday,Summer,1,Morning Rush,515,40,475
2012-05-18,8,Friday,Summer,1,Morning Rush,745,49,696
2012-05-18,9,Friday,Summer,1,Morning Rush,361,57,304
2012-05-18,10,Friday,Summer,1,Mid-Day,255,74,181
2012-05-18,11,Friday,Summer,1,Mid-Day,334,109,225
2012-05-18,12,Friday,Summer,1,Mid-Day,360,108,252
2012-05-18,13,Friday,Summer,1,Mid-Day,395,98,297
2012-05-18,14,Friday,Summer,1,Mid-Day,350,108,242
2012-05-18,15,Friday,Summer,1,Mid-Day,391,131,260
2012-05-18,16,Friday,Summer,1,Evening Rush,568,151,417
2012-05-18,17,Friday,Summer,1,Evening Rush,812,124,688
2012-05-18,18,Friday,Summer,1,Evening Rush,669,99,570
2012-05-18,19,Friday,Summer,1,Evening Rush,483,91,392
2012-05-18,20,Friday,Summer,1,Night,337,73,264
2012-05-18,21,Friday,Summer,1,Night,258,49,209
2012-05-18,22,Friday,Summer,1,Night,251,57,194
2012-05-18,23,Friday,Summer,1,Night,174,41,133
2012-05-19,0,Saturday,Summer,1,Early Morning,148,30,118
2012-05-19,1,Saturday,Summer,1,Early Morning,104,20,84
2012-05-19,2,Saturday,Summer,1,Early Morning,69,13,56
2012-05-19,3,Saturday,Summer,1,Early Morning,33,10,23
2012-05-19,4,Saturday,Summer,1,Early Morning,14,6,8
2012-05-19,5,Saturday,Summer,1,Early Morning,12,1,11
2012-05-19,6,Saturday,Summer,1,Morning Rush,50,12,38
2012-05-19,7,Saturday,Summer,1,Morning Rush,95,28,67
2012-05-19,8,Saturday,Summer,1,Morning Rush,195,33,162
2012-05-19,9,Saturday,Summer,1,Morning Rush,292,79,213
2012-05-19,10,Saturday,Summer,1,Mid-Day,452,177,275
2012-05-19,11,Saturday,Summer,1,Mid-Day,586,235,351
2012-05-19,12,Saturday,Summer,1,Mid-Day,642,276,366
2012-05-19,13,Saturday,Summer,1,Mid-Day,704,332,372
2012-05-19,14,Saturday,Summer,1,Mid-Day,730,361,369
2012-05-19,15,Saturday,Summer,1,Mid-Day,672,356,316
2012-05-19,16,Saturday,Summer,1,Evening Rush,642,331,311
2012-05-19,17,Saturday,Summer,1,Evening Rush,626,279,347
2012-05-19,18,Saturday,Summer,1,Evening Rush,645,254,391
2012-05-19,19,Saturday,Summer,1,Evening Rush,432,203,229
2012-05-19,20,Saturday,Summer,1,Night,315,118,197
2012-05-19,21,Saturday,Summer,1,Night,259,81,178
2012-05-19,22,Saturday,Summer,1,Night,338,104,234
2012-05-19,23,Saturday,Summer,1,Night,239,71,168
2012-05-20,0,Sunday,Summer,1,Early Morning,170,42,128
2012-05-20,1,Sunday,Summer,1,Early Morning,130,28,102
2012-05-20,2,Sunday,Summer,1,Early Morning,98,36,62
2012-05-20,3,Sunday,Summer,1,Early Morning,66,26,40
2012-05-20,4,Sunday,Summer,1,Early Morning,16,2,14
2012-05-20,5,Sunday,Summer,1,Early Morning,8,1,7
2012-05-20,6,Sunday,Summer,1,Morning Rush,25,4,21
2012-05-20,7,Sunday,Summer,1,Morning Rush,90,35,55
2012-05-20,8,Sunday,Summer,1,Morning Rush,171,51,120
2012-05-20,9,Sunday,Summer,1,Morning Rush,313,129,184
2012-05-20,10,Sunday,Summer,1,Mid-Day,432,174,258
2012-05-20,11,Sunday,Summer,1,Mid-Day,581,258,323
2012-05-20,12,Sunday,Summer,1,Mid-Day,637,247,390
2012-05-20,13,Sunday,Summer,1,Mid-Day,607,244,363
2012-05-20,14,Sunday,Summer,1,Mid-Day,543,236,307
2012-05-20,15,Sunday,Summer,2,Mid-Day,502,246,256
2012-05-20,16,Sunday,Summer,1,Evening Rush,577,238,339
2012-05-20,17,Sunday,Summer,1,Evening Rush,549,209,340
2012-05-20,18,Sunday,Summer,1,Evening Rush,474,146,328
2012-05-20,19,Sunday,Summer,1,Evening Rush,402,142,260
2012-05-20,20,Sunday,Summer,1,Night,274,83,191
2012-05-20,21,Sunday,Summer,1,Night,233,51,182
2012-05-20,22,Sunday,Summer,1,Night,145,44,101
2012-05-20,23,Sunday,Summer,3,Night,86,32,54
2012-05-21,0,Monday,Summer,3,Early Morning,40,12,28
2012-05-21,1,Monday,Summer,3,Early Morning,15,4,11
2012-05-21,2,Monday,Summer,3,Early Morning,11,2,9
2012-05-21,3,Monday,Summer,2,Early Morning,2,0,2
2012-05-21,4,Monday,Summer,3,Early Morning,7,2,5
2012-05-21,5,Monday,Summer,3,Early Morning,15,1,14
2012-05-21,6,Monday,Summer,3,Morning Rush,79,3,76
2012-05-21,7,Monday,Summer,3,Morning Rush,153,7,146
2012-05-21,8,Monday,Summer,3,Morning Rush,270,12,258
2012-05-21,9,Monday,Summer,3,Morning Rush,186,14,172
2012-05-21,10,Monday,Summer,3,Mid-Day,99,28,71
2012-05-21,11,Monday,Summer,2,Mid-Day,106,24,82
2012-05-21,12,Monday,Summer,2,Mid-Day,170,46,124
2012-05-21,13,Monday,Summer,3,Mid-Day,184,49,135
2012-05-21,14,Monday,Summer,3,Mid-Day,180,45,135
2012-05-21,15,Monday,Summer,2,Mid-Day,225,67,158
2012-05-21,16,Monday,Summer,2,Evening Rush,315,46,269
2012-05-21,17,Monday,Summer,2,Evening Rush,508,40,468
2012-05-21,18,Monday,Summer,1,Evening Rush,530,52,478
2012-05-21,19,Monday,Summer,1,Evening Rush,448,57,391
2012-05-21,20,Monday,Summer,1,Night,336,44,292
2012-05-21,21,Monday,Summer,1,Night,241,31,210
2012-05-21,22,Monday,Summer,2,Night,142,26,116
2012-05-21,23,Monday,Summer,1,Night,97,18,79
2012-05-22,0,Tuesday,Summer,1,Early Morning,36,10,26
2012-05-22,1,Tuesday,Summer,2,Early Morning,27,11,16
2012-05-22,2,Tuesday,Summer,2,Early Morning,11,1,10
2012-05-22,3,Tuesday,Summer,2,Early Morning,5,0,5
2012-05-22,4,Tuesday,Summer,2,Early Morning,7,0,7
2012-05-22,5,Tuesday,Summer,3,Early Morning,17,0,17
2012-05-22,6,Tuesday,Summer,3,Morning Rush,137,8,129
2012-05-22,7,Tuesday,Summer,3,Morning Rush,324,9,315
2012-05-22,8,Tuesday,Summer,2,Morning Rush,590,20,570
2012-05-22,9,Tuesday,Summer,2,Morning Rush,333,46,287
2012-05-22,10,Tuesday,Summer,2,Mid-Day,200,52,148
2012-05-22,11,Tuesday,Summer,2,Mid-Day,189,39,150
2012-05-22,12,Tuesday,Summer,2,Mid-Day,254,76,178
2012-05-22,13,Tuesday,Summer,2,Mid-Day,243,48,195
2012-05-22,14,Tuesday,Summer,2,Mid-Day,222,73,149
2012-05-22,15,Tuesday,Summer,1,Mid-Day,245,54,191
2012-05-22,16,Tuesday,Summer,1,Evening Rush,386,70,316
2012-05-22,17,Tuesday,Summer,1,Evening Rush,785,69,716
2012-05-22,18,Tuesday,Summer,1,Evening Rush,785,76,709
2012-05-22,19,Tuesday,Summer,1,Evening Rush,364,44,320
2012-05-22,20,Tuesday,Summer,1,Night,373,54,319
2012-05-22,21,Tuesday,Summer,1,Night,261,28,233
2012-05-22,22,Tuesday,Summer,1,Night,174,17,157
2012-05-22,23,Tuesday,Summer,1,Night,105,14,91
2012-05-23,0,Wednesday,Summer,1,Early Morning,47,19,28
2012-05-23,1,Wednesday,Summer,1,Early Morning,32,23,9
2012-05-23,2,Wednesday,Summer,2,Early Morning,12,2,10
2012-05-23,3,Wednesday,Summer,1,Early Morning,5,0,5
2012-05-23,4,Wednesday,Summer,3,Early Morning,3,0,3
2012-05-23,5,Wednesday,Summer,3,Early Morning,35,6,29
2012-05-23,6,Wednesday,Summer,1,Morning Rush,160,6,154
2012-05-23,7,Wednesday,Summer,1,Morning Rush,468,16,452
2012-05-23,8,Wednesday,Summer,1,Morning Rush,719,38,681
2012-05-23,9,Wednesday,Summer,2,Morning Rush,297,39,258
2012-05-23,10,Wednesday,Summer,1,Mid-Day,191,52,139
2012-05-23,11,Wednesday,Summer,1,Mid-Day,197,46,151
2012-05-23,12,Wednesday,Summer,2,Mid-Day,248,42,206
2012-05-23,13,Wednesday,Summer,2,Mid-Day,270,69,201
2012-05-23,14,Wednesday,Summer,1,Mid-Day,248,67,181
2012-05-23,15,Wednesday,Summer,2,Mid-Day,257,65,192
2012-05-23,16,Wednesday,Summer,3,Evening Rush,278,62,216
2012-05-23,17,Wednesday,Summer,3,Evening Rush,285,45,240
2012-05-23,18,Wednesday,Summer,3,Evening Rush,327,31,296
2012-05-23,19,Wednesday,Summer,2,Evening Rush,376,40,336
2012-05-23,20,Wednesday,Summer,2,Night,295,28,267
2012-05-23,21,Wednesday,Summer,2,Night,245,24,221
2012-05-23,22,Wednesday,Summer,2,Night,159,23,136
2012-05-23,23,Wednesday,Summer,1,Night,106,23,83
2012-05-24,0,Thursday,Summer,1,Early Morning,56,7,49
2012-05-24,1,Thursday,Summer,1,Early Morning,30,9,21
2012-05-24,2,Thursday,Summer,1,Early Morning,16,1,15
2012-05-24,3,Thursday,Summer,2,Early Morning,4,1,3
2012-05-24,4,Thursday,Summer,2,Early Morning,5,0,5
2012-05-24,5,Thursday,Summer,2,Early Morning,30,1,29
2012-05-24,6,Thursday,Summer,2,Morning Rush,156,10,146
2012-05-24,7,Thursday,Summer,1,Morning Rush,415,22,393
2012-05-24,8,Thursday,Summer,1,Morning Rush,692,33,659
2012-05-24,9,Thursday,Summer,1,Morning Rush,301,34,267
2012-05-24,10,Thursday,Summer,1,Mid-Day,185,47,138
2012-05-24,11,Thursday,Summer,1,Mid-Day,221,61,160
2012-05-24,12,Thursday,Summer,1,Mid-Day,289,76,213
2012-05-24,13,Thursday,Summer,1,Mid-Day,302,69,233
2012-05-24,14,Thursday,Summer,1,Mid-Day,252,72,180
2012-05-24,15,Thursday,Summer,1,Mid-Day,291,69,222
2012-05-24,16,Thursday,Summer,1,Evening Rush,390,61,329
2012-05-24,17,Thursday,Summer,1,Evening Rush,798,120,678
2012-05-24,18,Thursday,Summer,1,Evening Rush,752,118,634
2012-05-24,19,Thursday,Summer,1,Evening Rush,492,76,416
2012-05-24,20,Thursday,Summer,2,Night,398,55,343
2012-05-24,21,Thursday,Summer,3,Night,285,48,237
2012-05-24,22,Thursday,Summer,2,Night,243,33,210
2012-05-24,23,Thursday,Summer,2,Night,167,36,131
2012-05-25,0,Friday,Summer,1,Early Morning,73,10,63
2012-05-25,1,Friday,Summer,1,Early Morning,42,8,34
2012-05-25,2,Friday,Summer,2,Early Morning,23,7,16
2012-05-25,3,Friday,Summer,2,Early Morning,14,8,6
2012-05-25,4,Friday,Summer,2,Early Morning,9,3,6
2012-05-25,5,Friday,Summer,2,Early Morning,30,2,28
2012-05-25,6,Friday,Summer,2,Morning Rush,113,5,108
2012-05-25,7,Friday,Summer,2,Morning Rush,359,7,352
2012-05-25,8,Friday,Summer,2,Morning Rush,583,32,551
2012-05-25,9,Friday,Summer,2,Morning Rush,340,52,288
2012-05-25,10,Friday,Summer,1,Mid-Day,232,69,163
2012-05-25,11,Friday,Summer,1,Mid-Day,283,90,193
2012-05-25,12,Friday,Summer,1,Mid-Day,321,84,237
2012-05-25,13,Friday,Summer,1,Mid-Day,333,86,247
2012-05-25,14,Friday,Summer,1,Mid-Day,367,104,263
2012-05-25,15,Friday,Summer,1,Mid-Day,466,106,360
2012-05-25,16,Friday,Summer,1,Evening Rush,584,137,447
2012-05-25,17,Friday,Summer,1,Evening Rush,653,124,529
2012-05-25,18,Friday,Summer,1,Evening Rush,522,131,391
2012-05-25,19,Friday,Summer,1,Evening Rush,404,111,293
2012-05-25,20,Friday,Summer,1,Night,350,80,270
2012-05-25,21,Friday,Summer,1,Night,255,62,193
2012-05-25,22,Friday,Summer,1,Night,212,65,147
2012-05-25,23,Friday,Summer,1,Night,166,34,132
2012-05-26,0,Saturday,Summer,1,Early Morning,116,18,98
2012-05-26,1,Saturday,Summer,1,Early Morning,82,18,64
2012-05-26,2,Saturday,Summer,1,Early Morning,64,9,55
2012-05-26,3,Saturday,Summer,1,Early Morning,31,9,22
2012-05-26,4,Saturday,Summer,1,Early Morning,2,0,2
2012-05-26,5,Saturday,Summer,1,Early Morning,10,0,10
2012-05-26,6,Saturday,Summer,1,Morning Rush,31,6,25
2012-05-26,7,Saturday,Summer,2,Morning Rush,54,10,44
2012-05-26,8,Saturday,Summer,1,Morning Rush,141,38,103
2012-05-26,9,Saturday,Summer,1,Morning Rush,289,97,192
2012-05-26,10,Saturday,Summer,1,Mid-Day,437,181,256
2012-05-26,11,Saturday,Summer,1,Mid-Day,520,208,312
2012-05-26,12,Saturday,Summer,1,Mid-Day,529,236,293
2012-05-26,13,Saturday,Summer,1,Mid-Day,539,265,274
2012-05-26,14,Saturday,Summer,1,Mid-Day,564,307,257
2012-05-26,15,Saturday,Summer,1,Mid-Day,513,274,239
2012-05-26,16,Saturday,Summer,1,Evening Rush,504,261,243
2012-05-26,17,Saturday,Summer,2,Evening Rush,462,235,227
2012-05-26,18,Saturday,Summer,2,Evening Rush,415,199,216
2012-05-26,19,Saturday,Summer,2,Evening Rush,373,159,214
2012-05-26,20,Saturday,Summer,2,Night,255,103,152
2012-05-26,21,Saturday,Summer,2,Night,251,100,151
2012-05-26,22,Saturday,Summer,1,Night,204,86,118
2012-05-26,23,Saturday,Summer,1,Night,150,36,114
2012-05-27,0,Sunday,Summer,2,Early Morning,137,48,89
2012-05-27,1,Sunday,Summer,1,Early Morning,78,17,61
2012-05-27,2,Sunday,Summer,1,Early Morning,61,16,45
2012-05-27,3,Sunday,Summer,1,Early Morning,36,11,25
2012-05-27,4,Sunday,Summer,1,Early Morning,11,4,7
2012-05-27,5,Sunday,Summer,1,Early Morning,7,2,5
2012-05-27,6,Sunday,Summer,1,Morning Rush,22,8,14
2012-05-27,7,Sunday,Summer,1,Morning Rush,52,22,30
2012-05-27,8,Sunday,Summer,1,Morning Rush,151,69,82
2012-05-27,9,Sunday,Summer,1,Morning Rush,270,130,140
2012-05-27,10,Sunday,Summer,1,Mid-Day,424,209,215
2012-05-27,11,Sunday,Summer,1,Mid-Day,519,268,251
2012-05-27,12,Sunday,Summer,1,Mid-Day,570,301,269
2012-05-27,13,Sunday,Summer,1,Mid-Day,498,270,228
2012-05-27,14,Sunday,Summer,1,Mid-Day,547,317,230
2012-05-27,15,Sunday,Summer,1,Mid-Day,535,290,245
2012-05-27,16,Sunday,Summer,1,Evening Rush,501,258,243
2012-05-27,17,Sunday,Summer,1,Evening Rush,522,275,247
2012-05-27,18,Sunday,Summer,1,Evening Rush,518,266,252
2012-05-27,19,Sunday,Summer,1,Evening Rush,442,230,212
2012-05-27,20,Sunday,Summer,1,Night,392,168,224
2012-05-27,21,Sunday,Summer,3,Night,143,64,79
2012-05-27,22,Sunday,Summer,3,Night,59,9,50
2012-05-27,23,Sunday,Summer,3,Night,96,31,65
2012-05-28,0,Monday,Summer,1,Early Morning,65,21,44
2012-05-28,1,Monday,Summer,2,Early Morning,59,14,45
2012-05-28,2,Monday,Summer,1,Early Morning,48,20,28
2012-05-28,3,Monday,Summer,1,Early Morning,18,6,12
2012-05-28,4,Monday,Summer,1,Early Morning,6,2,4
2012-05-28,5,Monday,Summer,1,Early Morning,9,4,5
2012-05-28,6,Monday,Summer,1,Morning Rush,20,6,14
2012-05-28,7,Monday,Summer,1,Morning Rush,67,24,43
2012-05-28,8,Monday,Summer,1,Morning Rush,155,62,93
2012-05-28,9,Monday,Summer,1,Morning Rush,263,121,142
2012-05-28,10,Monday,Summer,1,Mid-Day,364,189,175
2012-05-28,11,Monday,Summer,1,Mid-Day,476,254,222
2012-05-28,12,Monday,Summer,1,Mid-Day,525,233,292
2012-05-28,13,Monday,Summer,1,Mid-Day,556,272,284
2012-05-28,14,Monday,Summer,1,Mid-Day,465,238,227
2012-05-28,15,Monday,Summer,1,Mid-Day,460,181,279
2012-05-28,16,Monday,Summer,1,Evening Rush,501,223,278
2012-05-28,17,Monday,Summer,1,Evening Rush,405,158,247
2012-05-28,18,Monday,Summer,1,Evening Rush,383,132,251
2012-05-28,19,Monday,Summer,1,Evening Rush,395,148,247
2012-05-28,20,Monday,Summer,1,Night,317,114,203
2012-05-28,21,Monday,Summer,1,Night,247,66,181
2012-05-28,22,Monday,Summer,1,Night,157,47,110
2012-05-28,23,Monday,Summer,1,Night,82,22,60
2012-05-29,0,Tuesday,Summer,1,Early Morning,45,12,33
2012-05-29,1,Tuesday,Summer,1,Early Morning,14,1,13
2012-05-29,2,Tuesday,Summer,1,Early Morning,8,0,8
2012-05-29,3,Tuesday,Summer,1,Early Morning,3,1,2
2012-05-29,4,Tuesday,Summer,1,Early Morning,5,0,5
2012-05-29,5,Tuesday,Summer,1,Early Morning,33,1,32
2012-05-29,6,Tuesday,Summer,1,Morning Rush,154,9,145
2012-05-29,7,Tuesday,Summer,1,Morning Rush,450,19,431
2012-05-29,8,Tuesday,Summer,1,Morning Rush,634,46,588
2012-05-29,9,Tuesday,Summer,1,Morning Rush,257,26,231
2012-05-29,10,Tuesday,Summer,1,Mid-Day,183,67,116
2012-05-29,11,Tuesday,Summer,1,Mid-Day,197,50,147
2012-05-29,12,Tuesday,Summer,1,Mid-Day,237,56,181
2012-05-29,13,Tuesday,Summer,1,Mid-Day,239,63,176
2012-05-29,14,Tuesday,Summer,1,Mid-Day,238,80,158
2012-05-29,15,Tuesday,Summer,1,Mid-Day,256,71,185
2012-05-29,16,Tuesday,Summer,1,Evening Rush,393,73,320
2012-05-29,17,Tuesday,Summer,1,Evening Rush,781,107,674
2012-05-29,18,Tuesday,Summer,1,Evening Rush,710,78,632
2012-05-29,19,Tuesday,Summer,1,Evening Rush,526,69,457
2012-05-29,20,Tuesday,Summer,3,Night,204,36,168
2012-05-29,21,Tuesday,Summer,3,Night,71,3,68
2012-05-29,22,Tuesday,Summer,2,Night,55,2,53
2012-05-29,23,Tuesday,Summer,3,Night,50,10,40
2012-05-30,0,Wednesday,Summer,3,Early Morning,36,4,32
2012-05-30,1,Wednesday,Summer,3,Early Morning,4,0,4
2012-05-30,2,Wednesday,Summer,3,Early Morning,5,1,4
2012-05-30,3,Wednesday,Summer,3,Early Morning,5,0,5
2012-05-30,4,Wednesday,Summer,2,Early Morning,6,0,6
2012-05-30,5,Wednesday,Summer,2,Early Morning,41,1,40
2012-05-30,6,Wednesday,Summer,2,Morning Rush,144,5,139
2012-05-30,7,Wednesday,Summer,3,Morning Rush,483,14,469
2012-05-30,8,Wednesday,Summer,2,Morning Rush,671,29,642
2012-05-30,9,Wednesday,Summer,2,Morning Rush,305,23,282
2012-05-30,10,Wednesday,Summer,2,Mid-Day,177,39,138
2012-05-30,11,Wednesday,Summer,2,Mid-Day,208,53,155
2012-05-30,12,Wednesday,Summer,1,Mid-Day,253,33,220
2012-05-30,13,Wednesday,Summer,1,Mid-Day,289,53,236
2012-05-30,14,Wednesday,Summer,1,Mid-Day,252,44,208
2012-05-30,15,Wednesday,Summer,1,Mid-Day,275,54,221
2012-05-30,16,Wednesday,Summer,1,Evening Rush,398,46,352
2012-05-30,17,Wednesday,Summer,1,Evening Rush,839,83,756
2012-05-30,18,Wednesday,Summer,1,Evening Rush,796,50,746
2012-05-30,19,Wednesday,Summer,1,Evening Rush,556,50,506
2012-05-30,20,Wednesday,Summer,2,Night,431,57,374
2012-05-30,21,Wednesday,Summer,1,Night,304,41,263
2012-05-30,22,Wednesday,Summer,1,Night,217,26,191
2012-05-30,23,Wednesday,Summer,1,Night,160,39,121
2012-05-31,0,Thursday,Summer,1,Early Morning,61,13,48
2012-05-31,1,Thursday,Summer,1,Early Morning,26,4,22
2012-05-31,2,Thursday,Summer,1,Early Morning,14,6,8
2012-05-31,3,Thursday,Summer,1,Early Morning,8,0,8
2012-05-31,4,Thursday,Summer,1,Early Morning,8,0,8
2012-05-31,5,Thursday,Summer,1,Early Morning,33,1,32
2012-05-31,6,Thursday,Summer,1,Morning Rush,178,7,171
2012-05-31,7,Thursday,Summer,1,Morning Rush,507,18,489
2012-05-31,8,Thursday,Summer,1,Morning Rush,693,18,675
2012-05-31,9,Thursday,Summer,1,Morning Rush,311,47,264
2012-05-31,10,Thursday,Summer,1,Mid-Day,220,65,155
2012-05-31,11,Thursday,Summer,1,Mid-Day,218,65,153
2012-05-31,12,Thursday,Summer,1,Mid-Day,292,62,230
2012-05-31,13,Thursday,Summer,1,Mid-Day,293,77,216
2012-05-31,14,Thursday,Summer,1,Mid-Day,254,61,193
2012-05-31,15,Thursday,Summer,1,Mid-Day,290,81,209
2012-05-31,16,Thursday,Summer,1,Evening Rush,487,103,384
2012-05-31,17,Thursday,Summer,1,Evening Rush,827,85,742
2012-05-31,18,Thursday,Summer,1,Evening Rush,785,85,700
2012-05-31,19,Thursday,Summer,1,Evening Rush,591,104,487
2012-05-31,20,Thursday,Summer,1,Night,479,88,391
2012-05-31,21,Thursday,Summer,1,Night,359,41,318
2012-05-31,22,Thursday,Summer,1,Night,264,43,221
2012-05-31,23,Thursday,Summer,1,Night,140,26,114
2012-06-01,0,Friday,Summer,1,Early Morning,86,10,76
2012-06-01,1,Friday,Summer,1,Early Morning,34,0,34
2012-06-01,2,Friday,Summer,1,Early Morning,16,3,13
2012-06-01,3,Friday,Summer,2,Early Morning,4,0,4
2012-06-01,4,Friday,Summer,2,Early Morning,6,1,5
2012-06-01,5,Friday,Summer,2,Early Morning,45,4,41
2012-06-01,6,Friday,Summer,3,Morning Rush,141,5,136
2012-06-01,7,Friday,Summer,2,Morning Rush,402,33,369
2012-06-01,8,Friday,Summer,2,Morning Rush,694,19,675
2012-06-01,9,Friday,Summer,2,Morning Rush,298,24,274
2012-06-01,10,Friday,Summer,2,Mid-Day,204,49,155
2012-06-01,11,Friday,Summer,2,Mid-Day,235,42,193
2012-06-01,12,Friday,Summer,2,Mid-Day,310,72,238
2012-06-01,13,Friday,Summer,1,Mid-Day,316,76,240
2012-06-01,14,Friday,Summer,3,Mid-Day,254,55,199
2012-06-01,15,Friday,Summer,3,Mid-Day,258,45,213
2012-06-01,16,Friday,Summer,3,Evening Rush,222,36,186
2012-06-01,17,Friday,Summer,3,Evening Rush,227,25,202
2012-06-01,18,Friday,Summer,3,Evening Rush,110,10,100
2012-06-01,19,Friday,Summer,3,Evening Rush,45,4,41
2012-06-01,20,Friday,Summer,3,Night,39,1,38
2012-06-01,21,Friday,Summer,3,Night,85,12,73
2012-06-01,22,Friday,Summer,3,Night,23,1,22
2012-06-01,23,Friday,Summer,3,Night,73,6,67
2012-06-02,0,Saturday,Summer,2,Early Morning,86,5,81
2012-06-02,1,Saturday,Summer,2,Early Morning,76,15,61
2012-06-02,2,Saturday,Summer,2,Early Morning,41,3,38
2012-06-02,3,Saturday,Summer,1,Early Morning,26,8,18
2012-06-02,4,Saturday,Summer,1,Early Morning,13,2,11
2012-06-02,5,Saturday,Summer,1,Early Morning,12,1,11
2012-06-02,6,Saturday,Summer,2,Morning Rush,36,5,31
2012-06-02,7,Saturday,Summer,1,Morning Rush,86,9,77
2012-06-02,8,Saturday,Summer,1,Morning Rush,210,30,180
2012-06-02,9,Saturday,Summer,1,Morning Rush,332,89,243
2012-06-02,10,Saturday,Summer,1,Mid-Day,493,145,348
2012-06-02,11,Saturday,Summer,1,Mid-Day,536,179,357
2012-06-02,12,Saturday,Summer,1,Mid-Day,668,250,418
2012-06-02,13,Saturday,Summer,1,Mid-Day,679,279,400
2012-06-02,14,Saturday,Summer,1,Mid-Day,647,259,388
2012-06-02,15,Saturday,Summer,1,Mid-Day,702,297,405
2012-06-02,16,Saturday,Summer,1,Evening Rush,644,275,369
2012-06-02,17,Saturday,Summer,1,Evening Rush,586,248,338
2012-06-02,18,Saturday,Summer,1,Evening Rush,512,171,341
2012-06-02,19,Saturday,Summer,1,Evening Rush,554,185,369
2012-06-02,20,Saturday,Summer,1,Night,399,139,260
2012-06-02,21,Saturday,Summer,1,Night,316,96,220
2012-06-02,22,Saturday,Summer,1,Night,228,52,176
2012-06-02,23,Saturday,Summer,1,Night,238,53,185
2012-06-03,0,Sunday,Summer,1,Early Morning,169,27,142
2012-06-03,1,Sunday,Summer,1,Early Morning,121,21,100
2012-06-03,2,Sunday,Summer,1,Early Morning,89,22,67
2012-06-03,3,Sunday,Summer,1,Early Morning,50,16,34
2012-06-03,4,Sunday,Summer,1,Early Morning,13,1,12
2012-06-03,5,Sunday,Summer,1,Early Morning,12,1,11
2012-06-03,6,Sunday,Summer,1,Morning Rush,22,6,16
2012-06-03,7,Sunday,Summer,1,Morning Rush,35,6,29
2012-06-03,8,Sunday,Summer,1,Morning Rush,140,30,110
2012-06-03,9,Sunday,Summer,1,Morning Rush,300,70,230
2012-06-03,10,Sunday,Summer,1,Mid-Day,404,127,277
2012-06-03,11,Sunday,Summer,1,Mid-Day,511,199,312
2012-06-03,12,Sunday,Summer,1,Mid-Day,684,276,408
2012-06-03,13,Sunday,Summer,1,Mid-Day,686,265,421
2012-06-03,14,Sunday,Summer,1,Mid-Day,678,267,411
2012-06-03,15,Sunday,Summer,1,Mid-Day,644,236,408
2012-06-03,16,Sunday,Summer,1,Evening Rush,662,226,436
2012-06-03,17,Sunday,Summer,1,Evening Rush,578,192,386
2012-06-03,18,Sunday,Summer,1,Evening Rush,496,153,343
2012-06-03,19,Sunday,Summer,1,Evening Rush,453,116,337
2012-06-03,20,Sunday,Summer,1,Night,314,84,230
2012-06-03,21,Sunday,Summer,1,Night,246,66,180
2012-06-03,22,Sunday,Summer,1,Night,226,61,165
2012-06-03,23,Sunday,Summer,1,Night,108,26,82
2012-06-04,0,Monday,Summer,1,Early Morning,49,11,38
2012-06-04,1,Monday,Summer,3,Early Morning,14,4,10
2012-06-04,2,Monday,Summer,1,Early Morning,11,1,10
2012-06-04,3,Monday,Summer,2,Early Morning,5,0,5
2012-06-04,4,Monday,Summer,1,Early Morning,8,2,6
2012-06-04,5,Monday,Summer,1,Early Morning,35,2,33
2012-06-04,6,Monday,Summer,1,Morning Rush,139,4,135
2012-06-04,7,Monday,Summer,1,Morning Rush,517,13,504
2012-06-04,8,Monday,Summer,1,Morning Rush,665,22,643
2012-06-04,9,Monday,Summer,1,Morning Rush,282,38,244
2012-06-04,10,Monday,Summer,1,Mid-Day,187,67,120
2012-06-04,11,Monday,Summer,1,Mid-Day,239,71,168
2012-06-04,12,Monday,Summer,1,Mid-Day,282,62,220
2012-06-04,13,Monday,Summer,1,Mid-Day,274,85,189
2012-06-04,14,Monday,Summer,1,Mid-Day,270,84,186
2012-06-04,15,Monday,Summer,1,Mid-Day,292,77,215
2012-06-04,16,Monday,Summer,1,Evening Rush,448,73,375
2012-06-04,17,Monday,Summer,1,Evening Rush,834,101,733
2012-06-04,18,Monday,Summer,1,Evening Rush,822,103,719
2012-06-04,19,Monday,Summer,1,Evening Rush,645,91,554
2012-06-04,20,Monday,Summer,1,Night,461,71,390
2012-06-04,21,Monday,Summer,1,Night,265,40,225
2012-06-04,22,Monday,Summer,1,Night,168,41,127
2012-06-04,23,Monday,Summer,1,Night,86,8,78
2012-06-05,0,Tuesday,Summer,1,Early Morning,34,6,28
2012-06-05,1,Tuesday,Summer,2,Early Morning,20,2,18
2012-06-05,2,Tuesday,Summer,3,Early Morning,8,0,8
2012-06-05,3,Tuesday,Summer,3,Early Morning,5,0,5
2012-06-05,4,Tuesday,Summer,3,Early Morning,5,1,4
2012-06-05,5,Tuesday,Summer,3,Early Morning,36,1,35
2012-06-05,6,Tuesday,Summer,1,Morning Rush,184,7,177
2012-06-05,7,Tuesday,Summer,1,Morning Rush,569,29,540
2012-06-05,8,Tuesday,Summer,2,Morning Rush,710,30,680
2012-06-05,9,Tuesday,Summer,2,Morning Rush,335,50,285
2012-06-05,10,Tuesday,Summer,2,Mid-Day,176,58,118
2012-06-05,11,Tuesday,Summer,2,Mid-Day,227,65,162
2012-06-05,12,Tuesday,Summer,2,Mid-Day,247,45,202
2012-06-05,13,Tuesday,Summer,2,Mid-Day,267,66,201
2012-06-05,14,Tuesday,Summer,2,Mid-Day,276,82,194
2012-06-05,15,Tuesday,Summer,2,Mid-Day,272,54,218
2012-06-05,16,Tuesday,Summer,1,Evening Rush,473,91,382
2012-06-05,17,Tuesday,Summer,1,Evening Rush,850,86,764
2012-06-05,18,Tuesday,Summer,1,Evening Rush,790,111,679
2012-06-05,19,Tuesday,Summer,1,Evening Rush,513,68,445
2012-06-05,20,Tuesday,Summer,1,Night,415,44,371
2012-06-05,21,Tuesday,Summer,1,Night,283,30,253
2012-06-05,22,Tuesday,Summer,1,Night,193,22,171
2012-06-05,23,Tuesday,Summer,1,Night,113,20,93
2012-06-06,0,Wednesday,Summer,1,Early Morning,49,3,46
2012-06-06,1,Wednesday,Summer,1,Early Morning,27,6,21
2012-06-06,2,Wednesday,Summer,1,Early Morning,11,4,7
2012-06-06,3,Wednesday,Summer,1,Early Morning,8,0,8
2012-06-06,4,Wednesday,Summer,1,Early Morning,10,3,7
2012-06-06,5,Wednesday,Summer,1,Early Morning,38,1,37
2012-06-06,6,Wednesday,Summer,1,Morning Rush,172,7,165
2012-06-06,7,Wednesday,Summer,1,Morning Rush,547,16,531
2012-06-06,8,Wednesday,Summer,1,Morning Rush,668,31,637
2012-06-06,9,Wednesday,Summer,1,Morning Rush,303,35,268
2012-06-06,10,Wednesday,Summer,1,Mid-Day,203,55,148
2012-06-06,11,Wednesday,Summer,1,Mid-Day,226,65,161
2012-06-06,12,Wednesday,Summer,1,Mid-Day,315,80,235
2012-06-06,13,Wednesday,Summer,1,Mid-Day,303,73,230
2012-06-06,14,Wednesday,Summer,1,Mid-Day,302,111,191
2012-06-06,15,Wednesday,Summer,1,Mid-Day,300,75,225
2012-06-06,16,Wednesday,Summer,1,Evening Rush,452,107,345
2012-06-06,17,Wednesday,Summer,1,Evening Rush,724,72,652
2012-06-06,18,Wednesday,Summer,3,Evening Rush,782,94,688
2012-06-06,19,Wednesday,Summer,1,Evening Rush,538,52,486
2012-06-06,20,Wednesday,Summer,1,Night,408,59,349
2012-06-06,21,Wednesday,Summer,1,Night,298,38,260
2012-06-06,22,Wednesday,Summer,1,Night,248,27,221
2012-06-06,23,Wednesday,Summer,1,Night,123,13,110
2012-06-07,0,Thursday,Summer,1,Early Morning,59,9,50
2012-06-07,1,Thursday,Summer,1,Early Morning,22,5,17
2012-06-07,2,Thursday,Summer,1,Early Morning,12,0,12
2012-06-07,3,Thursday,Summer,1,Early Morning,5,0,5
2012-06-07,4,Thursday,Summer,1,Early Morning,6,0,6
2012-06-07,5,Thursday,Summer,1,Early Morning,34,0,34
2012-06-07,6,Thursday,Summer,1,Morning Rush,170,5,165
2012-06-07,7,Thursday,Summer,1,Morning Rush,526,20,506
2012-06-07,8,Thursday,Summer,1,Morning Rush,681,20,661
2012-06-07,9,Thursday,Summer,1,Morning Rush,337,37,300
2012-06-07,10,Thursday,Summer,1,Mid-Day,210,56,154
2012-06-07,11,Thursday,Summer,1,Mid-Day,237,67,170
2012-06-07,12,Thursday,Summer,1,Mid-Day,336,62,274
2012-06-07,13,Thursday,Summer,1,Mid-Day,315,65,250
2012-06-07,14,Thursday,Summer,1,Mid-Day,265,67,198
2012-06-07,15,Thursday,Summer,1,Mid-Day,333,99,234
2012-06-07,16,Thursday,Summer,1,Evening Rush,466,77,389
2012-06-07,17,Thursday,Summer,1,Evening Rush,869,91,778
2012-06-07,18,Thursday,Summer,1,Evening Rush,813,110,703
2012-06-07,19,Thursday,Summer,1,Evening Rush,602,65,537
2012-06-07,20,Thursday,Summer,1,Night,478,76,402
2012-06-07,21,Thursday,Summer,1,Night,313,30,283
2012-06-07,22,Thursday,Summer,1,Night,228,35,193
2012-06-07,23,Thursday,Summer,1,Night,177,42,135
2012-06-08,0,Friday,Summer,1,Early Morning,77,18,59
2012-06-08,1,Friday,Summer,1,Early Morning,29,4,25
2012-06-08,2,Friday,Summer,1,Early Morning,19,2,17
2012-06-08,3,Friday,Summer,1,Early Morning,8,0,8
2012-06-08,4,Friday,Summer,1,Early Morning,10,1,9
2012-06-08,5,Friday,Summer,1,Early Morning,29,1,28
2012-06-08,6,Friday,Summer,1,Morning Rush,139,8,131
2012-06-08,7,Friday,Summer,1,Morning Rush,428,19,409
2012-06-08,8,Friday,Summer,1,Morning Rush,700,37,663
2012-06-08,9,Friday,Summer,1,Morning Rush,382,47,335
2012-06-08,10,Friday,Summer,1,Mid-Day,249,62,187
2012-06-08,11,Friday,Summer,1,Mid-Day,264,65,199
2012-06-08,12,Friday,Summer,1,Mid-Day,369,89,280
2012-06-08,13,Friday,Summer,1,Mid-Day,416,129,287
2012-06-08,14,Friday,Summer,1,Mid-Day,373,128,245
2012-06-08,15,Friday,Summer,1,Mid-Day,397,98,299
2012-06-08,16,Friday,Summer,1,Evening Rush,523,111,412
2012-06-08,17,Friday,Summer,1,Evening Rush,793,114,679
2012-06-08,18,Friday,Summer,1,Evening Rush,723,147,576
2012-06-08,19,Friday,Summer,1,Evening Rush,555,95,460
2012-06-08,20,Friday,Summer,1,Night,408,117,291
2012-06-08,21,Friday,Summer,1,Night,339,83,256
2012-06-08,22,Friday,Summer,1,Night,291,61,230
2012-06-08,23,Friday,Summer,1,Night,215,52,163
2012-06-09,0,Saturday,Summer,1,Early Morning,206,54,152
2012-06-09,1,Saturday,Summer,1,Early Morning,123,34,89
2012-06-09,2,Saturday,Summer,1,Early Morning,89,21,68
2012-06-09,3,Saturday,Summer,1,Early Morning,40,12,28
2012-06-09,4,Saturday,Summer,1,Early Morning,8,2,6
2012-06-09,5,Saturday,Summer,1,Early Morning,19,4,15
2012-06-09,6,Saturday,Summer,1,Morning Rush,80,17,63
2012-06-09,7,Saturday,Summer,1,Morning Rush,87,26,61
2012-06-09,8,Saturday,Summer,1,Morning Rush,244,42,202
2012-06-09,9,Saturday,Summer,1,Morning Rush,340,99,241
2012-06-09,10,Saturday,Summer,1,Mid-Day,466,168,298
2012-06-09,11,Saturday,Summer,1,Mid-Day,569,218,351
2012-06-09,12,Saturday,Summer,1,Mid-Day,531,196,335
2012-06-09,13,Saturday,Summer,1,Mid-Day,585,236,349
2012-06-09,14,Saturday,Summer,1,Mid-Day,593,239,354
2012-06-09,15,Saturday,Summer,1,Mid-Day,555,218,337
2012-06-09,16,Saturday,Summer,1,Evening Rush,534,219,315
2012-06-09,17,Saturday,Summer,1,Evening Rush,495,238,257
2012-06-09,18,Saturday,Summer,1,Evening Rush,451,175,276
2012-06-09,19,Saturday,Summer,1,Evening Rush,360,128,232
2012-06-09,20,Saturday,Summer,1,Night,363,125,238
2012-06-09,21,Saturday,Summer,1,Night,316,105,211
2012-06-09,22,Saturday,Summer,1,Night,214,63,151
2012-06-09,23,Saturday,Summer,1,Night,230,69,161
2012-06-10,0,Sunday,Summer,1,Early Morning,158,33,125
2012-06-10,1,Sunday,Summer,1,Early Morning,116,32,84
2012-06-10,2,Sunday,Summer,1,Early Morning,73,17,56
2012-06-10,3,Sunday,Summer,1,Early Morning,29,6,23
2012-06-10,4,Sunday,Summer,1,Early Morning,10,1,9
2012-06-10,5,Sunday,Summer,1,Early Morning,13,3,10
2012-06-10,6,Sunday,Summer,1,Morning Rush,30,3,27
2012-06-10,7,Sunday,Summer,1,Morning Rush,62,21,41
2012-06-10,8,Sunday,Summer,1,Morning Rush,181,59,122
2012-06-10,9,Sunday,Summer,1,Morning Rush,266,91,175
2012-06-10,10,Sunday,Summer,1,Mid-Day,413,148,265
2012-06-10,11,Sunday,Summer,1,Mid-Day,499,184,315
2012-06-10,12,Sunday,Summer,1,Mid-Day,502,173,329
2012-06-10,13,Sunday,Summer,1,Mid-Day,492,204,288
2012-06-10,14,Sunday,Summer,1,Mid-Day,500,186,314
2012-06-10,15,Sunday,Summer,1,Mid-Day,475,159,316
2012-06-10,16,Sunday,Summer,1,Evening Rush,508,173,335
2012-06-10,17,Sunday,Summer,1,Evening Rush,521,184,337
2012-06-10,18,Sunday,Summer,1,Evening Rush,490,164,326
2012-06-10,19,Sunday,Summer,1,Evening Rush,375,115,260
2012-06-10,20,Sunday,Summer,1,Night,363,113,250
2012-06-10,21,Sunday,Summer,1,Night,253,83,170
2012-06-10,22,Sunday,Summer,1,Night,159,42,117
2012-06-10,23,Sunday,Summer,1,Night,110,30,80
2012-06-11,0,Monday,Summer,1,Early Morning,41,8,33
2012-06-11,1,Monday,Summer,1,Early Morning,24,9,15
2012-06-11,2,Monday,Summer,1,Early Morning,17,5,12
2012-06-11,3,Monday,Summer,1,Early Morning,6,2,4
2012-06-11,4,Monday,Summer,1,Early Morning,7,0,7
2012-06-11,5,Monday,Summer,1,Early Morning,37,1,36
2012-06-11,6,Monday,Summer,1,Morning Rush,144,8,136
2012-06-11,7,Monday,Summer,1,Morning Rush,503,25,478
2012-06-11,8,Monday,Summer,1,Morning Rush,651,38,613
2012-06-11,9,Monday,Summer,1,Morning Rush,316,57,259
2012-06-11,10,Monday,Summer,1,Mid-Day,147,52,95
2012-06-11,11,Monday,Summer,2,Mid-Day,202,59,143
2012-06-11,12,Monday,Summer,2,Mid-Day,261,63,198
2012-06-11,13,Monday,Summer,2,Mid-Day,248,63,185
2012-06-11,14,Monday,Summer,2,Mid-Day,259,66,193
2012-06-11,15,Monday,Summer,1,Mid-Day,259,72,187
2012-06-11,16,Monday,Summer,2,Evening Rush,427,87,340
2012-06-11,17,Monday,Summer,2,Evening Rush,800,85,715
2012-06-11,18,Monday,Summer,2,Evening Rush,831,105,726
2012-06-11,19,Monday,Summer,2,Evening Rush,596,89,507
2012-06-11,20,Monday,Summer,2,Night,394,61,333
2012-06-11,21,Monday,Summer,2,Night,250,32,218
2012-06-11,22,Monday,Summer,2,Night,164,22,142
2012-06-11,23,Monday,Summer,2,Night,80,8,72
2012-06-12,0,Tuesday,Summer,2,Early Morning,28,2,26
2012-06-12,1,Tuesday,Summer,2,Early Morning,16,5,11
2012-06-12,2,Tuesday,Summer,2,Early Morning,6,0,6
2012-06-12,3,Tuesday,Summer,2,Early Morning,12,3,9
2012-06-12,4,Tuesday,Summer,3,Early Morning,4,0,4
2012-06-12,5,Tuesday,Summer,3,Early Morning,29,1,28
2012-06-12,6,Tuesday,Summer,2,Morning Rush,136,6,130
2012-06-12,7,Tuesday,Summer,3,Morning Rush,303,16,287
2012-06-12,8,Tuesday,Summer,2,Morning Rush,613,15,598
2012-06-12,9,Tuesday,Summer,2,Morning Rush,285,31,254
2012-06-12,10,Tuesday,Summer,3,Mid-Day,125,29,96
2012-06-12,11,Tuesday,Summer,3,Mid-Day,65,8,57
2012-06-12,12,Tuesday,Summer,3,Mid-Day,95,19,76
2012-06-12,13,Tuesday,Summer,3,Mid-Day,59,11,48
2012-06-12,14,Tuesday,Summer,3,Mid-Day,60,12,48
2012-06-12,15,Tuesday,Summer,3,Mid-Day,116,22,94
2012-06-12,16,Tuesday,Summer,2,Evening Rush,239,30,209
2012-06-12,17,Tuesday,Summer,2,Evening Rush,681,56,625
2012-06-12,18,Tuesday,Summer,1,Evening Rush,653,57,596
2012-06-12,19,Tuesday,Summer,1,Evening Rush,491,47,444
2012-06-12,20,Tuesday,Summer,1,Night,386,36,350
2012-06-12,21,Tuesday,Summer,1,Night,274,41,233
2012-06-12,22,Tuesday,Summer,1,Night,207,19,188
2012-06-12,23,Tuesday,Summer,3,Night,89,11,78
2012-06-13,0,Wednesday,Summer,2,Early Morning,34,7,27
2012-06-13,1,Wednesday,Summer,1,Early Morning,28,7,21
2012-06-13,2,Wednesday,Summer,1,Early Morning,4,0,4
2012-06-13,3,Wednesday,Summer,1,Early Morning,8,1,7
2012-06-13,4,Wednesday,Summer,1,Early Morning,10,1,9
2012-06-13,5,Wednesday,Summer,1,Early Morning,40,2,38
2012-06-13,6,Wednesday,Summer,1,Morning Rush,194,6,188
2012-06-13,7,Wednesday,Summer,1,Morning Rush,505,25,480
2012-06-13,8,Wednesday,Summer,2,Morning Rush,713,41,672
2012-06-13,9,Wednesday,Summer,2,Morning Rush,352,54,298
2012-06-13,10,Wednesday,Summer,2,Mid-Day,198,64,134
2012-06-13,11,Wednesday,Summer,2,Mid-Day,246,64,182
2012-06-13,12,Wednesday,Summer,2,Mid-Day,334,93,241
2012-06-13,13,Wednesday,Summer,2,Mid-Day,255,52,203
2012-06-13,14,Wednesday,Summer,2,Mid-Day,320,98,222
2012-06-13,15,Wednesday,Summer,1,Mid-Day,281,65,216
2012-06-13,16,Wednesday,Summer,1,Evening Rush,392,72,320
2012-06-13,17,Wednesday,Summer,1,Evening Rush,857,75,782
2012-06-13,18,Wednesday,Summer,1,Evening Rush,744,104,640
2012-06-13,19,Wednesday,Summer,1,Evening Rush,671,123,548
2012-06-13,20,Wednesday,Summer,1,Night,448,86,362
2012-06-13,21,Wednesday,Summer,1,Night,396,79,317
2012-06-13,22,Wednesday,Summer,1,Night,238,29,209
2012-06-13,23,Wednesday,Summer,1,Night,153,25,128
2012-06-14,0,Thursday,Summer,1,Early Morning,48,3,45
2012-06-14,1,Thursday,Summer,1,Early Morning,21,4,17
2012-06-14,2,Thursday,Summer,2,Early Morning,9,1,8
2012-06-14,3,Thursday,Summer,2,Early Morning,5,1,4
2012-06-14,4,Thursday,Summer,2,Early Morning,6,0,6
2012-06-14,5,Thursday,Summer,2,Early Morning,40,0,40
2012-06-14,6,Thursday,Summer,1,Morning Rush,181,12,169
2012-06-14,7,Thursday,Summer,1,Morning Rush,506,26,480
2012-06-14,8,Thursday,Summer,1,Morning Rush,719,37,682
2012-06-14,9,Thursday,Summer,1,Morning Rush,357,45,312
2012-06-14,10,Thursday,Summer,1,Mid-Day,179,47,132
2012-06-14,11,Thursday,Summer,1,Mid-Day,228,60,168
2012-06-14,12,Thursday,Summer,2,Mid-Day,265,55,210
2012-06-14,13,Thursday,Summer,1,Mid-Day,284,71,213
2012-06-14,14,Thursday,Summer,1,Mid-Day,298,84,214
2012-06-14,15,Thursday,Summer,1,Mid-Day,324,111,213
2012-06-14,16,Thursday,Summer,1,Evening Rush,438,70,368
2012-06-14,17,Thursday,Summer,1,Evening Rush,867,117,750
2012-06-14,18,Thursday,Summer,1,Evening Rush,823,107,716
2012-06-14,19,Thursday,Summer,1,Evening Rush,579,96,483
2012-06-14,20,Thursday,Summer,1,Night,435,84,351
2012-06-14,21,Thursday,Summer,1,Night,337,67,270
2012-06-14,22,Thursday,Summer,2,Night,242,46,196
2012-06-14,23,Thursday,Summer,2,Night,172,36,136
2012-06-15,0,Friday,Summer,1,Early Morning,94,26,68
2012-06-15,1,Friday,Summer,1,Early Morning,51,9,42
2012-06-15,2,Friday,Summer,1,Early Morning,15,0,15
2012-06-15,3,Friday,Summer,1,Early Morning,5,2,3
2012-06-15,4,Friday,Summer,1,Early Morning,14,1,13
2012-06-15,5,Friday,Summer,1,Early Morning,33,2,31
2012-06-15,6,Friday,Summer,1,Morning Rush,151,9,142
2012-06-15,7,Friday,Summer,1,Morning Rush,430,17,413
2012-06-15,8,Friday,Summer,1,Morning Rush,653,44,609
2012-06-15,9,Friday,Summer,1,Morning Rush,366,58,308
2012-06-15,10,Friday,Summer,1,Mid-Day,216,56,160
2012-06-15,11,Friday,Summer,1,Mid-Day,286,106,180
2012-06-15,12,Friday,Summer,1,Mid-Day,403,111,292
2012-06-15,13,Friday,Summer,1,Mid-Day,393,121,272
2012-06-15,14,Friday,Summer,1,Mid-Day,376,121,255
2012-06-15,15,Friday,Summer,1,Mid-Day,377,107,270
2012-06-15,16,Friday,Summer,1,Evening Rush,558,132,426
2012-06-15,17,Friday,Summer,1,Evening Rush,823,125,698
2012-06-15,18,Friday,Summer,1,Evening Rush,693,121,572
2012-06-15,19,Friday,Summer,1,Evening Rush,467,98,369
2012-06-15,20,Friday,Summer,1,Night,385,89,296
2012-06-15,21,Friday,Summer,1,Night,333,83,250
2012-06-15,22,Friday,Summer,1,Night,321,79,242
2012-06-15,23,Friday,Summer,1,Night,222,46,176
2012-06-16,0,Saturday,Summer,1,Early Morning,137,25,112
2012-06-16,1,Saturday,Summer,1,Early Morning,95,16,79
2012-06-16,2,Saturday,Summer,1,Early Morning,67,12,55
2012-06-16,3,Saturday,Summer,1,Early Morning,27,8,19
2012-06-16,4,Saturday,Summer,1,Early Morning,8,3,5
2012-06-16,5,Saturday,Summer,1,Early Morning,23,2,21
2012-06-16,6,Saturday,Summer,1,Morning Rush,47,11,36
2012-06-16,7,Saturday,Summer,1,Morning Rush,78,10,68
2012-06-16,8,Saturday,Summer,1,Morning Rush,204,47,157
2012-06-16,9,Saturday,Summer,1,Morning Rush,367,88,279
2012-06-16,10,Saturday,Summer,1,Mid-Day,435,139,296
2012-06-16,11,Saturday,Summer,1,Mid-Day,566,213,353
2012-06-16,12,Saturday,Summer,1,Mid-Day,603,254,349
2012-06-16,13,Saturday,Summer,1,Mid-Day,617,293,324
2012-06-16,14,Saturday,Summer,1,Mid-Day,573,264,309
2012-06-16,15,Saturday,Summer,1,Mid-Day,583,295,288
2012-06-16,16,Saturday,Summer,2,Evening Rush,542,238,304
2012-06-16,17,Saturday,Summer,2,Evening Rush,593,244,349
2012-06-16,18,Saturday,Summer,2,Evening Rush,571,256,315
2012-06-16,19,Saturday,Summer,2,Evening Rush,461,184,277
2012-06-16,20,Saturday,Summer,2,Night,352,123,229
2012-06-16,21,Saturday,Summer,2,Night,290,98,192
2012-06-16,22,Saturday,Summer,1,Night,280,91,189
2012-06-16,23,Saturday,Summer,1,Night,183,49,134
2012-06-17,0,Sunday,Summer,1,Early Morning,148,31,117
2012-06-17,1,Sunday,Summer,1,Early Morning,88,21,67
2012-06-17,2,Sunday,Summer,1,Early Morning,74,19,55
2012-06-17,3,Sunday,Summer,1,Early Morning,28,6,22
2012-06-17,4,Sunday,Summer,1,Early Morning,18,2,16
2012-06-17,5,Sunday,Summer,1,Early Morning,17,4,13
2012-06-17,6,Sunday,Summer,1,Morning Rush,23,7,16
2012-06-17,7,Sunday,Summer,1,Morning Rush,48,18,30
2012-06-17,8,Sunday,Summer,1,Morning Rush,119,24,95
2012-06-17,9,Sunday,Summer,1,Morning Rush,274,91,183
2012-06-17,10,Sunday,Summer,1,Mid-Day,436,148,288
2012-06-17,11,Sunday,Summer,1,Mid-Day,546,196,350
2012-06-17,12,Sunday,Summer,1,Mid-Day,615,260,355
2012-06-17,13,Sunday,Summer,1,Mid-Day,614,267,347
2012-06-17,14,Sunday,Summer,1,Mid-Day,582,255,327
2012-06-17,15,Sunday,Summer,1,Mid-Day,463,203,260
2012-06-17,16,Sunday,Summer,1,Evening Rush,580,240,340
2012-06-17,17,Sunday,Summer,1,Evening Rush,593,232,361
2012-06-17,18,Sunday,Summer,1,Evening Rush,513,203,310
2012-06-17,19,Sunday,Summer,1,Evening Rush,390,146,244
2012-06-17,20,Sunday,Summer,1,Night,302,101,201
2012-06-17,21,Sunday,Summer,1,Night,246,76,170
2012-06-17,22,Sunday,Summer,1,Night,153,55,98
2012-06-17,23,Sunday,Summer,1,Night,108,29,79
2012-06-18,0,Monday,Summer,1,Early Morning,40,12,28
2012-06-18,1,Monday,Summer,1,Early Morning,14,9,5
2012-06-18,2,Monday,Summer,1,Early Morning,9,3,6
2012-06-18,3,Monday,Summer,2,Early Morning,4,1,3
2012-06-18,4,Monday,Summer,2,Early Morning,9,0,9
2012-06-18,5,Monday,Summer,3,Early Morning,23,1,22
2012-06-18,6,Monday,Summer,3,Morning Rush,37,0,37
2012-06-18,7,Monday,Summer,3,Morning Rush,145,10,135
2012-06-18,8,Monday,Summer,2,Morning Rush,474,27,447
2012-06-18,9,Monday,Summer,2,Morning Rush,250,28,222
2012-06-18,10,Monday,Summer,3,Mid-Day,91,13,78
2012-06-18,11,Monday,Summer,2,Mid-Day,121,25,96
2012-06-18,12,Monday,Summer,3,Mid-Day,168,29,139
2012-06-18,13,Monday,Summer,2,Mid-Day,225,51,174
2012-06-18,14,Monday,Summer,2,Mid-Day,219,59,160
2012-06-18,15,Monday,Summer,2,Mid-Day,237,61,176
2012-06-18,16,Monday,Summer,2,Evening Rush,332,53,279
2012-06-18,17,Monday,Summer,2,Evening Rush,723,54,669
2012-06-18,18,Monday,Summer,2,Evening Rush,642,47,595
2012-06-18,19,Monday,Summer,2,Evening Rush,463,52,411
2012-06-18,20,Monday,Summer,2,Night,362,45,317
2012-06-18,21,Monday,Summer,2,Night,273,35,238
2012-06-18,22,Monday,Summer,2,Night,164,21,143
2012-06-18,23,Monday,Summer,3,Night,74,17,57
2012-06-19,0,Tuesday,Summer,2,Early Morning,35,5,30
2012-06-19,1,Tuesday,Summer,2,Early Morning,14,1,13
2012-06-19,2,Tuesday,Summer,2,Early Morning,15,1,14
2012-06-19,3,Tuesday,Summer,2,Early Morning,8,1,7
2012-06-19,4,Tuesday,Summer,2,Early Morning,10,1,9
2012-06-19,5,Tuesday,Summer,2,Early Morning,37,3,34
2012-06-19,6,Tuesday,Summer,2,Morning Rush,161,9,152
2012-06-19,7,Tuesday,Summer,2,Morning Rush,480,18,462
2012-06-19,8,Tuesday,Summer,2,Morning Rush,673,40,633
2012-06-19,9,Tuesday,Summer,1,Morning Rush,328,40,288
2012-06-19,10,Tuesday,Summer,1,Mid-Day,180,44,136
2012-06-19,11,Tuesday,Summer,1,Mid-Day,230,56,174
2012-06-19,12,Tuesday,Summer,1,Mid-Day,292,70,222
2012-06-19,13,Tuesday,Summer,1,Mid-Day,272,69,203
2012-06-19,14,Tuesday,Summer,1,Mid-Day,227,61,166
2012-06-19,15,Tuesday,Summer,1,Mid-Day,259,72,187
2012-06-19,16,Tuesday,Summer,1,Evening Rush,334,48,286
2012-06-19,17,Tuesday,Summer,1,Evening Rush,811,86,725
2012-06-19,18,Tuesday,Summer,1,Evening Rush,795,91,704
2012-06-19,19,Tuesday,Summer,1,Evening Rush,514,82,432
2012-06-19,20,Tuesday,Summer,1,Night,458,59,399
2012-06-19,21,Tuesday,Summer,1,Night,276,37,239
2012-06-19,22,Tuesday,Summer,1,Night,291,51,240
2012-06-19,23,Tuesday,Summer,1,Night,125,23,102
2012-06-20,0,Wednesday,Summer,1,Early Morning,53,5,48
2012-06-20,1,Wednesday,Summer,1,Early Morning,27,7,20
2012-06-20,2,Wednesday,Summer,1,Early Morning,6,1,5
2012-06-20,3,Wednesday,Summer,1,Early Morning,8,2,6
2012-06-20,4,Wednesday,Summer,1,Early Morning,7,1,6
2012-06-20,5,Wednesday,Summer,1,Early Morning,39,2,37
2012-06-20,6,Wednesday,Summer,2,Morning Rush,165,9,156
2012-06-20,7,Wednesday,Summer,2,Morning Rush,464,20,444
2012-06-20,8,Wednesday,Summer,2,Morning Rush,643,43,600
2012-06-20,9,Wednesday,Summer,2,Morning Rush,316,40,276
2012-06-20,10,Wednesday,Summer,1,Mid-Day,167,41,126
2012-06-20,11,Wednesday,Summer,1,Mid-Day,188,54,134
2012-06-20,12,Wednesday,Summer,1,Mid-Day,180,30,150
2012-06-20,13,Wednesday,Summer,1,Mid-Day,211,48,163
2012-06-20,14,Wednesday,Summer,1,Mid-Day,190,56,134
2012-06-20,15,Wednesday,Summer,1,Mid-Day,179,36,143
2012-06-20,16,Wednesday,Summer,1,Evening Rush,335,51,284
2012-06-20,17,Wednesday,Summer,1,Evening Rush,691,80,611
2012-06-20,18,Wednesday,Summer,1,Evening Rush,672,81,591
2012-06-20,19,Wednesday,Summer,1,Evening Rush,539,90,449
2012-06-20,20,Wednesday,Summer,1,Night,407,81,326
2012-06-20,21,Wednesday,Summer,1,Night,344,42,302
2012-06-20,22,Wednesday,Summer,1,Night,257,31,226
2012-06-20,23,Wednesday,Summer,1,Night,123,21,102
2012-06-21,0,Thursday,Fall,1,Early Morning,69,16,53
2012-06-21,1,Thursday,Fall,1,Early Morning,18,2,16
2012-06-21,2,Thursday,Fall,1,Early Morning,18,11,7
2012-06-21,3,Thursday,Fall,1,Early Morning,11,3,8
2012-06-21,4,Thursday,Fall,1,Early Morning,12,1,11
2012-06-21,5,Thursday,Fall,1,Early Morning,40,3,37
2012-06-21,6,Thursday,Fall,2,Morning Rush,150,3,147
2012-06-21,7,Thursday,Fall,2,Morning Rush,463,26,437
2012-06-21,8,Thursday,Fall,1,Morning Rush,590,27,563
2012-06-21,9,Thursday,Fall,1,Morning Rush,256,32,224
2012-06-21,10,Thursday,Fall,1,Mid-Day,150,36,114
2012-06-21,11,Thursday,Fall,1,Mid-Day,161,40,121
2012-06-21,12,Thursday,Fall,1,Mid-Day,215,33,182
2012-06-21,13,Thursday,Fall,1,Mid-Day,172,31,141
2012-06-21,14,Thursday,Fall,1,Mid-Day,176,27,149
2012-06-21,15,Thursday,Fall,1,Mid-Day,194,40,154
2012-06-21,16,Thursday,Fall,1,Evening Rush,320,37,283
2012-06-21,17,Thursday,Fall,1,Evening Rush,615,80,535
2012-06-21,18,Thursday,Fall,1,Evening Rush,640,78,562
2012-06-21,19,Thursday,Fall,1,Evening Rush,499,84,415
2012-06-21,20,Thursday,Fall,1,Night,436,79,357
2012-06-21,21,Thursday,Fall,1,Night,311,55,256
2012-06-21,22,Thursday,Fall,1,Night,243,22,221
2012-06-21,23,Thursday,Fall,1,Night,146,12,134
2012-06-22,0,Friday,Fall,2,Early Morning,93,16,77
2012-06-22,1,Friday,Fall,1,Early Morning,31,3,28
2012-06-22,2,Friday,Fall,1,Early Morning,12,0,12
2012-06-22,3,Friday,Fall,1,Early Morning,7,1,6
2012-06-22,4,Friday,Fall,2,Early Morning,10,3,7
2012-06-22,5,Friday,Fall,2,Early Morning,38,3,35
2012-06-22,6,Friday,Fall,2,Morning Rush,122,4,118
2012-06-22,7,Friday,Fall,1,Morning Rush,359,19,340
2012-06-22,8,Friday,Fall,1,Morning Rush,613,49,564
2012-06-22,9,Friday,Fall,1,Morning Rush,333,55,278
2012-06-22,10,Friday,Fall,1,Mid-Day,185,52,133
2012-06-22,11,Friday,Fall,1,Mid-Day,236,76,160
2012-06-22,12,Friday,Fall,1,Mid-Day,254,63,191
2012-06-22,13,Friday,Fall,1,Mid-Day,300,72,228
2012-06-22,14,Friday,Fall,1,Mid-Day,263,65,198
2012-06-22,15,Friday,Fall,1,Mid-Day,284,72,212
2012-06-22,16,Friday,Fall,1,Evening Rush,380,67,313
2012-06-22,17,Friday,Fall,2,Evening Rush,646,95,551
2012-06-22,18,Friday,Fall,2,Evening Rush,505,62,443
2012-06-22,19,Friday,Fall,2,Evening Rush,362,45,317
2012-06-22,20,Friday,Fall,2,Night,202,31,171
2012-06-22,21,Friday,Fall,3,Night,217,40,177
2012-06-22,22,Friday,Fall,1,Night,197,42,155
2012-06-22,23,Friday,Fall,2,Night,174,29,145
2012-06-23,0,Saturday,Fall,1,Early Morning,116,14,102
2012-06-23,1,Saturday,Fall,1,Early Morning,123,16,107
2012-06-23,2,Saturday,Fall,2,Early Morning,93,18,75
2012-06-23,3,Saturday,Fall,2,Early Morning,42,10,32
2012-06-23,4,Saturday,Fall,2,Early Morning,19,6,13
2012-06-23,5,Saturday,Fall,2,Early Morning,12,1,11
2012-06-23,6,Saturday,Fall,1,Morning Rush,47,10,37
2012-06-23,7,Saturday,Fall,1,Morning Rush,78,19,59
2012-06-23,8,Saturday,Fall,1,Morning Rush,167,34,133
2012-06-23,9,Saturday,Fall,1,Morning Rush,332,85,247
2012-06-23,10,Saturday,Fall,1,Mid-Day,494,177,317
2012-06-23,11,Saturday,Fall,1,Mid-Day,516,167,349
2012-06-23,12,Saturday,Fall,1,Mid-Day,602,203,399
2012-06-23,13,Saturday,Fall,1,Mid-Day,564,226,338
2012-06-23,14,Saturday,Fall,1,Mid-Day,609,238,371
2012-06-23,15,Saturday,Fall,1,Mid-Day,483,217,266
2012-06-23,16,Saturday,Fall,1,Evening Rush,513,196,317
2012-06-23,17,Saturday,Fall,1,Evening Rush,530,214,316
2012-06-23,18,Saturday,Fall,1,Evening Rush,481,194,287
2012-06-23,19,Saturday,Fall,1,Evening Rush,425,185,240
2012-06-23,20,Saturday,Fall,1,Night,386,158,228
2012-06-23,21,Saturday,Fall,1,Night,322,99,223
2012-06-23,22,Saturday,Fall,1,Night,279,101,178
2012-06-23,23,Saturday,Fall,1,Night,225,69,156
2012-06-24,0,Sunday,Fall,1,Early Morning,163,31,132
2012-06-24,1,Sunday,Fall,2,Early Morning,127,39,88
2012-06-24,2,Sunday,Fall,2,Early Morning,114,34,80
2012-06-24,3,Sunday,Fall,2,Early Morning,60,19,41
2012-06-24,4,Sunday,Fall,2,Early Morning,13,4,9
2012-06-24,5,Sunday,Fall,1,Early Morning,8,1,7
2012-06-24,6,Sunday,Fall,1,Morning Rush,25,6,19
2012-06-24,7,Sunday,Fall,1,Morning Rush,71,23,48
2012-06-24,8,Sunday,Fall,1,Morning Rush,141,38,103
2012-06-24,9,Sunday,Fall,1,Morning Rush,232,63,169
2012-06-24,10,Sunday,Fall,1,Mid-Day,452,161,291
2012-06-24,11,Sunday,Fall,1,Mid-Day,506,215,291
2012-06-24,12,Sunday,Fall,1,Mid-Day,556,227,329
2012-06-24,13,Sunday,Fall,1,Mid-Day,585,237,348
2012-06-24,14,Sunday,Fall,1,Mid-Day,551,253,298
2012-06-24,15,Sunday,Fall,1,Mid-Day,487,197,290
2012-06-24,16,Sunday,Fall,1,Evening Rush,461,181,280
2012-06-24,17,Sunday,Fall,1,Evening Rush,532,203,329
2012-06-24,18,Sunday,Fall,1,Evening Rush,534,186,348
2012-06-24,19,Sunday,Fall,1,Evening Rush,423,176,247
2012-06-24,20,Sunday,Fall,1,Night,332,108,224
2012-06-24,21,Sunday,Fall,1,Night,253,76,177
2012-06-24,22,Sunday,Fall,1,Night,178,53,125
2012-06-24,23,Sunday,Fall,1,Night,87,20,67
2012-06-25,0,Monday,Fall,1,Early Morning,68,31,37
2012-06-25,1,Monday,Fall,1,Early Morning,31,11,20
2012-06-25,2,Monday,Fall,1,Early Morning,14,4,10
2012-06-25,3,Monday,Fall,1,Early Morning,5,1,4
2012-06-25,4,Monday,Fall,1,Early Morning,4,0,4
2012-06-25,5,Monday,Fall,1,Early Morning,43,1,42
2012-06-25,6,Monday,Fall,1,Morning Rush,158,11,147
2012-06-25,7,Monday,Fall,1,Morning Rush,485,30,455
2012-06-25,8,Monday,Fall,1,Morning Rush,608,53,555
2012-06-25,9,Monday,Fall,1,Morning Rush,268,37,231
2012-06-25,10,Monday,Fall,1,Mid-Day,184,58,126
2012-06-25,11,Monday,Fall,1,Mid-Day,181,54,127
2012-06-25,12,Monday,Fall,2,Mid-Day,270,74,196
2012-06-25,13,Monday,Fall,1,Mid-Day,260,79,181
2012-06-25,14,Monday,Fall,1,Mid-Day,251,90,161
2012-06-25,15,Monday,Fall,1,Mid-Day,233,65,168
2012-06-25,16,Monday,Fall,1,Evening Rush,414,104,310
2012-06-25,17,Monday,Fall,1,Evening Rush,833,76,757
2012-06-25,18,Monday,Fall,1,Evening Rush,791,100,691
2012-06-25,19,Monday,Fall,1,Evening Rush,582,74,508
2012-06-25,20,Monday,Fall,1,Night,475,100,375
2012-06-25,21,Monday,Fall,1,Night,331,50,281
2012-06-25,22,Monday,Fall,1,Night,187,21,166
2012-06-25,23,Monday,Fall,1,Night,103,15,88
2012-06-26,0,Tuesday,Fall,1,Early Morning,37,8,29
2012-06-26,1,Tuesday,Fall,1,Early Morning,30,11,19
2012-06-26,2,Tuesday,Fall,1,Early Morning,9,2,7
2012-06-26,3,Tuesday,Fall,1,Early Morning,9,2,7
2012-06-26,4,Tuesday,Fall,1,Early Morning,10,1,9
2012-06-26,5,Tuesday,Fall,1,Early Morning,39,3,36
2012-06-26,6,Tuesday,Fall,1,Morning Rush,188,12,176
2012-06-26,7,Tuesday,Fall,1,Morning Rush,552,21,531
2012-06-26,8,Tuesday,Fall,1,Morning Rush,656,34,622
2012-06-26,9,Tuesday,Fall,1,Morning Rush,328,30,298
2012-06-26,10,Tuesday,Fall,1,Mid-Day,190,37,153
2012-06-26,11,Tuesday,Fall,1,Mid-Day,235,46,189
2012-06-26,12,Tuesday,Fall,1,Mid-Day,308,80,228
2012-06-26,13,Tuesday,Fall,1,Mid-Day,306,74,232
2012-06-26,14,Tuesday,Fall,1,Mid-Day,267,81,186
2012-06-26,15,Tuesday,Fall,1,Mid-Day,317,88,229
2012-06-26,16,Tuesday,Fall,1,Evening Rush,416,67,349
2012-06-26,17,Tuesday,Fall,1,Evening Rush,900,104,796
2012-06-26,18,Tuesday,Fall,1,Evening Rush,824,105,719
2012-06-26,19,Tuesday,Fall,1,Evening Rush,612,83,529
2012-06-26,20,Tuesday,Fall,1,Night,505,88,417
2012-06-26,21,Tuesday,Fall,1,Night,328,61,267
2012-06-26,22,Tuesday,Fall,1,Night,245,26,219
2012-06-26,23,Tuesday,Fall,1,Night,131,13,118
2012-06-27,0,Wednesday,Fall,1,Early Morning,54,15,39
2012-06-27,1,Wednesday,Fall,1,Early Morning,23,5,18
2012-06-27,2,Wednesday,Fall,1,Early Morning,14,2,12
2012-06-27,3,Wednesday,Fall,1,Early Morning,8,1,7
2012-06-27,4,Wednesday,Fall,1,Early Morning,11,0,11
2012-06-27,5,Wednesday,Fall,1,Early Morning,36,2,34
2012-06-27,6,Wednesday,Fall,1,Morning Rush,200,7,193
2012-06-27,7,Wednesday,Fall,1,Morning Rush,527,29,498
2012-06-27,8,Wednesday,Fall,1,Morning Rush,687,49,638
2012-06-27,9,Wednesday,Fall,1,Morning Rush,282,29,253
2012-06-27,10,Wednesday,Fall,1,Mid-Day,172,34,138
2012-06-27,11,Wednesday,Fall,1,Mid-Day,209,64,145
2012-06-27,12,Wednesday,Fall,1,Mid-Day,322,77,245
2012-06-27,13,Wednesday,Fall,1,Mid-Day,321,77,244
2012-06-27,14,Wednesday,Fall,1,Mid-Day,270,78,192
2012-06-27,15,Wednesday,Fall,1,Mid-Day,249,61,188
2012-06-27,16,Wednesday,Fall,1,Evening Rush,392,55,337
2012-06-27,17,Wednesday,Fall,1,Evening Rush,843,113,730
2012-06-27,18,Wednesday,Fall,1,Evening Rush,804,85,719
2012-06-27,19,Wednesday,Fall,1,Evening Rush,643,101,542
2012-06-27,20,Wednesday,Fall,1,Night,445,76,369
2012-06-27,21,Wednesday,Fall,1,Night,367,54,313
2012-06-27,22,Wednesday,Fall,1,Night,297,52,245
2012-06-27,23,Wednesday,Fall,1,Night,159,11,148
2012-06-28,0,Thursday,Fall,1,Early Morning,54,2,52
2012-06-28,1,Thursday,Fall,1,Early Morning,25,11,14
2012-06-28,2,Thursday,Fall,1,Early Morning,13,1,12
2012-06-28,3,Thursday,Fall,1,Early Morning,7,1,6
2012-06-28,4,Thursday,Fall,1,Early Morning,11,0,11
2012-06-28,5,Thursday,Fall,1,Early Morning,47,8,39
2012-06-28,6,Thursday,Fall,1,Morning Rush,193,8,185
2012-06-28,7,Thursday,Fall,1,Morning Rush,508,24,484
2012-06-28,8,Thursday,Fall,1,Morning Rush,617,40,577
2012-06-28,9,Thursday,Fall,1,Morning Rush,351,33,318
2012-06-28,10,Thursday,Fall,1,Mid-Day,184,40,144
2012-06-28,11,Thursday,Fall,1,Mid-Day,211,41,170
2012-06-28,12,Thursday,Fall,1,Mid-Day,276,49,227
2012-06-28,13,Thursday,Fall,1,Mid-Day,236,31,205
2012-06-28,14,Thursday,Fall,1,Mid-Day,254,66,188
2012-06-28,15,Thursday,Fall,1,Mid-Day,219,24,195
2012-06-28,16,Thursday,Fall,1,Evening Rush,387,56,331
2012-06-28,17,Thursday,Fall,1,Evening Rush,705,71,634
2012-06-28,18,Thursday,Fall,1,Evening Rush,697,100,597
2012-06-28,19,Thursday,Fall,1,Evening Rush,571,79,492
2012-06-28,20,Thursday,Fall,1,Night,470,71,399
2012-06-28,21,Thursday,Fall,1,Night,398,89,309
2012-06-28,22,Thursday,Fall,1,Night,274,50,224
2012-06-28,23,Thursday,Fall,1,Night,171,26,145
2012-06-29,0,Friday,Fall,1,Early Morning,114,24,90
2012-06-29,1,Friday,Fall,1,Early Morning,42,9,33
2012-06-29,2,Friday,Fall,1,Early Morning,18,3,15
2012-06-29,3,Friday,Fall,1,Early Morning,8,3,5
2012-06-29,4,Friday,Fall,1,Early Morning,10,1,9
2012-06-29,5,Friday,Fall,1,Early Morning,45,6,39
2012-06-29,6,Friday,Fall,2,Morning Rush,163,15,148
2012-06-29,7,Friday,Fall,1,Morning Rush,380,19,361
2012-06-29,8,Friday,Fall,2,Morning Rush,624,48,576
2012-06-29,9,Friday,Fall,1,Morning Rush,300,39,261
2012-06-29,10,Friday,Fall,1,Mid-Day,171,32,139
2012-06-29,11,Friday,Fall,2,Mid-Day,188,51,137
2012-06-29,12,Friday,Fall,2,Mid-Day,226,53,173
2012-06-29,13,Friday,Fall,1,Mid-Day,239,45,194
2012-06-29,14,Friday,Fall,1,Mid-Day,233,49,184
2012-06-29,15,Friday,Fall,1,Mid-Day,230,47,183
2012-06-29,16,Friday,Fall,1,Evening Rush,351,59,292
2012-06-29,17,Friday,Fall,1,Evening Rush,539,82,457
2012-06-29,18,Friday,Fall,1,Evening Rush,464,50,414
2012-06-29,19,Friday,Fall,1,Evening Rush,363,60,303
2012-06-29,20,Friday,Fall,1,Night,308,53,255
2012-06-29,21,Friday,Fall,2,Night,236,41,195
2012-06-29,22,Friday,Fall,3,Night,163,34,129
2012-06-29,23,Friday,Fall,3,Night,48,6,42
2012-06-30,0,Saturday,Fall,3,Early Morning,69,4,65
2012-06-30,1,Saturday,Fall,3,Early Morning,58,3,55
2012-06-30,2,Saturday,Fall,2,Early Morning,61,7,54
2012-06-30,3,Saturday,Fall,2,Early Morning,23,3,20
2012-06-30,4,Saturday,Fall,2,Early Morning,18,3,15
2012-06-30,5,Saturday,Fall,1,Early Morning,10,3,7
2012-06-30,6,Saturday,Fall,1,Morning Rush,42,6,36
2012-06-30,7,Saturday,Fall,1,Morning Rush,92,10,82
2012-06-30,8,Saturday,Fall,1,Morning Rush,194,26,168
2012-06-30,9,Saturday,Fall,1,Morning Rush,275,41,234
2012-06-30,10,Saturday,Fall,1,Mid-Day,404,96,308
2012-06-30,11,Saturday,Fall,1,Mid-Day,452,102,350
2012-06-30,12,Saturday,Fall,1,Mid-Day,471,143,328
2012-06-30,13,Saturday,Fall,1,Mid-Day,428,105,323
2012-06-30,14,Saturday,Fall,1,Mid-Day,409,114,295
2012-06-30,15,Saturday,Fall,1,Mid-Day,404,117,287
2012-06-30,16,Saturday,Fall,1,Evening Rush,373,109,264
2012-06-30,17,Saturday,Fall,1,Evening Rush,362,131,231
2012-06-30,18,Saturday,Fall,1,Evening Rush,339,91,248
2012-06-30,19,Saturday,Fall,1,Evening Rush,374,134,240
2012-06-30,20,Saturday,Fall,1,Night,292,88,204
2012-06-30,21,Saturday,Fall,1,Night,213,48,165
2012-06-30,22,Saturday,Fall,1,Night,172,38,134
2012-06-30,23,Saturday,Fall,1,Night,152,33,119
2012-07-01,0,Sunday,Fall,1,Early Morning,149,27,122
2012-07-01,1,Sunday,Fall,1,Early Morning,93,12,81
2012-07-01,2,Sunday,Fall,1,Early Morning,90,21,69
2012-07-01,3,Sunday,Fall,1,Early Morning,33,6,27
2012-07-01,4,Sunday,Fall,1,Early Morning,4,0,4
2012-07-01,5,Sunday,Fall,1,Early Morning,10,3,7
2012-07-01,6,Sunday,Fall,1,Morning Rush,27,8,19
2012-07-01,7,Sunday,Fall,1,Morning Rush,50,13,37
2012-07-01,8,Sunday,Fall,1,Morning Rush,142,36,106
2012-07-01,9,Sunday,Fall,1,Morning Rush,219,51,168
2012-07-01,10,Sunday,Fall,1,Mid-Day,366,98,268
2012-07-01,11,Sunday,Fall,1,Mid-Day,377,121,256
2012-07-01,12,Sunday,Fall,1,Mid-Day,433,114,319
2012-07-01,13,Sunday,Fall,1,Mid-Day,420,111,309
2012-07-01,14,Sunday,Fall,1,Mid-Day,444,98,346
2012-07-01,15,Sunday,Fall,1,Mid-Day,345,101,244
2012-07-01,16,Sunday,Fall,1,Evening Rush,313,85,228
2012-07-01,17,Sunday,Fall,1,Evening Rush,413,90,323
2012-07-01,18,Sunday,Fall,1,Evening Rush,370,95,275
2012-07-01,19,Sunday,Fall,1,Evening Rush,382,103,279
2012-07-01,20,Sunday,Fall,1,Night,332,88,244
2012-07-01,21,Sunday,Fall,1,Night,258,77,181
2012-07-01,22,Sunday,Fall,1,Night,151,41,110
2012-07-01,23,Sunday,Fall,3,Night,110,22,88
2012-07-02,0,Monday,Fall,2,Early Morning,43,12,31
2012-07-02,1,Monday,Fall,2,Early Morning,17,3,14
2012-07-02,2,Monday,Fall,2,Early Morning,15,1,14
2012-07-02,3,Monday,Fall,2,Early Morning,5,0,5
2012-07-02,4,Monday,Fall,2,Early Morning,12,2,10
2012-07-02,5,Monday,Fall,2,Early Morning,40,3,37
2012-07-02,6,Monday,Fall,1,Morning Rush,136,4,132
2012-07-02,7,Monday,Fall,1,Morning Rush,398,8,390
2012-07-02,8,Monday,Fall,1,Morning Rush,568,20,548
2012-07-02,9,Monday,Fall,1,Morning Rush,295,56,239
2012-07-02,10,Monday,Fall,1,Mid-Day,174,70,104
2012-07-02,11,Monday,Fall,1,Mid-Day,201,67,134
2012-07-02,12,Monday,Fall,1,Mid-Day,257,74,183
2012-07-02,13,Monday,Fall,1,Mid-Day,236,74,162
2012-07-02,14,Monday,Fall,1,Mid-Day,230,79,151
2012-07-02,15,Monday,Fall,1,Mid-Day,234,59,175
2012-07-02,16,Monday,Fall,1,Evening Rush,365,61,304
2012-07-02,17,Monday,Fall,1,Evening Rush,747,82,665
2012-07-02,18,Monday,Fall,1,Evening Rush,730,72,658
2012-07-02,19,Monday,Fall,1,Evening Rush,581,71,510
2012-07-02,20,Monday,Fall,1,Night,395,38,357
2012-07-02,21,Monday,Fall,1,Night,258,17,241
2012-07-02,22,Monday,Fall,1,Night,188,19,169
2012-07-02,23,Monday,Fall,1,Night,102,12,90
2012-07-03,0,Tuesday,Fall,1,Early Morning,53,9,44
2012-07-03,1,Tuesday,Fall,1,Early Morning,14,5,9
2012-07-03,2,Tuesday,Fall,1,Early Morning,10,2,8
2012-07-03,3,Tuesday,Fall,1,Early Morning,2,0,2
2012-07-03,4,Tuesday,Fall,1,Early Morning,6,0,6
2012-07-03,5,Tuesday,Fall,1,Early Morning,35,2,33
2012-07-03,6,Tuesday,Fall,1,Morning Rush,154,5,149
2012-07-03,7,Tuesday,Fall,1,Morning Rush,483,21,462
2012-07-03,8,Tuesday,Fall,1,Morning Rush,646,42,604
2012-07-03,9,Tuesday,Fall,1,Morning Rush,272,46,226
2012-07-03,10,Tuesday,Fall,1,Mid-Day,209,56,153
2012-07-03,11,Tuesday,Fall,1,Mid-Day,217,66,151
2012-07-03,12,Tuesday,Fall,1,Mid-Day,272,74,198
2012-07-03,13,Tuesday,Fall,1,Mid-Day,283,80,203
2012-07-03,14,Tuesday,Fall,1,Mid-Day,310,69,241
2012-07-03,15,Tuesday,Fall,2,Mid-Day,401,71,330
2012-07-03,16,Tuesday,Fall,2,Evening Rush,527,90,437
2012-07-03,17,Tuesday,Fall,2,Evening Rush,722,102,620
2012-07-03,18,Tuesday,Fall,2,Evening Rush,627,85,542
2012-07-03,19,Tuesday,Fall,2,Evening Rush,497,66,431
2012-07-03,20,Tuesday,Fall,3,Night,376,80,296
2012-07-03,21,Tuesday,Fall,2,Night,196,36,160
2012-07-03,22,Tuesday,Fall,1,Night,177,26,151
2012-07-03,23,Tuesday,Fall,1,Night,171,19,152
2012-07-04,0,Wednesday,Fall,1,Early Morning,159,19,140
2012-07-04,1,Wednesday,Fall,1,Early Morning,123,27,96
2012-07-04,2,Wednesday,Fall,1,Early Morning,93,27,66
2012-07-04,3,Wednesday,Fall,1,Early Morning,32,9,23
2012-07-04,4,Wednesday,Fall,1,Early Morning,16,5,11
2012-07-04,5,Wednesday,Fall,1,Early Morning,19,5,14
2012-07-04,6,Wednesday,Fall,1,Morning Rush,32,9,23
2012-07-04,7,Wednesday,Fall,1,Morning Rush,72,10,62
2012-07-04,8,Wednesday,Fall,1,Morning Rush,153,43,110
2012-07-04,9,Wednesday,Fall,1,Morning Rush,293,90,203
2012-07-04,10,Wednesday,Fall,1,Mid-Day,447,143,304
2012-07-04,11,Wednesday,Fall,1,Mid-Day,485,164,321
2012-07-04,12,Wednesday,Fall,1,Mid-Day,494,164,330
2012-07-04,13,Wednesday,Fall,1,Mid-Day,499,177,322
2012-07-04,14,Wednesday,Fall,1,Mid-Day,547,190,357
2012-07-04,15,Wednesday,Fall,1,Mid-Day,454,155,299
2012-07-04,16,Wednesday,Fall,1,Evening Rush,389,163,226
2012-07-04,17,Wednesday,Fall,1,Evening Rush,414,161,253
2012-07-04,18,Wednesday,Fall,1,Evening Rush,430,159,271
2012-07-04,19,Wednesday,Fall,1,Evening Rush,432,177,255
2012-07-04,20,Wednesday,Fall,1,Night,551,237,314
2012-07-04,21,Wednesday,Fall,1,Night,584,222,362
2012-07-04,22,Wednesday,Fall,1,Night,502,175,327
2012-07-04,23,Wednesday,Fall,2,Night,183,31,152
2012-07-05,0,Thursday,Fall,1,Early Morning,88,17,71
2012-07-05,1,Thursday,Fall,1,Early Morning,30,6,24
2012-07-05,2,Thursday,Fall,1,Early Morning,18,4,14
2012-07-05,3,Thursday,Fall,1,Early Morning,7,2,5
2012-07-05,4,Thursday,Fall,1,Early Morning,7,0,7
2012-07-05,5,Thursday,Fall,1,Early Morning,29,1,28
2012-07-05,6,Thursday,Fall,1,Morning Rush,133,3,130
2012-07-05,7,Thursday,Fall,1,Morning Rush,343,27,316
2012-07-05,8,Thursday,Fall,1,Morning Rush,550,36,514
2012-07-05,9,Thursday,Fall,1,Morning Rush,293,47,246
2012-07-05,10,Thursday,Fall,1,Mid-Day,186,69,117
2012-07-05,11,Thursday,Fall,1,Mid-Day,244,107,137
2012-07-05,12,Thursday,Fall,1,Mid-Day,276,88,188
2012-07-05,13,Thursday,Fall,1,Mid-Day,310,129,181
2012-07-05,14,Thursday,Fall,1,Mid-Day,241,87,154
2012-07-05,15,Thursday,Fall,1,Mid-Day,254,71,183
2012-07-05,16,Thursday,Fall,1,Evening Rush,433,109,324
2012-07-05,17,Thursday,Fall,1,Evening Rush,689,114,575
2012-07-05,18,Thursday,Fall,2,Evening Rush,607,96,511
2012-07-05,19,Thursday,Fall,2,Evening Rush,503,128,375
2012-07-05,20,Thursday,Fall,2,Night,321,78,243
2012-07-05,21,Thursday,Fall,1,Night,323,91,232
2012-07-05,22,Thursday,Fall,1,Night,225,63,162
2012-07-05,23,Thursday,Fall,1,Night,131,32,99
2012-07-06,0,Friday,Fall,1,Early Morning,102,39,63
2012-07-06,1,Friday,Fall,1,Early Morning,29,7,22
2012-07-06,2,Friday,Fall,1,Early Morning,17,4,13
2012-07-06,3,Friday,Fall,2,Early Morning,7,1,6
2012-07-06,4,Friday,Fall,1,Early Morning,6,2,4
2012-07-06,5,Friday,Fall,1,Early Morning,35,4,31
2012-07-06,6,Friday,Fall,1,Morning Rush,131,4,127
2012-07-06,7,Friday,Fall,1,Morning Rush,353,20,333
2012-07-06,8,Friday,Fall,1,Morning Rush,585,28,557
2012-07-06,9,Friday,Fall,1,Morning Rush,304,55,249
2012-07-06,10,Friday,Fall,1,Mid-Day,210,80,130
2012-07-06,11,Friday,Fall,1,Mid-Day,233,92,141
2012-07-06,12,Friday,Fall,1,Mid-Day,331,111,220
2012-07-06,13,Friday,Fall,1,Mid-Day,293,99,194
2012-07-06,14,Friday,Fall,1,Mid-Day,275,91,184
2012-07-06,15,Friday,Fall,1,Mid-Day,285,79,206
2012-07-06,16,Friday,Fall,1,Evening Rush,369,69,300
2012-07-06,17,Friday,Fall,1,Evening Rush,576,90,486
2012-07-06,18,Friday,Fall,1,Evening Rush,560,106,454
2012-07-06,19,Friday,Fall,1,Evening Rush,418,112,306
2012-07-06,20,Friday,Fall,1,Night,336,91,245
2012-07-06,21,Friday,Fall,1,Night,300,77,223
2012-07-06,22,Friday,Fall,1,Night,288,78,210
2012-07-06,23,Friday,Fall,1,Night,164,27,137
2012-07-07,0,Saturday,Fall,1,Early Morning,150,35,115
2012-07-07,1,Saturday,Fall,1,Early Morning,71,16,55
2012-07-07,2,Saturday,Fall,1,Early Morning,58,11,47
2012-07-07,3,Saturday,Fall,1,Early Morning,31,12,19
2012-07-07,4,Saturday,Fall,1,Early Morning,16,3,13
2012-07-07,5,Saturday,Fall,1,Early Morning,14,2,12
2012-07-07,6,Saturday,Fall,1,Morning Rush,31,4,27
2012-07-07,7,Saturday,Fall,1,Morning Rush,71,8,63
2012-07-07,8,Saturday,Fall,1,Morning Rush,152,32,120
2012-07-07,9,Saturday,Fall,1,Morning Rush,256,69,187
2012-07-07,10,Saturday,Fall,1,Mid-Day,325,100,225
2012-07-07,11,Saturday,Fall,1,Mid-Day,367,122,245
2012-07-07,12,Saturday,Fall,1,Mid-Day,342,124,218
2012-07-07,13,Saturday,Fall,2,Mid-Day,360,116,244
2012-07-07,14,Saturday,Fall,2,Mid-Day,308,105,203
2012-07-07,15,Saturday,Fall,1,Mid-Day,306,113,193
2012-07-07,16,Saturday,Fall,1,Evening Rush,294,102,192
2012-07-07,17,Saturday,Fall,1,Evening Rush,279,103,176
2012-07-07,18,Saturday,Fall,1,Evening Rush,277,83,194
2012-07-07,19,Saturday,Fall,1,Evening Rush,287,68,219
2012-07-07,20,Saturday,Fall,1,Night,276,79,197
2012-07-07,21,Saturday,Fall,1,Night,201,51,150
2012-07-07,22,Saturday,Fall,1,Night,220,56,164
2012-07-07,23,Saturday,Fall,1,Night,148,34,114
2012-07-08,0,Sunday,Fall,1,Early Morning,147,22,125
2012-07-08,1,Sunday,Fall,1,Early Morning,124,25,99
2012-07-08,2,Sunday,Fall,1,Early Morning,70,11,59
2012-07-08,3,Sunday,Fall,1,Early Morning,35,1,34
2012-07-08,4,Sunday,Fall,1,Early Morning,13,2,11
2012-07-08,5,Sunday,Fall,1,Early Morning,6,1,5
2012-07-08,6,Sunday,Fall,1,Morning Rush,21,5,16
2012-07-08,7,Sunday,Fall,1,Morning Rush,52,19,33
2012-07-08,8,Sunday,Fall,1,Morning Rush,130,35,95
2012-07-08,9,Sunday,Fall,1,Morning Rush,242,70,172
2012-07-08,10,Sunday,Fall,1,Mid-Day,319,85,234
2012-07-08,11,Sunday,Fall,1,Mid-Day,389,120,269
2012-07-08,12,Sunday,Fall,1,Mid-Day,376,105,271
2012-07-08,13,Sunday,Fall,1,Mid-Day,337,118,219
2012-07-08,14,Sunday,Fall,1,Mid-Day,312,77,235
2012-07-08,15,Sunday,Fall,3,Mid-Day,298,80,218
2012-07-08,16,Sunday,Fall,2,Evening Rush,291,65,226
2012-07-08,17,Sunday,Fall,1,Evening Rush,270,68,202
2012-07-08,18,Sunday,Fall,1,Evening Rush,253,54,199
2012-07-08,19,Sunday,Fall,1,Evening Rush,250,66,184
2012-07-08,20,Sunday,Fall,1,Night,285,79,206
2012-07-08,21,Sunday,Fall,1,Night,207,58,149
2012-07-08,22,Sunday,Fall,3,Night,122,12,110
2012-07-08,23,Sunday,Fall,3,Night,123,25,98
2012-07-09,0,Monday,Fall,2,Early Morning,39,6,33
2012-07-09,1,Monday,Fall,3,Early Morning,18,5,13
2012-07-09,2,Monday,Fall,3,Early Morning,5,1,4
2012-07-09,3,Monday,Fall,3,Early Morning,5,0,5
2012-07-09,4,Monday,Fall,3,Early Morning,2,1,1
2012-07-09,5,Monday,Fall,2,Early Morning,28,1,27
2012-07-09,6,Monday,Fall,3,Morning Rush,92,6,86
2012-07-09,7,Monday,Fall,3,Morning Rush,230,7,223
2012-07-09,8,Monday,Fall,2,Morning Rush,455,26,429
2012-07-09,9,Monday,Fall,2,Morning Rush,363,38,325
2012-07-09,10,Monday,Fall,2,Mid-Day,175,58,117
2012-07-09,11,Monday,Fall,2,Mid-Day,216,72,144
2012-07-09,12,Monday,Fall,2,Mid-Day,266,61,205
2012-07-09,13,Monday,Fall,2,Mid-Day,255,67,188
2012-07-09,14,Monday,Fall,2,Mid-Day,242,58,184
2012-07-09,15,Monday,Fall,2,Mid-Day,280,66,214
2012-07-09,16,Monday,Fall,1,Evening Rush,413,88,325
2012-07-09,17,Monday,Fall,1,Evening Rush,849,108,741
2012-07-09,18,Monday,Fall,1,Evening Rush,872,82,790
2012-07-09,19,Monday,Fall,1,Evening Rush,631,88,543
2012-07-09,20,Monday,Fall,2,Night,447,69,378
2012-07-09,21,Monday,Fall,2,Night,331,33,298
2012-07-09,22,Monday,Fall,2,Night,224,35,189
2012-07-09,23,Monday,Fall,2,Night,131,22,109
2012-07-10,0,Tuesday,Fall,1,Early Morning,69,16,53
2012-07-10,1,Tuesday,Fall,1,Early Morning,15,0,15
2012-07-10,2,Tuesday,Fall,1,Early Morning,16,1,15
2012-07-10,3,Tuesday,Fall,1,Early Morning,3,0,3
2012-07-10,4,Tuesday,Fall,1,Early Morning,4,0,4
2012-07-10,5,Tuesday,Fall,1,Early Morning,42,3,39
2012-07-10,6,Tuesday,Fall,2,Morning Rush,187,4,183
2012-07-10,7,Tuesday,Fall,2,Morning Rush,520,31,489
2012-07-10,8,Tuesday,Fall,1,Morning Rush,649,34,615
2012-07-10,9,Tuesday,Fall,1,Morning Rush,331,47,284
2012-07-10,10,Tuesday,Fall,1,Mid-Day,190,56,134
2012-07-10,11,Tuesday,Fall,1,Mid-Day,249,92,157
2012-07-10,12,Tuesday,Fall,1,Mid-Day,272,69,203
2012-07-10,13,Tuesday,Fall,1,Mid-Day,280,77,203
2012-07-10,14,Tuesday,Fall,1,Mid-Day,242,71,171
2012-07-10,15,Tuesday,Fall,1,Mid-Day,265,77,188
2012-07-10,16,Tuesday,Fall,1,Evening Rush,435,89,346
2012-07-10,17,Tuesday,Fall,1,Evening Rush,872,103,769
2012-07-10,18,Tuesday,Fall,3,Evening Rush,819,70,749
2012-07-10,19,Tuesday,Fall,3,Evening Rush,414,55,359
2012-07-10,20,Tuesday,Fall,3,Night,84,9,75
2012-07-10,21,Tuesday,Fall,3,Night,90,7,83
2012-07-10,22,Tuesday,Fall,2,Night,139,14,125
2012-07-10,23,Tuesday,Fall,2,Night,103,29,74
2012-07-11,0,Wednesday,Fall,2,Early Morning,44,6,38
2012-07-11,1,Wednesday,Fall,1,Early Morning,14,3,11
2012-07-11,2,Wednesday,Fall,1,Early Morning,5,0,5
2012-07-11,3,Wednesday,Fall,1,Early Morning,5,0,5
2012-07-11,4,Wednesday,Fall,1,Early Morning,7,1,6
2012-07-11,5,Wednesday,Fall,1,Early Morning,41,5,36
2012-07-11,6,Wednesday,Fall,1,Morning Rush,185,17,168
2012-07-11,7,Wednesday,Fall,2,Morning Rush,497,26,471
2012-07-11,8,Wednesday,Fall,2,Morning Rush,674,30,644
2012-07-11,9,Wednesday,Fall,2,Morning Rush,328,30,298
2012-07-11,10,Wednesday,Fall,2,Mid-Day,195,47,148
2012-07-11,11,Wednesday,Fall,2,Mid-Day,229,56,173
2012-07-11,12,Wednesday,Fall,2,Mid-Day,292,69,223
2012-07-11,13,Wednesday,Fall,2,Mid-Day,273,65,208
2012-07-11,14,Wednesday,Fall,1,Mid-Day,241,66,175
2012-07-11,15,Wednesday,Fall,1,Mid-Day,276,56,220
2012-07-11,16,Wednesday,Fall,1,Evening Rush,411,53,358
2012-07-11,17,Wednesday,Fall,1,Evening Rush,830,90,740
2012-07-11,18,Wednesday,Fall,1,Evening Rush,814,79,735
2012-07-11,19,Wednesday,Fall,1,Evening Rush,633,73,560
2012-07-11,20,Wednesday,Fall,1,Night,483,73,410
2012-07-11,21,Wednesday,Fall,1,Night,391,69,322
2012-07-11,22,Wednesday,Fall,1,Night,244,41,203
2012-07-11,23,Wednesday,Fall,2,Night,152,20,132
2012-07-12,0,Thursday,Fall,2,Early Morning,56,1,55
2012-07-12,1,Thursday,Fall,2,Early Morning,21,0,21
2012-07-12,2,Thursday,Fall,2,Early Morning,9,0,9
2012-07-12,3,Thursday,Fall,1,Early Morning,10,0,10
2012-07-12,4,Thursday,Fall,1,Early Morning,5,0,5
2012-07-12,5,Thursday,Fall,1,Early Morning,44,4,40
2012-07-12,6,Thursday,Fall,1,Morning Rush,178,7,171
2012-07-12,7,Thursday,Fall,1,Morning Rush,512,32,480
2012-07-12,8,Thursday,Fall,1,Morning Rush,702,49,653
2012-07-12,9,Thursday,Fall,1,Morning Rush,327,42,285
2012-07-12,10,Thursday,Fall,1,Mid-Day,214,69,145
2012-07-12,11,Thursday,Fall,1,Mid-Day,215,49,166
2012-07-12,12,Thursday,Fall,1,Mid-Day,292,71,221
2012-07-12,13,Thursday,Fall,1,Mid-Day,277,52,225
2012-07-12,14,Thursday,Fall,1,Mid-Day,209,42,167
2012-07-12,15,Thursday,Fall,1,Mid-Day,271,63,208
2012-07-12,16,Thursday,Fall,1,Evening Rush,439,69,370
2012-07-12,17,Thursday,Fall,1,Evening Rush,795,91,704
2012-07-12,18,Thursday,Fall,1,Evening Rush,825,86,739
2012-07-12,19,Thursday,Fall,1,Evening Rush,629,97,532
2012-07-12,20,Thursday,Fall,1,Night,514,75,439
2012-07-12,21,Thursday,Fall,1,Night,373,44,329
2012-07-12,22,Thursday,Fall,1,Night,318,56,262
2012-07-12,23,Thursday,Fall,2,Night,211,33,178
2012-07-13,0,Friday,Fall,2,Early Morning,95,19,76
2012-07-13,1,Friday,Fall,2,Early Morning,59,17,42
2012-07-13,2,Friday,Fall,2,Early Morning,17,2,15
2012-07-13,3,Friday,Fall,2,Early Morning,9,2,7
2012-07-13,4,Friday,Fall,2,Early Morning,11,0,11
2012-07-13,5,Friday,Fall,2,Early Morning,34,4,30
2012-07-13,6,Friday,Fall,2,Morning Rush,127,7,120
2012-07-13,7,Friday,Fall,2,Morning Rush,380,27,353
2012-07-13,8,Friday,Fall,2,Morning Rush,713,53,660
2012-07-13,9,Friday,Fall,2,Morning Rush,414,70,344
2012-07-13,10,Friday,Fall,2,Mid-Day,268,78,190
2012-07-13,11,Friday,Fall,2,Mid-Day,288,68,220
2012-07-13,12,Friday,Fall,2,Mid-Day,379,125,254
2012-07-13,13,Friday,Fall,2,Mid-Day,374,100,274
2012-07-13,14,Friday,Fall,2,Mid-Day,369,120,249
2012-07-13,15,Friday,Fall,2,Mid-Day,353,92,261
2012-07-13,16,Friday,Fall,2,Evening Rush,492,111,381
2012-07-13,17,Friday,Fall,2,Evening Rush,835,138,697
2012-07-13,18,Friday,Fall,1,Evening Rush,631,108,523
2012-07-13,19,Friday,Fall,1,Evening Rush,488,103,385
2012-07-13,20,Friday,Fall,1,Night,389,95,294
2012-07-13,21,Friday,Fall,1,Night,299,76,223
2012-07-13,22,Friday,Fall,1,Night,263,59,204
2012-07-13,23,Friday,Fall,2,Night,212,37,175
2012-07-14,0,Saturday,Fall,2,Early Morning,191,35,156
2012-07-14,1,Saturday,Fall,2,Early Morning,118,13,105
2012-07-14,2,Saturday,Fall,2,Early Morning,101,10,91
2012-07-14,3,Saturday,Fall,2,Early Morning,40,9,31
2012-07-14,4,Saturday,Fall,3,Early Morning,9,3,6
2012-07-14,5,Saturday,Fall,2,Early Morning,5,0,5
2012-07-14,6,Saturday,Fall,2,Morning Rush,35,6,29
2012-07-14,7,Saturday,Fall,1,Morning Rush,48,7,41
2012-07-14,8,Saturday,Fall,1,Morning Rush,151,33,118
2012-07-14,9,Saturday,Fall,1,Morning Rush,282,82,200
2012-07-14,10,Saturday,Fall,2,Mid-Day,401,123,278
2012-07-14,11,Saturday,Fall,2,Mid-Day,439,143,296
2012-07-14,12,Saturday,Fall,2,Mid-Day,499,181,318
2012-07-14,13,Saturday,Fall,2,Mid-Day,591,219,372
2012-07-14,14,Saturday,Fall,1,Mid-Day,632,269,363
2012-07-14,15,Saturday,Fall,1,Mid-Day,560,243,317
2012-07-14,16,Saturday,Fall,2,Evening Rush,566,226,340
2012-07-14,17,Saturday,Fall,3,Evening Rush,458,199,259
2012-07-14,18,Saturday,Fall,1,Evening Rush,351,108,243
2012-07-14,19,Saturday,Fall,1,Evening Rush,431,156,275
2012-07-14,20,Saturday,Fall,1,Night,356,101,255
2012-07-14,21,Saturday,Fall,1,Night,269,69,200
2012-07-14,22,Saturday,Fall,1,Night,225,65,160
2012-07-14,23,Saturday,Fall,2,Night,211,55,156
2012-07-15,0,Sunday,Fall,1,Early Morning,187,40,147
2012-07-15,1,Sunday,Fall,2,Early Morning,168,49,119
2012-07-15,2,Sunday,Fall,2,Early Morning,115,29,86
2012-07-15,3,Sunday,Fall,2,Early Morning,57,15,42
2012-07-15,4,Sunday,Fall,2,Early Morning,19,8,11
2012-07-15,5,Sunday,Fall,1,Early Morning,9,2,7
2012-07-15,6,Sunday,Fall,1,Morning Rush,15,6,9
2012-07-15,7,Sunday,Fall,1,Morning Rush,47,17,30
2012-07-15,8,Sunday,Fall,2,Morning Rush,133,37,96
2012-07-15,9,Sunday,Fall,2,Morning Rush,221,58,163
2012-07-15,10,Sunday,Fall,1,Mid-Day,382,141,241
2012-07-15,11,Sunday,Fall,1,Mid-Day,451,170,281
2012-07-15,12,Sunday,Fall,1,Mid-Day,489,153,336
2012-07-15,13,Sunday,Fall,1,Mid-Day,480,171,309
2012-07-15,14,Sunday,Fall,1,Mid-Day,476,162,314
2012-07-15,15,Sunday,Fall,1,Mid-Day,489,182,307
2012-07-15,16,Sunday,Fall,1,Evening Rush,495,152,343
2012-07-15,17,Sunday,Fall,1,Evening Rush,436,122,314
2012-07-15,18,Sunday,Fall,3,Evening Rush,312,84,228
2012-07-15,19,Sunday,Fall,1,Evening Rush,312,109,203
2012-07-15,20,Sunday,Fall,1,Night,294,95,199
2012-07-15,21,Sunday,Fall,1,Night,223,59,164
2012-07-15,22,Sunday,Fall,1,Night,130,34,96
2012-07-15,23,Sunday,Fall,1,Night,91,25,66
2012-07-16,0,Monday,Fall,3,Early Morning,43,11,32
2012-07-16,1,Monday,Fall,2,Early Morning,11,1,10
2012-07-16,2,Monday,Fall,1,Early Morning,15,4,11
2012-07-16,3,Monday,Fall,1,Early Morning,6,2,4
2012-07-16,4,Monday,Fall,1,Early Morning,12,1,11
2012-07-16,5,Monday,Fall,1,Early Morning,50,10,40
2012-07-16,6,Monday,Fall,1,Morning Rush,140,8,132
2012-07-16,7,Monday,Fall,1,Morning Rush,483,24,459
2012-07-16,8,Monday,Fall,1,Morning Rush,667,48,619
2012-07-16,9,Monday,Fall,1,Morning Rush,348,51,297
2012-07-16,10,Monday,Fall,1,Mid-Day,186,69,117
2012-07-16,11,Monday,Fall,1,Mid-Day,182,57,125
2012-07-16,12,Monday,Fall,1,Mid-Day,237,79,158
2012-07-16,13,Monday,Fall,1,Mid-Day,239,63,176
2012-07-16,14,Monday,Fall,1,Mid-Day,212,53,159
2012-07-16,15,Monday,Fall,1,Mid-Day,237,61,176
2012-07-16,16,Monday,Fall,3,Evening Rush,386,77,309
2012-07-16,17,Monday,Fall,3,Evening Rush,755,86,669
2012-07-16,18,Monday,Fall,1,Evening Rush,794,97,697
2012-07-16,19,Monday,Fall,1,Evening Rush,595,92,503
2012-07-16,20,Monday,Fall,1,Night,454,66,388
2012-07-16,21,Monday,Fall,1,Night,328,45,283
2012-07-16,22,Monday,Fall,1,Night,284,56,228
2012-07-16,23,Monday,Fall,1,Night,166,27,139
2012-07-17,0,Tuesday,Fall,1,Early Morning,53,10,43
2012-07-17,1,Tuesday,Fall,1,Early Morning,25,4,21
2012-07-17,2,Tuesday,Fall,1,Early Morning,7,1,6
2012-07-17,3,Tuesday,Fall,1,Early Morning,3,0,3
2012-07-17,4,Tuesday,Fall,1,Early Morning,7,0,7
2012-07-17,5,Tuesday,Fall,1,Early Morning,38,7,31
2012-07-17,6,Tuesday,Fall,1,Morning Rush,213,16,197
2012-07-17,7,Tuesday,Fall,2,Morning Rush,526,26,500
2012-07-17,8,Tuesday,Fall,2,Morning Rush,661,43,618
2012-07-17,9,Tuesday,Fall,2,Morning Rush,320,32,288
2012-07-17,10,Tuesday,Fall,2,Mid-Day,159,37,122
2012-07-17,11,Tuesday,Fall,2,Mid-Day,206,60,146
2012-07-17,12,Tuesday,Fall,2,Mid-Day,254,80,174
2012-07-17,13,Tuesday,Fall,1,Mid-Day,221,53,168
2012-07-17,14,Tuesday,Fall,1,Mid-Day,214,54,160
2012-07-17,15,Tuesday,Fall,1,Mid-Day,244,57,187
2012-07-17,16,Tuesday,Fall,1,Evening Rush,381,64,317
2012-07-17,17,Tuesday,Fall,1,Evening Rush,770,95,675
2012-07-17,18,Tuesday,Fall,1,Evening Rush,772,60,712
2012-07-17,19,Tuesday,Fall,1,Evening Rush,547,69,478
2012-07-17,20,Tuesday,Fall,1,Night,427,52,375
2012-07-17,21,Tuesday,Fall,1,Night,333,50,283
2012-07-17,22,Tuesday,Fall,1,Night,244,29,215
2012-07-17,23,Tuesday,Fall,1,Night,161,22,139
2012-07-18,0,Wednesday,Fall,1,Early Morning,53,8,45
2012-07-18,1,Wednesday,Fall,1,Early Morning,16,2,14
2012-07-18,2,Wednesday,Fall,1,Early Morning,8,3,5
2012-07-18,3,Wednesday,Fall,1,Early Morning,4,2,2
2012-07-18,4,Wednesday,Fall,1,Early Morning,6,0,6
2012-07-18,5,Wednesday,Fall,1,Early Morning,46,5,41
2012-07-18,6,Wednesday,Fall,1,Morning Rush,162,10,152
2012-07-18,7,Wednesday,Fall,1,Morning Rush,495,23,472
2012-07-18,8,Wednesday,Fall,1,Morning Rush,679,55,624
2012-07-18,9,Wednesday,Fall,1,Morning Rush,297,44,253
2012-07-18,10,Wednesday,Fall,1,Mid-Day,138,39,99
2012-07-18,11,Wednesday,Fall,1,Mid-Day,183,47,136
2012-07-18,12,Wednesday,Fall,1,Mid-Day,202,36,166
2012-07-18,13,Wednesday,Fall,1,Mid-Day,203,49,154
2012-07-18,14,Wednesday,Fall,1,Mid-Day,170,54,116
2012-07-18,15,Wednesday,Fall,3,Mid-Day,194,42,152
2012-07-18,16,Wednesday,Fall,1,Evening Rush,224,34,190
2012-07-18,17,Wednesday,Fall,1,Evening Rush,370,35,335
2012-07-18,18,Wednesday,Fall,2,Evening Rush,643,63,580
2012-07-18,19,Wednesday,Fall,2,Evening Rush,516,78,438
2012-07-18,20,Wednesday,Fall,1,Night,366,56,310
2012-07-18,21,Wednesday,Fall,1,Night,319,53,266
2012-07-18,22,Wednesday,Fall,1,Night,288,42,246
2012-07-18,23,Wednesday,Fall,1,Night,131,19,112
2012-07-19,0,Thursday,Fall,1,Early Morning,66,16,50
2012-07-19,1,Thursday,Fall,1,Early Morning,25,6,19
2012-07-19,2,Thursday,Fall,1,Early Morning,7,0,7
2012-07-19,3,Thursday,Fall,1,Early Morning,5,1,4
2012-07-19,4,Thursday,Fall,1,Early Morning,8,0,8
2012-07-19,5,Thursday,Fall,2,Early Morning,40,5,35
2012-07-19,6,Thursday,Fall,1,Morning Rush,152,8,144
2012-07-19,7,Thursday,Fall,1,Morning Rush,473,23,450
2012-07-19,8,Thursday,Fall,1,Morning Rush,657,32,625
2012-07-19,9,Thursday,Fall,2,Morning Rush,318,36,282
2012-07-19,10,Thursday,Fall,1,Mid-Day,198,41,157
2012-07-19,11,Thursday,Fall,1,Mid-Day,216,54,162
2012-07-19,12,Thursday,Fall,1,Mid-Day,274,59,215
2012-07-19,13,Thursday,Fall,1,Mid-Day,254,74,180
2012-07-19,14,Thursday,Fall,1,Mid-Day,197,46,151
2012-07-19,15,Thursday,Fall,1,Mid-Day,292,66,226
2012-07-19,16,Thursday,Fall,1,Evening Rush,358,70,288
2012-07-19,17,Thursday,Fall,1,Evening Rush,771,93,678
2012-07-19,18,Thursday,Fall,1,Evening Rush,777,93,684
2012-07-19,19,Thursday,Fall,1,Evening Rush,533,53,480
2012-07-19,20,Thursday,Fall,1,Night,505,65,440
2012-07-19,21,Thursday,Fall,3,Night,332,38,294
2012-07-19,22,Thursday,Fall,3,Night,68,6,62
2012-07-19,23,Thursday,Fall,3,Night,65,3,62
2012-07-20,0,Friday,Fall,3,Early Morning,34,2,32
2012-07-20,1,Friday,Fall,1,Early Morning,11,2,9
2012-07-20,2,Friday,Fall,2,Early Morning,19,5,14
2012-07-20,3,Friday,Fall,2,Early Morning,36,7,29
2012-07-20,4,Friday,Fall,2,Early Morning,9,3,6
2012-07-20,5,Friday,Fall,2,Early Morning,42,2,40
2012-07-20,6,Friday,Fall,2,Morning Rush,126,3,123
2012-07-20,7,Friday,Fall,2,Morning Rush,360,14,346
2012-07-20,8,Friday,Fall,2,Morning Rush,691,39,652
2012-07-20,9,Friday,Fall,2,Morning Rush,373,45,328
2012-07-20,10,Friday,Fall,2,Mid-Day,233,51,182
2012-07-20,11,Friday,Fall,3,Mid-Day,212,51,161
2012-07-20,12,Friday,Fall,3,Mid-Day,274,41,233
2012-07-20,13,Friday,Fall,3,Mid-Day,156,20,136
2012-07-20,14,Friday,Fall,3,Mid-Day,229,53,176
2012-07-20,15,Friday,Fall,2,Mid-Day,216,47,169
2012-07-20,16,Friday,Fall,2,Evening Rush,436,70,366
2012-07-20,17,Friday,Fall,2,Evening Rush,715,95,620
2012-07-20,18,Friday,Fall,2,Evening Rush,622,73,549
2012-07-20,19,Friday,Fall,2,Evening Rush,402,44,358
2012-07-20,20,Friday,Fall,3,Night,251,35,216
2012-07-20,21,Friday,Fall,3,Night,122,14,108
2012-07-20,22,Friday,Fall,2,Night,135,13,122
2012-07-20,23,Friday,Fall,2,Night,166,18,148
2012-07-21,0,Saturday,Fall,3,Early Morning,103,11,92
2012-07-21,1,Saturday,Fall,2,Early Morning,72,10,62
2012-07-21,2,Saturday,Fall,3,Early Morning,60,5,55
2012-07-21,3,Saturday,Fall,3,Early Morning,25,7,18
2012-07-21,4,Saturday,Fall,3,Early Morning,16,11,5
2012-07-21,5,Saturday,Fall,3,Early Morning,17,7,10
2012-07-21,6,Saturday,Fall,3,Morning Rush,15,3,12
2012-07-21,7,Saturday,Fall,2,Morning Rush,37,8,29
2012-07-21,8,Saturday,Fall,2,Morning Rush,112,18,94
2012-07-21,9,Saturday,Fall,2,Morning Rush,207,32,175
2012-07-21,10,Saturday,Fall,3,Mid-Day,268,49,219
2012-07-21,11,Saturday,Fall,2,Mid-Day,305,80,225
2012-07-21,12,Saturday,Fall,3,Mid-Day,457,156,301
2012-07-21,13,Saturday,Fall,3,Mid-Day,354,106,248
2012-07-21,14,Saturday,Fall,2,Mid-Day,343,121,222
2012-07-21,15,Saturday,Fall,3,Mid-Day,380,148,232
2012-07-21,16,Saturday,Fall,3,Evening Rush,326,130,196
2012-07-21,17,Saturday,Fall,3,Evening Rush,241,92,149
2012-07-21,18,Saturday,Fall,2,Evening Rush,177,51,126
2012-07-21,19,Saturday,Fall,2,Evening Rush,238,67,171
2012-07-21,20,Saturday,Fall,3,Night,214,51,163
2012-07-21,21,Saturday,Fall,2,Night,163,29,134
2012-07-21,22,Saturday,Fall,2,Night,180,40,140
2012-07-21,23,Saturday,Fall,2,Night,149,32,117
2012-07-22,0,Sunday,Fall,2,Early Morning,113,17,96
2012-07-22,1,Sunday,Fall,2,Early Morning,130,31,99
2012-07-22,2,Sunday,Fall,2,Early Morning,122,32,90
2012-07-22,3,Sunday,Fall,2,Early Morning,43,13,30
2012-07-22,4,Sunday,Fall,1,Early Morning,16,6,10
2012-07-22,5,Sunday,Fall,1,Early Morning,6,0,6
2012-07-22,6,Sunday,Fall,2,Morning Rush,19,5,14
2012-07-22,7,Sunday,Fall,2,Morning Rush,38,13,25
2012-07-22,8,Sunday,Fall,2,Morning Rush,153,31,122
2012-07-22,9,Sunday,Fall,2,Morning Rush,258,79,179
2012-07-22,10,Sunday,Fall,2,Mid-Day,379,114,265
2012-07-22,11,Sunday,Fall,2,Mid-Day,505,191,314
2012-07-22,12,Sunday,Fall,2,Mid-Day,504,178,326
2012-07-22,13,Sunday,Fall,2,Mid-Day,626,238,388
2012-07-22,14,Sunday,Fall,1,Mid-Day,616,256,360
2012-07-22,15,Sunday,Fall,1,Mid-Day,624,254,370
2012-07-22,16,Sunday,Fall,1,Evening Rush,628,245,383
2012-07-22,17,Sunday,Fall,1,Evening Rush,556,188,368
2012-07-22,18,Sunday,Fall,1,Evening Rush,515,173,342
2012-07-22,19,Sunday,Fall,1,Evening Rush,522,180,342
2012-07-22,20,Sunday,Fall,1,Night,378,124,254
2012-07-22,21,Sunday,Fall,1,Night,345,88,257
2012-07-22,22,Sunday,Fall,1,Night,191,55,136
2012-07-22,23,Sunday,Fall,1,Night,123,33,90
2012-07-23,0,Monday,Fall,1,Early Morning,47,11,36
2012-07-23,1,Monday,Fall,1,Early Morning,27,7,20
2012-07-23,2,Monday,Fall,2,Early Morning,17,3,14
2012-07-23,3,Monday,Fall,2,Early Morning,2,0,2
2012-07-23,4,Monday,Fall,2,Early Morning,8,0,8
2012-07-23,5,Monday,Fall,2,Early Morning,51,3,48
2012-07-23,6,Monday,Fall,2,Morning Rush,157,9,148
2012-07-23,7,Monday,Fall,1,Morning Rush,421,17,404
2012-07-23,8,Monday,Fall,1,Morning Rush,738,47,691
2012-07-23,9,Monday,Fall,2,Morning Rush,345,57,288
2012-07-23,10,Monday,Fall,2,Mid-Day,200,63,137
2012-07-23,11,Monday,Fall,2,Mid-Day,198,69,129
2012-07-23,12,Monday,Fall,2,Mid-Day,314,109,205
2012-07-23,13,Monday,Fall,2,Mid-Day,240,64,176
2012-07-23,14,Monday,Fall,2,Mid-Day,271,82,189
2012-07-23,15,Monday,Fall,1,Mid-Day,281,76,205
2012-07-23,16,Monday,Fall,1,Evening Rush,457,111,346
2012-07-23,17,Monday,Fall,1,Evening Rush,847,87,760
2012-07-23,18,Monday,Fall,1,Evening Rush,741,69,672
2012-07-23,19,Monday,Fall,1,Evening Rush,582,94,488
2012-07-23,20,Monday,Fall,1,Night,403,56,347
2012-07-23,21,Monday,Fall,1,Night,296,45,251
2012-07-23,22,Monday,Fall,1,Night,209,40,169
2012-07-23,23,Monday,Fall,1,Night,114,16,98
2012-07-24,0,Tuesday,Fall,1,Early Morning,64,12,52
2012-07-24,1,Tuesday,Fall,1,Early Morning,17,7,10
2012-07-24,2,Tuesday,Fall,1,Early Morning,16,6,10
2012-07-24,3,Tuesday,Fall,1,Early Morning,6,1,5
2012-07-24,4,Tuesday,Fall,1,Early Morning,6,0,6
2012-07-24,5,Tuesday,Fall,1,Early Morning,50,5,45
2012-07-24,6,Tuesday,Fall,1,Morning Rush,190,17,173
2012-07-24,7,Tuesday,Fall,1,Morning Rush,516,24,492
2012-07-24,8,Tuesday,Fall,1,Morning Rush,743,49,694
2012-07-24,9,Tuesday,Fall,1,Morning Rush,339,40,299
2012-07-24,10,Tuesday,Fall,1,Mid-Day,218,62,156
2012-07-24,11,Tuesday,Fall,2,Mid-Day,201,45,156
2012-07-24,12,Tuesday,Fall,2,Mid-Day,229,60,169
2012-07-24,13,Tuesday,Fall,2,Mid-Day,273,73,200
2012-07-24,14,Tuesday,Fall,2,Mid-Day,244,48,196
2012-07-24,15,Tuesday,Fall,1,Mid-Day,285,73,212
2012-07-24,16,Tuesday,Fall,1,Evening Rush,455,86,369
2012-07-24,17,Tuesday,Fall,1,Evening Rush,869,94,775
2012-07-24,18,Tuesday,Fall,1,Evening Rush,877,110,767
2012-07-24,19,Tuesday,Fall,1,Evening Rush,632,109,523
2012-07-24,20,Tuesday,Fall,1,Night,523,85,438
2012-07-24,21,Tuesday,Fall,1,Night,378,53,325
2012-07-24,22,Tuesday,Fall,1,Night,269,43,226
2012-07-24,23,Tuesday,Fall,1,Night,192,38,154
2012-07-25,0,Wednesday,Fall,1,Early Morning,66,9,57
2012-07-25,1,Wednesday,Fall,1,Early Morning,28,2,26
2012-07-25,2,Wednesday,Fall,1,Early Morning,12,1,11
2012-07-25,3,Wednesday,Fall,1,Early Morning,12,1,11
2012-07-25,4,Wednesday,Fall,1,Early Morning,4,0,4
2012-07-25,5,Wednesday,Fall,1,Early Morning,59,5,54
2012-07-25,6,Wednesday,Fall,1,Morning Rush,190,11,179
2012-07-25,7,Wednesday,Fall,1,Morning Rush,507,34,473
2012-07-25,8,Wednesday,Fall,1,Morning Rush,788,43,745
2012-07-25,9,Wednesday,Fall,1,Morning Rush,342,65,277
2012-07-25,10,Wednesday,Fall,1,Mid-Day,231,68,163
2012-07-25,11,Wednesday,Fall,1,Mid-Day,281,79,202
2012-07-25,12,Wednesday,Fall,1,Mid-Day,310,77,233
2012-07-25,13,Wednesday,Fall,1,Mid-Day,312,81,231
2012-07-25,14,Wednesday,Fall,1,Mid-Day,247,88,159
2012-07-25,15,Wednesday,Fall,1,Mid-Day,317,94,223
2012-07-25,16,Wednesday,Fall,1,Evening Rush,484,91,393
2012-07-25,17,Wednesday,Fall,1,Evening Rush,913,130,783
2012-07-25,18,Wednesday,Fall,1,Evening Rush,891,104,787
2012-07-25,19,Wednesday,Fall,1,Evening Rush,698,116,582
2012-07-25,20,Wednesday,Fall,1,Night,567,106,461
2012-07-25,21,Wednesday,Fall,1,Night,397,71,326
2012-07-25,22,Wednesday,Fall,1,Night,278,55,223
2012-07-25,23,Wednesday,Fall,1,Night,239,52,187
2012-07-26,0,Thursday,Fall,1,Early Morning,92,27,65
2012-07-26,1,Thursday,Fall,1,Early Morning,29,6,23
2012-07-26,2,Thursday,Fall,1,Early Morning,21,5,16
2012-07-26,3,Thursday,Fall,1,Early Morning,8,0,8
2012-07-26,4,Thursday,Fall,1,Early Morning,4,0,4
2012-07-26,5,Thursday,Fall,1,Early Morning,42,2,40
2012-07-26,6,Thursday,Fall,1,Morning Rush,181,16,165
2012-07-26,7,Thursday,Fall,1,Morning Rush,495,17,478
2012-07-26,8,Thursday,Fall,2,Morning Rush,729,49,680
2012-07-26,9,Thursday,Fall,2,Morning Rush,344,55,289
2012-07-26,10,Thursday,Fall,1,Mid-Day,222,79,143
2012-07-26,11,Thursday,Fall,1,Mid-Day,212,69,143
2012-07-26,12,Thursday,Fall,1,Mid-Day,279,73,206
2012-07-26,13,Thursday,Fall,1,Mid-Day,242,53,189
2012-07-26,14,Thursday,Fall,1,Mid-Day,213,62,151
2012-07-26,15,Thursday,Fall,1,Mid-Day,238,65,173
2012-07-26,16,Thursday,Fall,1,Evening Rush,374,62,312
2012-07-26,17,Thursday,Fall,1,Evening Rush,738,110,628
2012-07-26,18,Thursday,Fall,1,Evening Rush,688,73,615
2012-07-26,19,Thursday,Fall,1,Evening Rush,614,80,534
2012-07-26,20,Thursday,Fall,1,Night,446,47,399
2012-07-26,21,Thursday,Fall,1,Night,271,35,236
2012-07-26,22,Thursday,Fall,1,Night,234,33,201
2012-07-26,23,Thursday,Fall,1,Night,145,18,127
2012-07-27,0,Friday,Fall,1,Early Morning,97,14,83
2012-07-27,1,Friday,Fall,1,Early Morning,54,12,42
2012-07-27,2,Friday,Fall,1,Early Morning,26,8,18
2012-07-27,3,Friday,Fall,1,Early Morning,12,3,9
2012-07-27,4,Friday,Fall,1,Early Morning,8,3,5
2012-07-27,5,Friday,Fall,1,Early Morning,37,3,34
2012-07-27,6,Friday,Fall,1,Morning Rush,139,10,129
2012-07-27,7,Friday,Fall,1,Morning Rush,410,13,397
2012-07-27,8,Friday,Fall,1,Morning Rush,676,34,642
2012-07-27,9,Friday,Fall,1,Morning Rush,363,34,329
2012-07-27,10,Friday,Fall,1,Mid-Day,231,85,146
2012-07-27,11,Friday,Fall,1,Mid-Day,251,67,184
2012-07-27,12,Friday,Fall,1,Mid-Day,299,92,207
2012-07-27,13,Friday,Fall,1,Mid-Day,314,83,231
2012-07-27,14,Friday,Fall,1,Mid-Day,326,105,221
2012-07-27,15,Friday,Fall,1,Mid-Day,323,81,242
2012-07-27,16,Friday,Fall,1,Evening Rush,499,80,419
2012-07-27,17,Friday,Fall,1,Evening Rush,699,101,598
2012-07-27,18,Friday,Fall,1,Evening Rush,622,100,522
2012-07-27,19,Friday,Fall,1,Evening Rush,516,93,423
2012-07-27,20,Friday,Fall,1,Night,354,85,269
2012-07-27,21,Friday,Fall,1,Night,260,71,189
2012-07-27,22,Friday,Fall,1,Night,199,48,151
2012-07-27,23,Friday,Fall,1,Night,189,34,155
2012-07-28,0,Saturday,Fall,1,Early Morning,191,21,170
2012-07-28,1,Saturday,Fall,1,Early Morning,80,11,69
2012-07-28,2,Saturday,Fall,1,Early Morning,90,14,76
2012-07-28,3,Saturday,Fall,1,Early Morning,43,10,33
2012-07-28,4,Saturday,Fall,1,Early Morning,11,1,10
2012-07-28,5,Saturday,Fall,1,Early Morning,14,4,10
2012-07-28,6,Saturday,Fall,1,Morning Rush,50,10,40
2012-07-28,7,Saturday,Fall,1,Morning Rush,76,18,58
2012-07-28,8,Saturday,Fall,1,Morning Rush,163,36,127
2012-07-28,9,Saturday,Fall,1,Morning Rush,337,110,227
2012-07-28,10,Saturday,Fall,1,Mid-Day,395,129,266
2012-07-28,11,Saturday,Fall,1,Mid-Day,457,162,295
2012-07-28,12,Saturday,Fall,1,Mid-Day,487,157,330
2012-07-28,13,Saturday,Fall,1,Mid-Day,498,173,325
2012-07-28,14,Saturday,Fall,1,Mid-Day,494,186,308
2012-07-28,15,Saturday,Fall,1,Mid-Day,497,206,291
2012-07-28,16,Saturday,Fall,1,Evening Rush,487,208,279
2012-07-28,17,Saturday,Fall,1,Evening Rush,479,199,280
2012-07-28,18,Saturday,Fall,1,Evening Rush,481,151,330
2012-07-28,19,Saturday,Fall,1,Evening Rush,338,115,223
2012-07-28,20,Saturday,Fall,1,Night,233,79,154
2012-07-28,21,Saturday,Fall,1,Night,300,94,206
2012-07-28,22,Saturday,Fall,1,Night,276,88,188
2012-07-28,23,Saturday,Fall,1,Night,208,52,156
2012-07-29,0,Sunday,Fall,1,Early Morning,188,59,129
2012-07-29,1,Sunday,Fall,1,Early Morning,158,49,109
2012-07-29,2,Sunday,Fall,1,Early Morning,112,33,79
2012-07-29,3,Sunday,Fall,1,Early Morning,55,18,37
2012-07-29,4,Sunday,Fall,1,Early Morning,13,2,11
2012-07-29,5,Sunday,Fall,1,Early Morning,17,3,14
2012-07-29,6,Sunday,Fall,1,Morning Rush,18,6,12
2012-07-29,7,Sunday,Fall,1,Morning Rush,40,4,36
2012-07-29,8,Sunday,Fall,1,Morning Rush,127,37,90
2012-07-29,9,Sunday,Fall,1,Morning Rush,226,64,162
2012-07-29,10,Sunday,Fall,1,Mid-Day,381,123,258
2012-07-29,11,Sunday,Fall,1,Mid-Day,509,183,326
2012-07-29,12,Sunday,Fall,1,Mid-Day,511,154,357
2012-07-29,13,Sunday,Fall,1,Mid-Day,483,181,302
2012-07-29,14,Sunday,Fall,1,Mid-Day,522,231,291
2012-07-29,15,Sunday,Fall,1,Mid-Day,501,195,306
2012-07-29,16,Sunday,Fall,1,Evening Rush,521,191,330
2012-07-29,17,Sunday,Fall,1,Evening Rush,531,164,367
2012-07-29,18,Sunday,Fall,1,Evening Rush,419,117,302
2012-07-29,19,Sunday,Fall,1,Evening Rush,443,143,300
2012-07-29,20,Sunday,Fall,1,Night,303,75,228
2012-07-29,21,Sunday,Fall,1,Night,271,72,199
2012-07-29,22,Sunday,Fall,1,Night,148,31,117
2012-07-29,23,Sunday,Fall,1,Night,100,18,82
2012-07-30,0,Monday,Fall,1,Early Morning,58,12,46
2012-07-30,1,Monday,Fall,1,Early Morning,19,4,15
2012-07-30,2,Monday,Fall,1,Early Morning,8,2,6
2012-07-30,3,Monday,Fall,1,Early Morning,3,0,3
2012-07-30,4,Monday,Fall,1,Early Morning,5,0,5
2012-07-30,5,Monday,Fall,1,Early Morning,47,4,43
2012-07-30,6,Monday,Fall,1,Morning Rush,161,6,155
2012-07-30,7,Monday,Fall,1,Morning Rush,469,14,455
2012-07-30,8,Monday,Fall,2,Morning Rush,751,31,720
2012-07-30,9,Monday,Fall,2,Morning Rush,293,34,259
2012-07-30,10,Monday,Fall,2,Mid-Day,189,54,135
2012-07-30,11,Monday,Fall,2,Mid-Day,215,69,146
2012-07-30,12,Monday,Fall,2,Mid-Day,278,77,201
2012-07-30,13,Monday,Fall,1,Mid-Day,226,57,169
2012-07-30,14,Monday,Fall,1,Mid-Day,254,87,167
2012-07-30,15,Monday,Fall,1,Mid-Day,236,51,185
2012-07-30,16,Monday,Fall,1,Evening Rush,425,88,337
2012-07-30,17,Monday,Fall,1,Evening Rush,827,62,765
2012-07-30,18,Monday,Fall,1,Evening Rush,812,77,735
2012-07-30,19,Monday,Fall,1,Evening Rush,665,81,584
2012-07-30,20,Monday,Fall,1,Night,462,78,384
2012-07-30,21,Monday,Fall,1,Night,322,71,251
2012-07-30,22,Monday,Fall,2,Night,230,47,183
2012-07-30,23,Monday,Fall,1,Night,150,34,116
2012-07-31,0,Tuesday,Fall,1,Early Morning,38,11,27
2012-07-31,1,Tuesday,Fall,1,Early Morning,21,3,18
2012-07-31,2,Tuesday,Fall,1,Early Morning,8,0,8
2012-07-31,3,Tuesday,Fall,1,Early Morning,6,1,5
2012-07-31,4,Tuesday,Fall,1,Early Morning,6,0,6
2012-07-31,5,Tuesday,Fall,1,Early Morning,45,5,40
2012-07-31,6,Tuesday,Fall,1,Morning Rush,194,2,192
2012-07-31,7,Tuesday,Fall,1,Morning Rush,513,21,492
2012-07-31,8,Tuesday,Fall,1,Morning Rush,760,30,730
2012-07-31,9,Tuesday,Fall,1,Morning Rush,333,31,302
2012-07-31,10,Tuesday,Fall,1,Mid-Day,227,73,154
2012-07-31,11,Tuesday,Fall,1,Mid-Day,224,54,170
2012-07-31,12,Tuesday,Fall,1,Mid-Day,248,50,198
2012-07-31,13,Tuesday,Fall,1,Mid-Day,288,69,219
2012-07-31,14,Tuesday,Fall,1,Mid-Day,260,72,188
2012-07-31,15,Tuesday,Fall,1,Mid-Day,144,29,115
2012-07-31,16,Tuesday,Fall,1,Evening Rush,402,66,336
2012-07-31,17,Tuesday,Fall,1,Evening Rush,820,94,726
2012-07-31,18,Tuesday,Fall,1,Evening Rush,857,99,758
2012-07-31,19,Tuesday,Fall,3,Evening Rush,614,90,524
2012-07-31,20,Tuesday,Fall,3,Night,452,55,397
2012-07-31,21,Tuesday,Fall,1,Night,352,60,292
2012-07-31,22,Tuesday,Fall,1,Night,257,33,224
2012-07-31,23,Tuesday,Fall,2,Night,147,20,127
2012-08-01,0,Wednesday,Fall,1,Early Morning,47,3,44
2012-08-01,1,Wednesday,Fall,1,Early Morning,33,5,28
2012-08-01,2,Wednesday,Fall,1,Early Morning,13,0,13
2012-08-01,3,Wednesday,Fall,1,Early Morning,7,0,7
2012-08-01,4,Wednesday,Fall,2,Early Morning,4,1,3
2012-08-01,5,Wednesday,Fall,2,Early Morning,49,3,46
2012-08-01,6,Wednesday,Fall,1,Morning Rush,185,6,179
2012-08-01,7,Wednesday,Fall,2,Morning Rush,487,19,468
2012-08-01,8,Wednesday,Fall,2,Morning Rush,681,32,649
2012-08-01,9,Wednesday,Fall,2,Morning Rush,350,34,316
2012-08-01,10,Wednesday,Fall,1,Mid-Day,236,61,175
2012-08-01,11,Wednesday,Fall,1,Mid-Day,234,54,180
2012-08-01,12,Wednesday,Fall,1,Mid-Day,284,75,209
2012-08-01,13,Wednesday,Fall,1,Mid-Day,280,59,221
2012-08-01,14,Wednesday,Fall,1,Mid-Day,263,88,175
2012-08-01,15,Wednesday,Fall,1,Mid-Day,295,89,206
2012-08-01,16,Wednesday,Fall,1,Evening Rush,479,93,386
2012-08-01,17,Wednesday,Fall,1,Evening Rush,837,103,734
2012-08-01,18,Wednesday,Fall,3,Evening Rush,891,105,786
2012-08-01,19,Wednesday,Fall,1,Evening Rush,652,88,564
2012-08-01,20,Wednesday,Fall,1,Night,513,65,448
2012-08-01,21,Wednesday,Fall,1,Night,320,36,284
2012-08-01,22,Wednesday,Fall,1,Night,288,37,251
2012-08-01,23,Wednesday,Fall,1,Night,152,18,134
2012-08-02,0,Thursday,Fall,1,Early Morning,63,8,55
2012-08-02,1,Thursday,Fall,1,Early Morning,42,6,36
2012-08-02,2,Thursday,Fall,1,Early Morning,11,3,8
2012-08-02,3,Thursday,Fall,1,Early Morning,6,0,6
2012-08-02,4,Thursday,Fall,1,Early Morning,9,0,9
2012-08-02,5,Thursday,Fall,1,Early Morning,41,4,37
2012-08-02,6,Thursday,Fall,1,Morning Rush,183,6,177
2012-08-02,7,Thursday,Fall,1,Morning Rush,473,21,452
2012-08-02,8,Thursday,Fall,1,Morning Rush,739,21,718
2012-08-02,9,Thursday,Fall,1,Morning Rush,343,31,312
2012-08-02,10,Thursday,Fall,1,Mid-Day,181,51,130
2012-08-02,11,Thursday,Fall,1,Mid-Day,226,59,167
2012-08-02,12,Thursday,Fall,1,Mid-Day,286,56,230
2012-08-02,13,Thursday,Fall,1,Mid-Day,310,98,212
2012-08-02,14,Thursday,Fall,1,Mid-Day,225,54,171
2012-08-02,15,Thursday,Fall,1,Mid-Day,270,68,202
2012-08-02,16,Thursday,Fall,1,Evening Rush,406,71,335
2012-08-02,17,Thursday,Fall,1,Evening Rush,865,90,775
2012-08-02,18,Thursday,Fall,1,Evening Rush,767,86,681
2012-08-02,19,Thursday,Fall,1,Evening Rush,607,98,509
2012-08-02,20,Thursday,Fall,1,Night,427,51,376
2012-08-02,21,Thursday,Fall,1,Night,342,41,301
2012-08-02,22,Thursday,Fall,1,Night,262,35,227
2012-08-02,23,Thursday,Fall,1,Night,177,25,152
2012-08-03,0,Friday,Fall,1,Early Morning,71,15,56
2012-08-03,1,Friday,Fall,1,Early Morning,43,11,32
2012-08-03,2,Friday,Fall,1,Early Morning,14,0,14
2012-08-03,3,Friday,Fall,1,Early Morning,6,1,5
2012-08-03,4,Friday,Fall,1,Early Morning,12,1,11
2012-08-03,5,Friday,Fall,1,Early Morning,37,2,35
2012-08-03,6,Friday,Fall,1,Morning Rush,163,5,158
2012-08-03,7,Friday,Fall,1,Morning Rush,421,25,396
2012-08-03,8,Friday,Fall,1,Morning Rush,668,32,636
2012-08-03,9,Friday,Fall,2,Morning Rush,396,69,327
2012-08-03,10,Friday,Fall,2,Mid-Day,249,82,167
2012-08-03,11,Friday,Fall,2,Mid-Day,263,77,186
2012-08-03,12,Friday,Fall,2,Mid-Day,338,95,243
2012-08-03,13,Friday,Fall,2,Mid-Day,345,98,247
2012-08-03,14,Friday,Fall,2,Mid-Day,331,102,229
2012-08-03,15,Friday,Fall,1,Mid-Day,380,112,268
2012-08-03,16,Friday,Fall,2,Evening Rush,492,112,380
2012-08-03,17,Friday,Fall,2,Evening Rush,741,95,646
2012-08-03,18,Friday,Fall,2,Evening Rush,671,98,573
2012-08-03,19,Friday,Fall,2,Evening Rush,469,81,388
2012-08-03,20,Friday,Fall,2,Night,389,89,300
2012-08-03,21,Friday,Fall,2,Night,278,54,224
2012-08-03,22,Friday,Fall,1,Night,202,46,156
2012-08-03,23,Friday,Fall,1,Night,196,26,170
2012-08-04,0,Saturday,Fall,1,Early Morning,161,24,137
2012-08-04,1,Saturday,Fall,1,Early Morning,122,23,99
2012-08-04,2,Saturday,Fall,1,Early Morning,84,20,64
2012-08-04,3,Saturday,Fall,1,Early Morning,30,11,19
2012-08-04,4,Saturday,Fall,1,Early Morning,13,2,11
2012-08-04,5,Saturday,Fall,1,Early Morning,17,1,16
2012-08-04,6,Saturday,Fall,1,Morning Rush,49,12,37
2012-08-04,7,Saturday,Fall,1,Morning Rush,67,18,49
2012-08-04,8,Saturday,Fall,1,Morning Rush,181,49,132
2012-08-04,9,Saturday,Fall,1,Morning Rush,278,61,217
2012-08-04,10,Saturday,Fall,1,Mid-Day,396,108,288
2012-08-04,11,Saturday,Fall,1,Mid-Day,470,155,315
2012-08-04,12,Saturday,Fall,1,Mid-Day,547,222,325
2012-08-04,13,Saturday,Fall,1,Mid-Day,527,195,332
2012-08-04,14,Saturday,Fall,1,Mid-Day,472,183,289
2012-08-04,15,Saturday,Fall,1,Mid-Day,489,205,284
2012-08-04,16,Saturday,Fall,1,Evening Rush,450,197,253
2012-08-04,17,Saturday,Fall,1,Evening Rush,492,179,313
2012-08-04,18,Saturday,Fall,1,Evening Rush,490,169,321
2012-08-04,19,Saturday,Fall,1,Evening Rush,397,133,264
2012-08-04,20,Saturday,Fall,1,Night,312,117,195
2012-08-04,21,Saturday,Fall,1,Night,289,96,193
2012-08-04,22,Saturday,Fall,1,Night,269,104,165
2012-08-04,23,Saturday,Fall,1,Night,222,61,161
2012-08-05,0,Sunday,Fall,1,Early Morning,153,32,121
2012-08-05,1,Sunday,Fall,1,Early Morning,87,8,79
2012-08-05,2,Sunday,Fall,1,Early Morning,73,5,68
2012-08-05,3,Sunday,Fall,1,Early Morning,41,9,32
2012-08-05,4,Sunday,Fall,1,Early Morning,14,3,11
2012-08-05,5,Sunday,Fall,1,Early Morning,19,1,18
2012-08-05,6,Sunday,Fall,1,Morning Rush,19,7,12
2012-08-05,7,Sunday,Fall,1,Morning Rush,68,18,50
2012-08-05,8,Sunday,Fall,1,Morning Rush,108,27,81
2012-08-05,9,Sunday,Fall,1,Morning Rush,229,61,168
2012-08-05,10,Sunday,Fall,1,Mid-Day,364,111,253
2012-08-05,11,Sunday,Fall,1,Mid-Day,437,155,282
2012-08-05,12,Sunday,Fall,1,Mid-Day,491,161,330
2012-08-05,13,Sunday,Fall,1,Mid-Day,523,208,315
2012-08-05,14,Sunday,Fall,1,Mid-Day,526,161,365
2012-08-05,15,Sunday,Fall,1,Mid-Day,450,164,286
2012-08-05,16,Sunday,Fall,1,Evening Rush,421,143,278
2012-08-05,17,Sunday,Fall,1,Evening Rush,382,122,260
2012-08-05,18,Sunday,Fall,3,Evening Rush,229,75,154
2012-08-05,19,Sunday,Fall,1,Evening Rush,185,46,139
2012-08-05,20,Sunday,Fall,1,Night,193,53,140
2012-08-05,21,Sunday,Fall,1,Night,208,51,157
2012-08-05,22,Sunday,Fall,1,Night,157,57,100
2012-08-05,23,Sunday,Fall,2,Night,87,29,58
2012-08-06,0,Monday,Fall,2,Early Morning,33,9,24
2012-08-06,1,Monday,Fall,1,Early Morning,11,1,10
2012-08-06,2,Monday,Fall,2,Early Morning,5,0,5
2012-08-06,3,Monday,Fall,3,Early Morning,5,0,5
2012-08-06,4,Monday,Fall,2,Early Morning,11,3,8
2012-08-06,5,Monday,Fall,1,Early Morning,25,2,23
2012-08-06,6,Monday,Fall,2,Morning Rush,141,4,137
2012-08-06,7,Monday,Fall,3,Morning Rush,407,14,393
2012-08-06,8,Monday,Fall,2,Morning Rush,605,27,578
2012-08-06,9,Monday,Fall,3,Morning Rush,276,28,248
2012-08-06,10,Monday,Fall,1,Mid-Day,213,54,159
2012-08-06,11,Monday,Fall,1,Mid-Day,260,108,152
2012-08-06,12,Monday,Fall,2,Mid-Day,285,72,213
2012-08-06,13,Monday,Fall,1,Mid-Day,289,85,204
2012-08-06,14,Monday,Fall,1,Mid-Day,287,99,188
2012-08-06,15,Monday,Fall,1,Mid-Day,274,91,183
2012-08-06,16,Monday,Fall,1,Evening Rush,451,88,363
2012-08-06,17,Monday,Fall,1,Evening Rush,858,112,746
2012-08-06,18,Monday,Fall,1,Evening Rush,843,100,743
2012-08-06,19,Monday,Fall,1,Evening Rush,640,109,531
2012-08-06,20,Monday,Fall,1,Night,457,89,368
2012-08-06,21,Monday,Fall,1,Night,317,72,245
2012-08-06,22,Monday,Fall,1,Night,207,50,157
2012-08-06,23,Monday,Fall,1,Night,113,16,97
2012-08-07,0,Tuesday,Fall,1,Early Morning,47,15,32
2012-08-07,1,Tuesday,Fall,1,Early Morning,18,2,16
2012-08-07,2,Tuesday,Fall,1,Early Morning,13,6,7
2012-08-07,3,Tuesday,Fall,1,Early Morning,6,0,6
2012-08-07,4,Tuesday,Fall,1,Early Morning,9,2,7
2012-08-07,5,Tuesday,Fall,1,Early Morning,36,3,33
2012-08-07,6,Tuesday,Fall,2,Morning Rush,179,3,176
2012-08-07,7,Tuesday,Fall,2,Morning Rush,502,21,481
2012-08-07,8,Tuesday,Fall,2,Morning Rush,705,41,664
2012-08-07,9,Tuesday,Fall,2,Morning Rush,327,44,283
2012-08-07,10,Tuesday,Fall,2,Mid-Day,250,89,161
2012-08-07,11,Tuesday,Fall,2,Mid-Day,214,84,130
2012-08-07,12,Tuesday,Fall,2,Mid-Day,283,86,197
2012-08-07,13,Tuesday,Fall,2,Mid-Day,253,68,185
2012-08-07,14,Tuesday,Fall,2,Mid-Day,261,76,185
2012-08-07,15,Tuesday,Fall,1,Mid-Day,306,100,206
2012-08-07,16,Tuesday,Fall,3,Evening Rush,445,101,344
2012-08-07,17,Tuesday,Fall,2,Evening Rush,868,125,743
2012-08-07,18,Tuesday,Fall,2,Evening Rush,814,103,711
2012-08-07,19,Tuesday,Fall,2,Evening Rush,610,104,506
2012-08-07,20,Tuesday,Fall,2,Night,448,74,374
2012-08-07,21,Tuesday,Fall,2,Night,317,70,247
2012-08-07,22,Tuesday,Fall,1,Night,224,43,181
2012-08-07,23,Tuesday,Fall,1,Night,138,18,120
2012-08-08,0,Wednesday,Fall,1,Early Morning,58,12,46
2012-08-08,1,Wednesday,Fall,1,Early Morning,23,3,20
2012-08-08,2,Wednesday,Fall,1,Early Morning,6,1,5
2012-08-08,3,Wednesday,Fall,1,Early Morning,7,1,6
2012-08-08,4,Wednesday,Fall,1,Early Morning,7,1,6
2012-08-08,5,Wednesday,Fall,2,Early Morning,43,3,40
2012-08-08,6,Wednesday,Fall,2,Morning Rush,173,4,169
2012-08-08,7,Wednesday,Fall,2,Morning Rush,482,24,458
2012-08-08,8,Wednesday,Fall,2,Morning Rush,737,48,689
2012-08-08,9,Wednesday,Fall,2,Morning Rush,341,33,308
2012-08-08,10,Wednesday,Fall,2,Mid-Day,214,63,151
2012-08-08,11,Wednesday,Fall,2,Mid-Day,239,80,159
2012-08-08,12,Wednesday,Fall,2,Mid-Day,280,63,217
2012-08-08,13,Wednesday,Fall,2,Mid-Day,313,101,212
2012-08-08,14,Wednesday,Fall,2,Mid-Day,236,63,173
2012-08-08,15,Wednesday,Fall,2,Mid-Day,278,110,168
2012-08-08,16,Wednesday,Fall,2,Evening Rush,441,113,328
2012-08-08,17,Wednesday,Fall,2,Evening Rush,858,107,751
2012-08-08,18,Wednesday,Fall,2,Evening Rush,862,117,745
2012-08-08,19,Wednesday,Fall,1,Evening Rush,686,119,567
2012-08-08,20,Wednesday,Fall,1,Night,500,76,424
2012-08-08,21,Wednesday,Fall,1,Night,381,70,311
2012-08-08,22,Wednesday,Fall,1,Night,233,35,198
2012-08-08,23,Wednesday,Fall,1,Night,136,16,120
2012-08-09,0,Thursday,Fall,1,Early Morning,67,16,51
2012-08-09,1,Thursday,Fall,1,Early Morning,28,5,23
2012-08-09,2,Thursday,Fall,1,Early Morning,14,2,12
2012-08-09,3,Thursday,Fall,1,Early Morning,6,1,5
2012-08-09,4,Thursday,Fall,2,Early Morning,10,0,10
2012-08-09,5,Thursday,Fall,2,Early Morning,41,4,37
2012-08-09,6,Thursday,Fall,1,Morning Rush,167,5,162
2012-08-09,7,Thursday,Fall,2,Morning Rush,475,24,451
2012-08-09,8,Thursday,Fall,1,Morning Rush,698,28,670
2012-08-09,9,Thursday,Fall,1,Morning Rush,353,54,299
2012-08-09,10,Thursday,Fall,1,Mid-Day,205,72,133
2012-08-09,11,Thursday,Fall,1,Mid-Day,260,94,166
2012-08-09,12,Thursday,Fall,1,Mid-Day,277,85,192
2012-08-09,13,Thursday,Fall,1,Mid-Day,281,80,201
2012-08-09,14,Thursday,Fall,1,Mid-Day,247,86,161
2012-08-09,15,Thursday,Fall,1,Mid-Day,267,63,204
2012-08-09,16,Thursday,Fall,1,Evening Rush,417,97,320
2012-08-09,17,Thursday,Fall,1,Evening Rush,810,111,699
2012-08-09,18,Thursday,Fall,2,Evening Rush,811,78,733
2012-08-09,19,Thursday,Fall,1,Evening Rush,623,90,533
2012-08-09,20,Thursday,Fall,1,Night,478,91,387
2012-08-09,21,Thursday,Fall,2,Night,336,50,286
2012-08-09,22,Thursday,Fall,2,Night,259,41,218
2012-08-09,23,Thursday,Fall,1,Night,156,19,137
2012-08-10,0,Friday,Fall,1,Early Morning,85,17,68
2012-08-10,1,Friday,Fall,1,Early Morning,41,6,35
2012-08-10,2,Friday,Fall,1,Early Morning,20,6,14
2012-08-10,3,Friday,Fall,2,Early Morning,9,3,6
2012-08-10,4,Friday,Fall,3,Early Morning,7,0,7
2012-08-10,5,Friday,Fall,3,Early Morning,33,4,29
2012-08-10,6,Friday,Fall,3,Morning Rush,44,3,41
2012-08-10,7,Friday,Fall,3,Morning Rush,133,5,128
2012-08-10,8,Friday,Fall,3,Morning Rush,119,7,112
2012-08-10,9,Friday,Fall,2,Morning Rush,220,21,199
2012-08-10,10,Friday,Fall,1,Mid-Day,193,27,166
2012-08-10,11,Friday,Fall,3,Mid-Day,251,73,178
2012-08-10,12,Friday,Fall,2,Mid-Day,315,75,240
2012-08-10,13,Friday,Fall,2,Mid-Day,290,66,224
2012-08-10,14,Friday,Fall,1,Mid-Day,307,71,236
2012-08-10,15,Friday,Fall,1,Mid-Day,324,100,224
2012-08-10,16,Friday,Fall,1,Evening Rush,467,96,371
2012-08-10,17,Friday,Fall,1,Evening Rush,730,111,619
2012-08-10,18,Friday,Fall,1,Evening Rush,640,88,552
2012-08-10,19,Friday,Fall,1,Evening Rush,492,98,394
2012-08-10,20,Friday,Fall,1,Night,370,55,315
2012-08-10,21,Friday,Fall,1,Night,286,50,236
2012-08-10,22,Friday,Fall,1,Night,218,50,168
2012-08-10,23,Friday,Fall,1,Night,192,33,159
2012-08-11,0,Saturday,Fall,1,Early Morning,180,38,142
2012-08-11,1,Saturday,Fall,1,Early Morning,116,32,84
2012-08-11,2,Saturday,Fall,3,Early Morning,85,19,66
2012-08-11,3,Saturday,Fall,3,Early Morning,21,2,19
2012-08-11,4,Saturday,Fall,1,Early Morning,10,3,7
2012-08-11,5,Saturday,Fall,1,Early Morning,11,2,9
2012-08-11,6,Saturday,Fall,2,Morning Rush,23,5,18
2012-08-11,7,Saturday,Fall,1,Morning Rush,62,8,54
2012-08-11,8,Saturday,Fall,1,Morning Rush,162,30,132
2012-08-11,9,Saturday,Fall,1,Morning Rush,271,54,217
2012-08-11,10,Saturday,Fall,1,Mid-Day,407,125,282
2012-08-11,11,Saturday,Fall,1,Mid-Day,499,203,296
2012-08-11,12,Saturday,Fall,1,Mid-Day,546,214,332
2012-08-11,13,Saturday,Fall,1,Mid-Day,569,228,341
2012-08-11,14,Saturday,Fall,1,Mid-Day,538,248,290
2012-08-11,15,Saturday,Fall,1,Mid-Day,562,246,316
2012-08-11,16,Saturday,Fall,1,Evening Rush,531,227,304
2012-08-11,17,Saturday,Fall,3,Evening Rush,512,220,292
2012-08-11,18,Saturday,Fall,2,Evening Rush,300,107,193
2012-08-11,19,Saturday,Fall,2,Evening Rush,275,97,178
2012-08-11,20,Saturday,Fall,3,Night,160,31,129
2012-08-11,21,Saturday,Fall,2,Night,128,26,102
2012-08-11,22,Saturday,Fall,2,Night,168,40,128
2012-08-11,23,Saturday,Fall,3,Night,163,42,121
2012-08-12,0,Sunday,Fall,2,Early Morning,120,24,96
2012-08-12,1,Sunday,Fall,1,Early Morning,113,21,92
2012-08-12,2,Sunday,Fall,1,Early Morning,86,19,67
2012-08-12,3,Sunday,Fall,1,Early Morning,48,11,37
2012-08-12,4,Sunday,Fall,1,Early Morning,10,2,8
2012-08-12,5,Sunday,Fall,1,Early Morning,10,1,9
2012-08-12,6,Sunday,Fall,1,Morning Rush,16,2,14
2012-08-12,7,Sunday,Fall,1,Morning Rush,39,9,30
2012-08-12,8,Sunday,Fall,1,Morning Rush,119,35,84
2012-08-12,9,Sunday,Fall,1,Morning Rush,217,64,153
2012-08-12,10,Sunday,Fall,1,Mid-Day,328,88,240
2012-08-12,11,Sunday,Fall,1,Mid-Day,449,167,282
2012-08-12,12,Sunday,Fall,1,Mid-Day,505,163,342
2012-08-12,13,Sunday,Fall,1,Mid-Day,543,178,365
2012-08-12,14,Sunday,Fall,1,Mid-Day,579,213,366
2012-08-12,15,Sunday,Fall,1,Mid-Day,577,235,342
2012-08-12,16,Sunday,Fall,1,Evening Rush,513,213,300
2012-08-12,17,Sunday,Fall,1,Evening Rush,505,186,319
2012-08-12,18,Sunday,Fall,1,Evening Rush,491,164,327
2012-08-12,19,Sunday,Fall,1,Evening Rush,465,148,317
2012-08-12,20,Sunday,Fall,1,Night,300,96,204
2012-08-12,21,Sunday,Fall,1,Night,220,78,142
2012-08-12,22,Sunday,Fall,1,Night,181,40,141
2012-08-12,23,Sunday,Fall,1,Night,110,25,85
2012-08-13,0,Monday,Fall,1,Early Morning,47,14,33
2012-08-13,1,Monday,Fall,1,Early Morning,14,3,11
2012-08-13,2,Monday,Fall,1,Early Morning,9,1,8
2012-08-13,3,Monday,Fall,1,Early Morning,6,1,5
2012-08-13,4,Monday,Fall,1,Early Morning,11,0,11
2012-08-13,5,Monday,Fall,1,Early Morning,36,3,33
2012-08-13,6,Monday,Fall,1,Morning Rush,159,4,155
2012-08-13,7,Monday,Fall,1,Morning Rush,436,11,425
2012-08-13,8,Monday,Fall,2,Morning Rush,673,25,648
2012-08-13,9,Monday,Fall,2,Morning Rush,305,40,265
2012-08-13,10,Monday,Fall,2,Mid-Day,199,88,111
2012-08-13,11,Monday,Fall,1,Mid-Day,245,94,151
2012-08-13,12,Monday,Fall,1,Mid-Day,276,96,180
2012-08-13,13,Monday,Fall,1,Mid-Day,254,79,175
2012-08-13,14,Monday,Fall,1,Mid-Day,248,85,163
2012-08-13,15,Monday,Fall,1,Mid-Day,274,80,194
2012-08-13,16,Monday,Fall,1,Evening Rush,464,116,348
2012-08-13,17,Monday,Fall,1,Evening Rush,818,102,716
2012-08-13,18,Monday,Fall,1,Evening Rush,812,103,709
2012-08-13,19,Monday,Fall,1,Evening Rush,555,88,467
2012-08-13,20,Monday,Fall,1,Night,432,58,374
2012-08-13,21,Monday,Fall,1,Night,290,44,246
2012-08-13,22,Monday,Fall,1,Night,192,44,148
2012-08-13,23,Monday,Fall,1,Night,128,28,100
2012-08-14,0,Tuesday,Fall,1,Early Morning,60,12,48
2012-08-14,1,Tuesday,Fall,1,Early Morning,27,8,19
2012-08-14,2,Tuesday,Fall,2,Early Morning,11,2,9
2012-08-14,3,Tuesday,Fall,2,Early Morning,3,0,3
2012-08-14,4,Tuesday,Fall,2,Early Morning,5,0,5
2012-08-14,5,Tuesday,Fall,2,Early Morning,36,1,35
2012-08-14,6,Tuesday,Fall,3,Morning Rush,64,1,63
2012-08-14,7,Tuesday,Fall,2,Morning Rush,179,1,178
2012-08-14,8,Tuesday,Fall,2,Morning Rush,618,27,591
2012-08-14,9,Tuesday,Fall,2,Morning Rush,402,48,354
2012-08-14,10,Tuesday,Fall,1,Mid-Day,208,53,155
2012-08-14,11,Tuesday,Fall,1,Mid-Day,196,69,127
2012-08-14,12,Tuesday,Fall,1,Mid-Day,300,93,207
2012-08-14,13,Tuesday,Fall,1,Mid-Day,286,83,203
2012-08-14,14,Tuesday,Fall,1,Mid-Day,255,80,175
2012-08-14,15,Tuesday,Fall,1,Mid-Day,283,84,199
2012-08-14,16,Tuesday,Fall,1,Evening Rush,458,95,363
2012-08-14,17,Tuesday,Fall,3,Evening Rush,812,78,734
2012-08-14,18,Tuesday,Fall,1,Evening Rush,854,97,757
2012-08-14,19,Tuesday,Fall,1,Evening Rush,627,94,533
2012-08-14,20,Tuesday,Fall,1,Night,436,65,371
2012-08-14,21,Tuesday,Fall,1,Night,308,56,252
2012-08-14,22,Tuesday,Fall,1,Night,189,28,161
2012-08-14,23,Tuesday,Fall,1,Night,167,53,114
2012-08-15,0,Wednesday,Fall,1,Early Morning,60,8,52
2012-08-15,1,Wednesday,Fall,1,Early Morning,37,6,31
2012-08-15,2,Wednesday,Fall,1,Early Morning,8,1,7
2012-08-15,3,Wednesday,Fall,1,Early Morning,11,1,10
2012-08-15,4,Wednesday,Fall,1,Early Morning,4,0,4
2012-08-15,5,Wednesday,Fall,1,Early Morning,39,4,35
2012-08-15,6,Wednesday,Fall,1,Morning Rush,172,12,160
2012-08-15,7,Wednesday,Fall,2,Morning Rush,492,25,467
2012-08-15,8,Wednesday,Fall,2,Morning Rush,682,40,642
2012-08-15,9,Wednesday,Fall,2,Morning Rush,367,57,310
2012-08-15,10,Wednesday,Fall,2,Mid-Day,233,70,163
2012-08-15,11,Wednesday,Fall,2,Mid-Day,235,80,155
2012-08-15,12,Wednesday,Fall,1,Mid-Day,307,77,230
2012-08-15,13,Wednesday,Fall,2,Mid-Day,294,88,206
2012-08-15,14,Wednesday,Fall,2,Mid-Day,255,94,161
2012-08-15,15,Wednesday,Fall,1,Mid-Day,266,70,196
2012-08-15,16,Wednesday,Fall,1,Evening Rush,431,91,340
2012-08-15,17,Wednesday,Fall,1,Evening Rush,851,102,749
2012-08-15,18,Wednesday,Fall,1,Evening Rush,848,80,768
2012-08-15,19,Wednesday,Fall,1,Evening Rush,649,124,525
2012-08-15,20,Wednesday,Fall,1,Night,427,72,355
2012-08-15,21,Wednesday,Fall,1,Night,315,49,266
2012-08-15,22,Wednesday,Fall,1,Night,226,29,197
2012-08-15,23,Wednesday,Fall,1,Night,138,18,120
2012-08-16,0,Thursday,Fall,1,Early Morning,76,13,63
2012-08-16,1,Thursday,Fall,1,Early Morning,21,3,18
2012-08-16,2,Thursday,Fall,1,Early Morning,15,0,15
2012-08-16,3,Thursday,Fall,1,Early Morning,4,0,4
2012-08-16,4,Thursday,Fall,1,Early Morning,5,2,3
2012-08-16,5,Thursday,Fall,1,Early Morning,37,7,30
2012-08-16,6,Thursday,Fall,1,Morning Rush,165,3,162
2012-08-16,7,Thursday,Fall,1,Morning Rush,464,16,448
2012-08-16,8,Thursday,Fall,1,Morning Rush,682,33,649
2012-08-16,9,Thursday,Fall,1,Morning Rush,337,41,296
2012-08-16,10,Thursday,Fall,1,Mid-Day,199,78,121
2012-08-16,11,Thursday,Fall,1,Mid-Day,274,83,191
2012-08-16,12,Thursday,Fall,1,Mid-Day,343,96,247
2012-08-16,13,Thursday,Fall,1,Mid-Day,300,81,219
2012-08-16,14,Thursday,Fall,1,Mid-Day,248,72,176
2012-08-16,15,Thursday,Fall,1,Mid-Day,260,63,197
2012-08-16,16,Thursday,Fall,1,Evening Rush,419,79,340
2012-08-16,17,Thursday,Fall,1,Evening Rush,897,130,767
2012-08-16,18,Thursday,Fall,1,Evening Rush,832,109,723
2012-08-16,19,Thursday,Fall,1,Evening Rush,677,119,558
2012-08-16,20,Thursday,Fall,1,Night,514,100,414
2012-08-16,21,Thursday,Fall,1,Night,356,83,273
2012-08-16,22,Thursday,Fall,1,Night,254,69,185
2012-08-16,23,Thursday,Fall,1,Night,226,58,168
2012-08-17,0,Friday,Fall,1,Early Morning,88,21,67
2012-08-17,1,Friday,Fall,1,Early Morning,54,16,38
2012-08-17,2,Friday,Fall,1,Early Morning,19,4,15
2012-08-17,3,Friday,Fall,1,Early Morning,6,0,6
2012-08-17,4,Friday,Fall,1,Early Morning,9,0,9
2012-08-17,5,Friday,Fall,1,Early Morning,36,2,34
2012-08-17,6,Friday,Fall,1,Morning Rush,157,6,151
2012-08-17,7,Friday,Fall,1,Morning Rush,379,11,368
2012-08-17,8,Friday,Fall,1,Morning Rush,668,43,625
2012-08-17,9,Friday,Fall,1,Morning Rush,378,58,320
2012-08-17,10,Friday,Fall,1,Mid-Day,231,82,149
2012-08-17,11,Friday,Fall,1,Mid-Day,303,98,205
2012-08-17,12,Friday,Fall,1,Mid-Day,365,110,255
2012-08-17,13,Friday,Fall,1,Mid-Day,357,103,254
2012-08-17,14,Friday,Fall,1,Mid-Day,328,128,200
2012-08-17,15,Friday,Fall,1,Mid-Day,383,127,256
2012-08-17,16,Friday,Fall,2,Evening Rush,488,116,372
2012-08-17,17,Friday,Fall,1,Evening Rush,791,144,647
2012-08-17,18,Friday,Fall,2,Evening Rush,669,108,561
2012-08-17,19,Friday,Fall,2,Evening Rush,491,88,403
2012-08-17,20,Friday,Fall,2,Night,359,97,262
2012-08-17,21,Friday,Fall,2,Night,255,57,198
2012-08-17,22,Friday,Fall,3,Night,213,43,170
2012-08-17,23,Friday,Fall,3,Night,121,21,100
2012-08-18,0,Saturday,Fall,2,Early Morning,105,6,99
2012-08-18,1,Saturday,Fall,3,Early Morning,92,14,78
2012-08-18,2,Saturday,Fall,3,Early Morning,43,4,39
2012-08-18,3,Saturday,Fall,1,Early Morning,30,7,23
2012-08-18,4,Saturday,Fall,1,Early Morning,13,5,8
2012-08-18,5,Saturday,Fall,1,Early Morning,9,2,7
2012-08-18,6,Saturday,Fall,1,Morning Rush,27,4,23
2012-08-18,7,Saturday,Fall,1,Morning Rush,64,12,52
2012-08-18,8,Saturday,Fall,1,Morning Rush,189,28,161
2012-08-18,9,Saturday,Fall,1,Morning Rush,292,81,211
2012-08-18,10,Saturday,Fall,1,Mid-Day,480,166,314
2012-08-18,11,Saturday,Fall,1,Mid-Day,536,180,356
2012-08-18,12,Saturday,Fall,1,Mid-Day,654,266,388
2012-08-18,13,Saturday,Fall,1,Mid-Day,644,289,355
2012-08-18,14,Saturday,Fall,1,Mid-Day,598,242,356
2012-08-18,15,Saturday,Fall,1,Mid-Day,596,250,346
2012-08-18,16,Saturday,Fall,1,Evening Rush,641,287,354
2012-08-18,17,Saturday,Fall,1,Evening Rush,635,256,379
2012-08-18,18,Saturday,Fall,1,Evening Rush,554,225,329
2012-08-18,19,Saturday,Fall,1,Evening Rush,488,164,324
2012-08-18,20,Saturday,Fall,1,Night,341,99,242
2012-08-18,21,Saturday,Fall,1,Night,338,90,248
2012-08-18,22,Saturday,Fall,1,Night,261,90,171
2012-08-18,23,Saturday,Fall,1,Night,235,60,175
2012-08-19,0,Sunday,Fall,1,Early Morning,187,44,143
2012-08-19,1,Sunday,Fall,1,Early Morning,131,29,102
2012-08-19,2,Sunday,Fall,2,Early Morning,119,16,103
2012-08-19,3,Sunday,Fall,2,Early Morning,55,21,34
2012-08-19,4,Sunday,Fall,2,Early Morning,26,4,22
2012-08-19,5,Sunday,Fall,2,Early Morning,11,3,8
2012-08-19,6,Sunday,Fall,2,Morning Rush,20,5,15
2012-08-19,7,Sunday,Fall,2,Morning Rush,41,12,29
2012-08-19,8,Sunday,Fall,2,Morning Rush,124,34,90
2012-08-19,9,Sunday,Fall,2,Morning Rush,270,86,184
2012-08-19,10,Sunday,Fall,2,Mid-Day,425,138,287
2012-08-19,11,Sunday,Fall,3,Mid-Day,272,83,189
2012-08-19,12,Sunday,Fall,3,Mid-Day,298,112,186
2012-08-19,13,Sunday,Fall,3,Mid-Day,162,50,112
2012-08-19,14,Sunday,Fall,3,Mid-Day,149,41,108
2012-08-19,15,Sunday,Fall,2,Mid-Day,276,89,187
2012-08-19,16,Sunday,Fall,2,Evening Rush,356,97,259
2012-08-19,17,Sunday,Fall,2,Evening Rush,343,76,267
2012-08-19,18,Sunday,Fall,2,Evening Rush,377,86,291
2012-08-19,19,Sunday,Fall,2,Evening Rush,341,72,269
2012-08-19,20,Sunday,Fall,2,Night,274,61,213
2012-08-19,21,Sunday,Fall,3,Night,190,36,154
2012-08-19,22,Sunday,Fall,2,Night,56,6,50
2012-08-19,23,Sunday,Fall,2,Night,46,7,39
2012-08-20,0,Monday,Fall,2,Early Morning,26,1,25
2012-08-20,1,Monday,Fall,1,Early Morning,10,0,10
2012-08-20,2,Monday,Fall,1,Early Morning,5,0,5
2012-08-20,3,Monday,Fall,1,Early Morning,3,0,3
2012-08-20,4,Monday,Fall,2,Early Morning,7,0,7
2012-08-20,5,Monday,Fall,2,Early Morning,37,2,35
2012-08-20,6,Monday,Fall,2,Morning Rush,161,6,155
2012-08-20,7,Monday,Fall,2,Morning Rush,442,15,427
2012-08-20,8,Monday,Fall,2,Morning Rush,655,37,618
2012-08-20,9,Monday,Fall,2,Morning Rush,357,55,302
2012-08-20,10,Monday,Fall,2,Mid-Day,193,69,124
2012-08-20,11,Monday,Fall,1,Mid-Day,241,90,151
2012-08-20,12,Monday,Fall,2,Mid-Day,282,66,216
2012-08-20,13,Monday,Fall,1,Mid-Day,291,97,194
2012-08-20,14,Monday,Fall,1,Mid-Day,275,87,188
2012-08-20,15,Monday,Fall,1,Mid-Day,309,102,207
2012-08-20,16,Monday,Fall,1,Evening Rush,460,103,357
2012-08-20,17,Monday,Fall,1,Evening Rush,893,83,810
2012-08-20,18,Monday,Fall,2,Evening Rush,815,89,726
2012-08-20,19,Monday,Fall,2,Evening Rush,299,33,266
2012-08-20,20,Monday,Fall,2,Night,261,30,231
2012-08-20,21,Monday,Fall,1,Night,245,26,219
2012-08-20,22,Monday,Fall,2,Night,161,25,136
2012-08-20,23,Monday,Fall,2,Night,102,10,92
2012-08-21,0,Tuesday,Fall,2,Early Morning,59,7,52
2012-08-21,1,Tuesday,Fall,2,Early Morning,33,11,22
2012-08-21,2,Tuesday,Fall,2,Early Morning,8,1,7
2012-08-21,3,Tuesday,Fall,1,Early Morning,3,0,3
2012-08-21,4,Tuesday,Fall,1,Early Morning,4,0,4
2012-08-21,5,Tuesday,Fall,1,Early Morning,34,4,30
2012-08-21,6,Tuesday,Fall,1,Morning Rush,169,5,164
2012-08-21,7,Tuesday,Fall,1,Morning Rush,519,19,500
2012-08-21,8,Tuesday,Fall,1,Morning Rush,723,27,696
2012-08-21,9,Tuesday,Fall,1,Morning Rush,328,47,281
2012-08-21,10,Tuesday,Fall,1,Mid-Day,178,58,120
2012-08-21,11,Tuesday,Fall,1,Mid-Day,256,61,195
2012-08-21,12,Tuesday,Fall,1,Mid-Day,305,79,226
2012-08-21,13,Tuesday,Fall,1,Mid-Day,331,76,255
2012-08-21,14,Tuesday,Fall,1,Mid-Day,302,110,192
2012-08-21,15,Tuesday,Fall,1,Mid-Day,302,76,226
2012-08-21,16,Tuesday,Fall,1,Evening Rush,467,109,358
2012-08-21,17,Tuesday,Fall,1,Evening Rush,878,92,786
2012-08-21,18,Tuesday,Fall,1,Evening Rush,625,93,532
2012-08-21,19,Tuesday,Fall,3,Evening Rush,476,56,420
2012-08-21,20,Tuesday,Fall,1,Night,358,62,296
2012-08-21,21,Tuesday,Fall,1,Night,280,41,239
2012-08-21,22,Tuesday,Fall,1,Night,232,24,208
2012-08-21,23,Tuesday,Fall,1,Night,136,23,113
2012-08-22,0,Wednesday,Fall,1,Early Morning,55,9,46
2012-08-22,1,Wednesday,Fall,1,Early Morning,21,1,20
2012-08-22,2,Wednesday,Fall,1,Early Morning,17,7,10
2012-08-22,3,Wednesday,Fall,1,Early Morning,7,0,7
2012-08-22,4,Wednesday,Fall,1,Early Morning,8,1,7
2012-08-22,5,Wednesday,Fall,1,Early Morning,40,2,38
2012-08-22,6,Wednesday,Fall,1,Morning Rush,187,12,175
2012-08-22,7,Wednesday,Fall,1,Morning Rush,553,16,537
2012-08-22,8,Wednesday,Fall,1,Morning Rush,740,37,703
2012-08-22,9,Wednesday,Fall,1,Morning Rush,376,41,335
2012-08-22,10,Wednesday,Fall,1,Mid-Day,225,66,159
2012-08-22,11,Wednesday,Fall,1,Mid-Day,267,71,196
2012-08-22,12,Wednesday,Fall,1,Mid-Day,312,59,253
2012-08-22,13,Wednesday,Fall,1,Mid-Day,316,74,242
2012-08-22,14,Wednesday,Fall,1,Mid-Day,266,82,184
2012-08-22,15,Wednesday,Fall,1,Mid-Day,316,94,222
2012-08-22,16,Wednesday,Fall,3,Evening Rush,460,102,358
2012-08-22,17,Wednesday,Fall,3,Evening Rush,783,72,711
2012-08-22,18,Wednesday,Fall,3,Evening Rush,683,91,592
2012-08-22,19,Wednesday,Fall,2,Evening Rush,580,56,524
2012-08-22,20,Wednesday,Fall,1,Night,391,59,332
2012-08-22,21,Wednesday,Fall,1,Night,351,60,291
2012-08-22,22,Wednesday,Fall,1,Night,281,55,226
2012-08-22,23,Wednesday,Fall,1,Night,140,27,113
2012-08-23,0,Thursday,Fall,1,Early Morning,60,9,51
2012-08-23,1,Thursday,Fall,1,Early Morning,25,10,15
2012-08-23,2,Thursday,Fall,1,Early Morning,20,9,11
2012-08-23,3,Thursday,Fall,1,Early Morning,9,3,6
2012-08-23,4,Thursday,Fall,1,Early Morning,6,0,6
2012-08-23,5,Thursday,Fall,1,Early Morning,37,1,36
2012-08-23,6,Thursday,Fall,2,Morning Rush,192,14,178
2012-08-23,7,Thursday,Fall,2,Morning Rush,481,18,463
2012-08-23,8,Thursday,Fall,2,Morning Rush,707,45,662
2012-08-23,9,Thursday,Fall,2,Morning Rush,412,58,354
2012-08-23,10,Thursday,Fall,1,Mid-Day,233,76,157
2012-08-23,11,Thursday,Fall,1,Mid-Day,278,86,192
2012-08-23,12,Thursday,Fall,1,Mid-Day,332,97,235
2012-08-23,13,Thursday,Fall,1,Mid-Day,346,93,253
2012-08-23,14,Thursday,Fall,1,Mid-Day,305,114,191
2012-08-23,15,Thursday,Fall,1,Mid-Day,305,104,201
2012-08-23,16,Thursday,Fall,1,Evening Rush,465,121,344
2012-08-23,17,Thursday,Fall,1,Evening Rush,820,111,709
2012-08-23,18,Thursday,Fall,1,Evening Rush,941,130,811
2012-08-23,19,Thursday,Fall,1,Evening Rush,633,96,537
2012-08-23,20,Thursday,Fall,1,Night,474,70,404
2012-08-23,21,Thursday,Fall,1,Night,329,53,276
2012-08-23,22,Thursday,Fall,2,Night,198,21,177
2012-08-23,23,Thursday,Fall,2,Night,157,24,133
2012-08-24,0,Friday,Fall,2,Early Morning,111,27,84
2012-08-24,1,Friday,Fall,2,Early Morning,42,5,37
2012-08-24,2,Friday,Fall,1,Early Morning,16,1,15
2012-08-24,3,Friday,Fall,1,Early Morning,8,2,6
2012-08-24,4,Friday,Fall,2,Early Morning,8,2,6
2012-08-24,5,Friday,Fall,1,Early Morning,38,1,37
2012-08-24,6,Friday,Fall,2,Morning Rush,151,9,142
2012-08-24,7,Friday,Fall,2,Morning Rush,425,13,412
2012-08-24,8,Friday,Fall,2,Morning Rush,744,41,703
2012-08-24,9,Friday,Fall,2,Morning Rush,389,58,331
2012-08-24,10,Friday,Fall,2,Mid-Day,262,78,184
2012-08-24,11,Friday,Fall,2,Mid-Day,281,69,212
2012-08-24,12,Friday,Fall,2,Mid-Day,371,95,276
2012-08-24,13,Friday,Fall,2,Mid-Day,351,79,272
2012-08-24,14,Friday,Fall,1,Mid-Day,338,109,229
2012-08-24,15,Friday,Fall,2,Mid-Day,350,99,251
2012-08-24,16,Friday,Fall,2,Evening Rush,515,101,414
2012-08-24,17,Friday,Fall,2,Evening Rush,812,117,695
2012-08-24,18,Friday,Fall,2,Evening Rush,736,109,627
2012-08-24,19,Friday,Fall,2,Evening Rush,536,106,430
2012-08-24,20,Friday,Fall,2,Night,363,66,297
2012-08-24,21,Friday,Fall,2,Night,306,58,248
2012-08-24,22,Friday,Fall,2,Night,251,42,209
2012-08-24,23,Friday,Fall,2,Night,178,38,140
2012-08-25,0,Saturday,Fall,2,Early Morning,135,21,114
2012-08-25,1,Saturday,Fall,2,Early Morning,115,15,100
2012-08-25,2,Saturday,Fall,2,Early Morning,79,18,61
2012-08-25,3,Saturday,Fall,1,Early Morning,38,7,31
2012-08-25,4,Saturday,Fall,2,Early Morning,12,3,9
2012-08-25,5,Saturday,Fall,2,Early Morning,14,4,10
2012-08-25,6,Saturday,Fall,2,Morning Rush,30,5,25
2012-08-25,7,Saturday,Fall,2,Morning Rush,102,14,88
2012-08-25,8,Saturday,Fall,2,Morning Rush,162,29,133
2012-08-25,9,Saturday,Fall,2,Morning Rush,288,60,228
2012-08-25,10,Saturday,Fall,2,Mid-Day,442,148,294
2012-08-25,11,Saturday,Fall,2,Mid-Day,457,143,314
2012-08-25,12,Saturday,Fall,3,Mid-Day,584,217,367
2012-08-25,13,Saturday,Fall,2,Mid-Day,517,186,331
2012-08-25,14,Saturday,Fall,3,Mid-Day,482,150,332
2012-08-25,15,Saturday,Fall,2,Mid-Day,233,79,154
2012-08-25,16,Saturday,Fall,2,Evening Rush,434,174,260
2012-08-25,17,Saturday,Fall,2,Evening Rush,403,132,271
2012-08-25,18,Saturday,Fall,2,Evening Rush,383,122,261
2012-08-25,19,Saturday,Fall,2,Evening Rush,354,97,257
2012-08-25,20,Saturday,Fall,3,Night,241,65,176
2012-08-25,21,Saturday,Fall,1,Night,208,60,148
2012-08-25,22,Saturday,Fall,1,Night,182,46,136
2012-08-25,23,Saturday,Fall,2,Night,158,34,124
2012-08-26,0,Sunday,Fall,1,Early Morning,134,23,111
2012-08-26,1,Sunday,Fall,1,Early Morning,134,18,116
2012-08-26,2,Sunday,Fall,2,Early Morning,116,12,104
2012-08-26,3,Sunday,Fall,2,Early Morning,53,11,42
2012-08-26,4,Sunday,Fall,2,Early Morning,16,5,11
2012-08-26,5,Sunday,Fall,1,Early Morning,16,3,13
2012-08-26,6,Sunday,Fall,1,Morning Rush,21,5,16
2012-08-26,7,Sunday,Fall,1,Morning Rush,34,11,23
2012-08-26,8,Sunday,Fall,1,Morning Rush,133,21,112
2012-08-26,9,Sunday,Fall,1,Morning Rush,263,67,196
2012-08-26,10,Sunday,Fall,1,Mid-Day,385,127,258
2012-08-26,11,Sunday,Fall,1,Mid-Day,482,150,332
2012-08-26,12,Sunday,Fall,3,Mid-Day,626,225,401
2012-08-26,13,Sunday,Fall,3,Mid-Day,541,166,375
2012-08-26,14,Sunday,Fall,1,Mid-Day,377,125,252
2012-08-26,15,Sunday,Fall,3,Mid-Day,391,132,259
2012-08-26,16,Sunday,Fall,3,Evening Rush,173,57,116
2012-08-26,17,Sunday,Fall,1,Evening Rush,233,61,172
2012-08-26,18,Sunday,Fall,2,Evening Rush,264,77,187
2012-08-26,19,Sunday,Fall,2,Evening Rush,292,80,212
2012-08-26,20,Sunday,Fall,1,Night,211,40,171
2012-08-26,21,Sunday,Fall,1,Night,166,26,140
2012-08-26,22,Sunday,Fall,1,Night,114,20,94
2012-08-26,23,Sunday,Fall,1,Night,80,21,59
2012-08-27,0,Monday,Fall,1,Early Morning,32,4,28
2012-08-27,1,Monday,Fall,1,Early Morning,7,3,4
2012-08-27,2,Monday,Fall,1,Early Morning,8,0,8
2012-08-27,3,Monday,Fall,1,Early Morning,4,1,3
2012-08-27,4,Monday,Fall,1,Early Morning,12,1,11
2012-08-27,5,Monday,Fall,1,Early Morning,36,4,32
2012-08-27,6,Monday,Fall,1,Morning Rush,145,4,141
2012-08-27,7,Monday,Fall,1,Morning Rush,433,15,418
2012-08-27,8,Monday,Fall,1,Morning Rush,699,29,670
2012-08-27,9,Monday,Fall,1,Morning Rush,342,40,302
2012-08-27,10,Monday,Fall,1,Mid-Day,206,63,143
2012-08-27,11,Monday,Fall,1,Mid-Day,229,47,182
2012-08-27,12,Monday,Fall,1,Mid-Day,283,69,214
2012-08-27,13,Monday,Fall,1,Mid-Day,288,77,211
2012-08-27,14,Monday,Fall,1,Mid-Day,246,66,180
2012-08-27,15,Monday,Fall,1,Mid-Day,282,77,205
2012-08-27,16,Monday,Fall,1,Evening Rush,444,77,367
2012-08-27,17,Monday,Fall,1,Evening Rush,845,101,744
2012-08-27,18,Monday,Fall,1,Evening Rush,834,83,751
2012-08-27,19,Monday,Fall,1,Evening Rush,573,74,499
2012-08-27,20,Monday,Fall,1,Night,416,50,366
2012-08-27,21,Monday,Fall,1,Night,278,39,239
2012-08-27,22,Monday,Fall,1,Night,161,30,131
2012-08-27,23,Monday,Fall,1,Night,114,35,79
2012-08-28,0,Tuesday,Fall,1,Early Morning,38,9,29
2012-08-28,1,Tuesday,Fall,1,Early Morning,21,4,17
2012-08-28,2,Tuesday,Fall,1,Early Morning,15,2,13
2012-08-28,3,Tuesday,Fall,1,Early Morning,4,0,4
2012-08-28,4,Tuesday,Fall,1,Early Morning,8,2,6
2012-08-28,5,Tuesday,Fall,2,Early Morning,42,3,39
2012-08-28,6,Tuesday,Fall,2,Morning Rush,147,3,144
2012-08-28,7,Tuesday,Fall,2,Morning Rush,269,14,255
2012-08-28,8,Tuesday,Fall,2,Morning Rush,693,25,668
2012-08-28,9,Tuesday,Fall,2,Morning Rush,395,44,351
2012-08-28,10,Tuesday,Fall,1,Mid-Day,204,39,165
2012-08-28,11,Tuesday,Fall,1,Mid-Day,218,47,171
2012-08-28,12,Tuesday,Fall,1,Mid-Day,297,56,241
2012-08-28,13,Tuesday,Fall,1,Mid-Day,288,56,232
2012-08-28,14,Tuesday,Fall,1,Mid-Day,251,72,179
2012-08-28,15,Tuesday,Fall,1,Mid-Day,317,59,258
2012-08-28,16,Tuesday,Fall,1,Evening Rush,480,84,396
2012-08-28,17,Tuesday,Fall,1,Evening Rush,864,90,774
2012-08-28,18,Tuesday,Fall,1,Evening Rush,818,82,736
2012-08-28,19,Tuesday,Fall,1,Evening Rush,597,82,515
2012-08-28,20,Tuesday,Fall,1,Night,435,87,348
2012-08-28,21,Tuesday,Fall,1,Night,314,38,276
2012-08-28,22,Tuesday,Fall,1,Night,216,20,196
2012-08-28,23,Tuesday,Fall,1,Night,109,17,92
2012-08-29,0,Wednesday,Fall,1,Early Morning,47,8,39
2012-08-29,1,Wednesday,Fall,1,Early Morning,14,2,12
2012-08-29,2,Wednesday,Fall,1,Early Morning,6,2,4
2012-08-29,3,Wednesday,Fall,1,Early Morning,9,0,9
2012-08-29,4,Wednesday,Fall,1,Early Morning,10,2,8
2012-08-29,5,Wednesday,Fall,1,Early Morning,40,3,37
2012-08-29,6,Wednesday,Fall,1,Morning Rush,181,6,175
2012-08-29,7,Wednesday,Fall,1,Morning Rush,554,23,531
2012-08-29,8,Wednesday,Fall,1,Morning Rush,808,28,780
2012-08-29,9,Wednesday,Fall,1,Morning Rush,348,40,308
2012-08-29,10,Wednesday,Fall,1,Mid-Day,178,34,144
2012-08-29,11,Wednesday,Fall,1,Mid-Day,253,67,186
2012-08-29,12,Wednesday,Fall,1,Mid-Day,360,79,281
2012-08-29,13,Wednesday,Fall,1,Mid-Day,300,68,232
2012-08-29,14,Wednesday,Fall,1,Mid-Day,301,87,214
2012-08-29,15,Wednesday,Fall,1,Mid-Day,338,96,242
2012-08-29,16,Wednesday,Fall,1,Evening Rush,493,104,389
2012-08-29,17,Wednesday,Fall,1,Evening Rush,870,108,762
2012-08-29,18,Wednesday,Fall,1,Evening Rush,812,119,693
2012-08-29,19,Wednesday,Fall,1,Evening Rush,643,120,523
2012-08-29,20,Wednesday,Fall,1,Night,427,49,378
2012-08-29,21,Wednesday,Fall,1,Night,313,48,265
2012-08-29,22,Wednesday,Fall,1,Night,235,50,185
2012-08-29,23,Wednesday,Fall,1,Night,157,34,123
2012-08-30,0,Thursday,Fall,1,Early Morning,65,14,51
2012-08-30,1,Thursday,Fall,1,Early Morning,23,6,17
2012-08-30,2,Thursday,Fall,1,Early Morning,17,3,14
2012-08-30,3,Thursday,Fall,1,Early Morning,5,0,5
2012-08-30,4,Thursday,Fall,1,Early Morning,8,4,4
2012-08-30,5,Thursday,Fall,1,Early Morning,35,2,33
2012-08-30,6,Thursday,Fall,1,Morning Rush,163,8,155
2012-08-30,7,Thursday,Fall,1,Morning Rush,532,31,501
2012-08-30,8,Thursday,Fall,1,Morning Rush,754,53,701
2012-08-30,9,Thursday,Fall,1,Morning Rush,396,57,339
2012-08-30,10,Thursday,Fall,1,Mid-Day,234,73,161
2012-08-30,11,Thursday,Fall,1,Mid-Day,276,85,191
2012-08-30,12,Thursday,Fall,1,Mid-Day,294,73,221
2012-08-30,13,Thursday,Fall,1,Mid-Day,290,76,214
2012-08-30,14,Thursday,Fall,1,Mid-Day,273,74,199
2012-08-30,15,Thursday,Fall,1,Mid-Day,338,99,239
2012-08-30,16,Thursday,Fall,1,Evening Rush,482,77,405
2012-08-30,17,Thursday,Fall,1,Evening Rush,844,93,751
2012-08-30,18,Thursday,Fall,1,Evening Rush,853,109,744
2012-08-30,19,Thursday,Fall,1,Evening Rush,610,78,532
2012-08-30,20,Thursday,Fall,1,Night,471,68,403
2012-08-30,21,Thursday,Fall,1,Night,307,32,275
2012-08-30,22,Thursday,Fall,1,Night,291,38,253
2012-08-30,23,Thursday,Fall,1,Night,152,19,133
2012-08-31,0,Friday,Fall,1,Early Morning,82,13,69
2012-08-31,1,Friday,Fall,1,Early Morning,32,8,24
2012-08-31,2,Friday,Fall,1,Early Morning,20,9,11
2012-08-31,3,Friday,Fall,1,Early Morning,5,3,2
2012-08-31,4,Friday,Fall,1,Early Morning,7,0,7
2012-08-31,5,Friday,Fall,1,Early Morning,29,2,27
2012-08-31,6,Friday,Fall,2,Morning Rush,108,7,101
2012-08-31,7,Friday,Fall,2,Morning Rush,421,21,400
2012-08-31,8,Friday,Fall,2,Morning Rush,690,36,654
2012-08-31,9,Friday,Fall,1,Morning Rush,398,61,337
2012-08-31,10,Friday,Fall,1,Mid-Day,256,59,197
2012-08-31,11,Friday,Fall,1,Mid-Day,309,88,221
2012-08-31,12,Friday,Fall,1,Mid-Day,410,120,290
2012-08-31,13,Friday,Fall,1,Mid-Day,368,97,271
2012-08-31,14,Friday,Fall,1,Mid-Day,436,112,324
2012-08-31,15,Friday,Fall,1,Mid-Day,526,109,417
2012-08-31,16,Friday,Fall,1,Evening Rush,528,111,417
2012-08-31,17,Friday,Fall,1,Evening Rush,617,129,488
2012-08-31,18,Friday,Fall,1,Evening Rush,546,87,459
2012-08-31,19,Friday,Fall,1,Evening Rush,452,91,361
2012-08-31,20,Friday,Fall,1,Night,356,102,254
2012-08-31,21,Friday,Fall,1,Night,303,71,232
2012-08-31,22,Friday,Fall,1,Night,277,65,212
2012-08-31,23,Friday,Fall,1,Night,174,32,142
2012-09-01,0,Saturday,Fall,1,Early Morning,168,22,146
2012-09-01,1,Saturday,Fall,1,Early Morning,79,11,68
2012-09-01,2,Saturday,Fall,1,Early Morning,69,8,61
2012-09-01,3,Saturday,Fall,1,Early Morning,35,6,29
2012-09-01,4,Saturday,Fall,1,Early Morning,12,3,9
2012-09-01,5,Saturday,Fall,1,Early Morning,22,2,20
2012-09-01,6,Saturday,Fall,1,Morning Rush,36,13,23
2012-09-01,7,Saturday,Fall,2,Morning Rush,66,8,58
2012-09-01,8,Saturday,Fall,2,Morning Rush,162,28,134
2012-09-01,9,Saturday,Fall,2,Morning Rush,237,62,175
2012-09-01,10,Saturday,Fall,2,Mid-Day,417,128,289
2012-09-01,11,Saturday,Fall,2,Mid-Day,492,219,273
2012-09-01,12,Saturday,Fall,2,Mid-Day,471,187,284
2012-09-01,13,Saturday,Fall,2,Mid-Day,504,237,267
2012-09-01,14,Saturday,Fall,2,Mid-Day,514,240,274
2012-09-01,15,Saturday,Fall,2,Mid-Day,563,257,306
2012-09-01,16,Saturday,Fall,2,Evening Rush,462,209,253
2012-09-01,17,Saturday,Fall,2,Evening Rush,463,205,258
2012-09-01,18,Saturday,Fall,2,Evening Rush,442,184,258
2012-09-01,19,Saturday,Fall,3,Evening Rush,392,157,235
2012-09-01,20,Saturday,Fall,3,Night,207,67,140
2012-09-01,21,Saturday,Fall,3,Night,104,21,83
2012-09-01,22,Saturday,Fall,2,Night,78,21,57
2012-09-01,23,Saturday,Fall,1,Night,145,57,88
2012-09-02,0,Sunday,Fall,2,Early Morning,99,27,72
2012-09-02,1,Sunday,Fall,1,Early Morning,73,15,58
2012-09-02,2,Sunday,Fall,1,Early Morning,84,28,56
2012-09-02,3,Sunday,Fall,1,Early Morning,42,9,33
2012-09-02,4,Sunday,Fall,1,Early Morning,22,7,15
2012-09-02,5,Sunday,Fall,1,Early Morning,12,2,10
2012-09-02,6,Sunday,Fall,2,Morning Rush,15,2,13
2012-09-02,7,Sunday,Fall,1,Morning Rush,42,13,29
2012-09-02,8,Sunday,Fall,1,Morning Rush,129,30,99
2012-09-02,9,Sunday,Fall,2,Morning Rush,232,88,144
2012-09-02,10,Sunday,Fall,2,Mid-Day,388,158,230
2012-09-02,11,Sunday,Fall,2,Mid-Day,489,226,263
2012-09-02,12,Sunday,Fall,3,Mid-Day,545,248,297
2012-09-02,13,Sunday,Fall,3,Mid-Day,493,263,230
2012-09-02,14,Sunday,Fall,3,Mid-Day,457,249,208
2012-09-02,15,Sunday,Fall,3,Mid-Day,355,179,176
2012-09-02,16,Sunday,Fall,1,Evening Rush,474,222,252
2012-09-02,17,Sunday,Fall,1,Evening Rush,503,219,284
2012-09-02,18,Sunday,Fall,1,Evening Rush,500,227,273
2012-09-02,19,Sunday,Fall,2,Evening Rush,292,140,152
2012-09-02,20,Sunday,Fall,2,Night,104,63,41
2012-09-02,21,Sunday,Fall,1,Night,171,79,92
2012-09-02,22,Sunday,Fall,3,Night,166,66,100
2012-09-02,23,Sunday,Fall,3,Night,123,53,70
2012-09-03,0,Monday,Fall,2,Early Morning,104,42,62
2012-09-03,1,Monday,Fall,2,Early Morning,55,18,37
2012-09-03,2,Monday,Fall,1,Early Morning,40,10,30
2012-09-03,3,Monday,Fall,1,Early Morning,28,6,22
2012-09-03,4,Monday,Fall,1,Early Morning,11,6,5
2012-09-03,5,Monday,Fall,1,Early Morning,4,1,3
2012-09-03,6,Monday,Fall,1,Morning Rush,15,3,12
2012-09-03,7,Monday,Fall,1,Morning Rush,43,6,37
2012-09-03,8,Monday,Fall,2,Morning Rush,127,36,91
2012-09-03,9,Monday,Fall,2,Morning Rush,229,71,158
2012-09-03,10,Monday,Fall,2,Mid-Day,359,135,224
2012-09-03,11,Monday,Fall,2,Mid-Day,459,187,272
2012-09-03,12,Monday,Fall,2,Mid-Day,543,191,352
2012-09-03,13,Monday,Fall,2,Mid-Day,566,209,357
2012-09-03,14,Monday,Fall,1,Mid-Day,512,163,349
2012-09-03,15,Monday,Fall,1,Mid-Day,449,168,281
2012-09-03,16,Monday,Fall,1,Evening Rush,500,165,335
2012-09-03,17,Monday,Fall,1,Evening Rush,498,181,317
2012-09-03,18,Monday,Fall,1,Evening Rush,482,145,337
2012-09-03,19,Monday,Fall,1,Evening Rush,374,73,301
2012-09-03,20,Monday,Fall,1,Night,261,78,183
2012-09-03,21,Monday,Fall,1,Night,184,42,142
2012-09-03,22,Monday,Fall,2,Night,121,17,104
2012-09-03,23,Monday,Fall,2,Night,70,12,58
2012-09-04,0,Tuesday,Fall,2,Early Morning,29,10,19
2012-09-04,1,Tuesday,Fall,1,Early Morning,24,15,9
2012-09-04,2,Tuesday,Fall,1,Early Morning,5,1,4
2012-09-04,3,Tuesday,Fall,2,Early Morning,10,1,9
2012-09-04,4,Tuesday,Fall,2,Early Morning,8,0,8
2012-09-04,5,Tuesday,Fall,2,Early Morning,38,1,37
2012-09-04,6,Tuesday,Fall,2,Morning Rush,172,7,165
2012-09-04,7,Tuesday,Fall,2,Morning Rush,493,13,480
2012-09-04,8,Tuesday,Fall,1,Morning Rush,632,15,617
2012-09-04,9,Tuesday,Fall,2,Morning Rush,323,30,293
2012-09-04,10,Tuesday,Fall,2,Mid-Day,172,42,130
2012-09-04,11,Tuesday,Fall,2,Mid-Day,198,39,159
2012-09-04,12,Tuesday,Fall,1,Mid-Day,287,54,233
2012-09-04,13,Tuesday,Fall,1,Mid-Day,275,72,203
2012-09-04,14,Tuesday,Fall,1,Mid-Day,274,72,202
2012-09-04,15,Tuesday,Fall,1,Mid-Day,292,68,224
2012-09-04,16,Tuesday,Fall,1,Evening Rush,458,61,397
2012-09-04,17,Tuesday,Fall,1,Evening Rush,856,110,746
2012-09-04,18,Tuesday,Fall,1,Evening Rush,839,94,745
2012-09-04,19,Tuesday,Fall,1,Evening Rush,552,50,502
2012-09-04,20,Tuesday,Fall,1,Night,385,47,338
2012-09-04,21,Tuesday,Fall,1,Night,268,28,240
2012-09-04,22,Tuesday,Fall,1,Night,179,25,154
2012-09-04,23,Tuesday,Fall,1,Night,95,12,83
2012-09-05,0,Wednesday,Fall,1,Early Morning,37,10,27
2012-09-05,1,Wednesday,Fall,1,Early Morning,13,2,11
2012-09-05,2,Wednesday,Fall,1,Early Morning,9,0,9
2012-09-05,3,Wednesday,Fall,1,Early Morning,4,0,4
2012-09-05,4,Wednesday,Fall,1,Early Morning,5,2,3
2012-09-05,5,Wednesday,Fall,2,Early Morning,40,1,39
2012-09-05,6,Wednesday,Fall,1,Morning Rush,210,7,203
2012-09-05,7,Wednesday,Fall,2,Morning Rush,500,11,489
2012-09-05,8,Wednesday,Fall,1,Morning Rush,725,33,692
2012-09-05,9,Wednesday,Fall,1,Morning Rush,290,27,263
2012-09-05,10,Wednesday,Fall,2,Mid-Day,235,54,181
2012-09-05,11,Wednesday,Fall,2,Mid-Day,217,61,156
2012-09-05,12,Wednesday,Fall,1,Mid-Day,266,49,217
2012-09-05,13,Wednesday,Fall,1,Mid-Day,234,50,184
2012-09-05,14,Wednesday,Fall,1,Mid-Day,211,34,177
2012-09-05,15,Wednesday,Fall,1,Mid-Day,245,41,204
2012-09-05,16,Wednesday,Fall,1,Evening Rush,430,86,344
2012-09-05,17,Wednesday,Fall,1,Evening Rush,863,83,780
2012-09-05,18,Wednesday,Fall,1,Evening Rush,839,82,757
2012-09-05,19,Wednesday,Fall,1,Evening Rush,662,64,598
2012-09-05,20,Wednesday,Fall,1,Night,412,55,357
2012-09-05,21,Wednesday,Fall,1,Night,296,18,278
2012-09-05,22,Wednesday,Fall,1,Night,219,38,181
2012-09-05,23,Wednesday,Fall,1,Night,150,24,126
2012-09-06,0,Thursday,Fall,2,Early Morning,65,30,35
2012-09-06,1,Thursday,Fall,2,Early Morning,18,2,16
2012-09-06,2,Thursday,Fall,1,Early Morning,8,1,7
2012-09-06,3,Thursday,Fall,1,Early Morning,9,0,9
2012-09-06,4,Thursday,Fall,2,Early Morning,8,0,8
2012-09-06,5,Thursday,Fall,2,Early Morning,38,3,35
2012-09-06,6,Thursday,Fall,2,Morning Rush,200,11,189
2012-09-06,7,Thursday,Fall,2,Morning Rush,482,21,461
2012-09-06,8,Thursday,Fall,3,Morning Rush,646,24,622
2012-09-06,9,Thursday,Fall,3,Morning Rush,123,8,115
2012-09-06,10,Thursday,Fall,3,Mid-Day,49,9,40
2012-09-06,11,Thursday,Fall,3,Mid-Day,62,10,52
2012-09-06,12,Thursday,Fall,2,Mid-Day,137,11,126
2012-09-06,13,Thursday,Fall,2,Mid-Day,191,39,152
2012-09-06,14,Thursday,Fall,1,Mid-Day,216,38,178
2012-09-06,15,Thursday,Fall,1,Mid-Day,270,42,228
2012-09-06,16,Thursday,Fall,1,Evening Rush,416,42,374
2012-09-06,17,Thursday,Fall,1,Evening Rush,808,67,741
2012-09-06,18,Thursday,Fall,1,Evening Rush,835,74,761
2012-09-06,19,Thursday,Fall,1,Evening Rush,558,54,504
2012-09-06,20,Thursday,Fall,1,Night,406,50,356
2012-09-06,21,Thursday,Fall,1,Night,272,32,240
2012-09-06,22,Thursday,Fall,1,Night,217,24,193
2012-09-06,23,Thursday,Fall,1,Night,169,19,150
2012-09-07,0,Friday,Fall,1,Early Morning,96,17,79
2012-09-07,1,Friday,Fall,1,Early Morning,29,10,19
2012-09-07,2,Friday,Fall,1,Early Morning,11,1,10
2012-09-07,3,Friday,Fall,1,Early Morning,9,0,9
2012-09-07,4,Friday,Fall,1,Early Morning,8,1,7
2012-09-07,5,Friday,Fall,1,Early Morning,40,1,39
2012-09-07,6,Friday,Fall,1,Morning Rush,140,5,135
2012-09-07,7,Friday,Fall,1,Morning Rush,486,21,465
2012-09-07,8,Friday,Fall,1,Morning Rush,719,29,690
2012-09-07,9,Friday,Fall,1,Morning Rush,344,33,311
2012-09-07,10,Friday,Fall,1,Mid-Day,224,53,171
2012-09-07,11,Friday,Fall,1,Mid-Day,296,81,215
2012-09-07,12,Friday,Fall,1,Mid-Day,323,76,247
2012-09-07,13,Friday,Fall,1,Mid-Day,354,71,283
2012-09-07,14,Friday,Fall,1,Mid-Day,253,66,187
2012-09-07,15,Friday,Fall,1,Mid-Day,331,66,265
2012-09-07,16,Friday,Fall,1,Evening Rush,470,75,395
2012-09-07,17,Friday,Fall,1,Evening Rush,772,88,684
2012-09-07,18,Friday,Fall,1,Evening Rush,792,95,697
2012-09-07,19,Friday,Fall,1,Evening Rush,568,70,498
2012-09-07,20,Friday,Fall,1,Night,391,51,340
2012-09-07,21,Friday,Fall,1,Night,301,55,246
2012-09-07,22,Friday,Fall,1,Night,299,52,247
2012-09-07,23,Friday,Fall,1,Night,248,28,220
2012-09-08,0,Saturday,Fall,1,Early Morning,150,20,130
2012-09-08,1,Saturday,Fall,2,Early Morning,117,10,107
2012-09-08,2,Saturday,Fall,1,Early Morning,77,9,68
2012-09-08,3,Saturday,Fall,2,Early Morning,43,3,40
2012-09-08,4,Saturday,Fall,2,Early Morning,11,3,8
2012-09-08,5,Saturday,Fall,2,Early Morning,15,2,13
2012-09-08,6,Saturday,Fall,2,Morning Rush,34,8,26
2012-09-08,7,Saturday,Fall,1,Morning Rush,82,11,71
2012-09-08,8,Saturday,Fall,1,Morning Rush,230,33,197
2012-09-08,9,Saturday,Fall,1,Morning Rush,348,87,261
2012-09-08,10,Saturday,Fall,1,Mid-Day,422,100,322
2012-09-08,11,Saturday,Fall,1,Mid-Day,578,173,405
2012-09-08,12,Saturday,Fall,1,Mid-Day,694,220,474
2012-09-08,13,Saturday,Fall,1,Mid-Day,668,233,435
2012-09-08,14,Saturday,Fall,1,Mid-Day,626,260,366
2012-09-08,15,Saturday,Fall,3,Mid-Day,512,175,337
2012-09-08,16,Saturday,Fall,3,Evening Rush,114,19,95
2012-09-08,17,Saturday,Fall,3,Evening Rush,171,52,119
2012-09-08,18,Saturday,Fall,3,Evening Rush,167,27,140
2012-09-08,19,Saturday,Fall,3,Evening Rush,215,28,187
2012-09-08,20,Saturday,Fall,2,Night,194,28,166
2012-09-08,21,Saturday,Fall,2,Night,181,26,155
2012-09-08,22,Saturday,Fall,2,Night,194,18,176
2012-09-08,23,Saturday,Fall,2,Night,133,12,121
2012-09-09,0,Sunday,Fall,2,Early Morning,124,18,106
2012-09-09,1,Sunday,Fall,1,Early Morning,124,20,104
2012-09-09,2,Sunday,Fall,1,Early Morning,96,15,81
2012-09-09,3,Sunday,Fall,1,Early Morning,46,14,32
2012-09-09,4,Sunday,Fall,1,Early Morning,28,12,16
2012-09-09,5,Sunday,Fall,1,Early Morning,55,16,39
2012-09-09,6,Sunday,Fall,1,Morning Rush,35,11,24
2012-09-09,7,Sunday,Fall,1,Morning Rush,70,20,50
2012-09-09,8,Sunday,Fall,1,Morning Rush,170,27,143
2012-09-09,9,Sunday,Fall,1,Morning Rush,299,85,214
2012-09-09,10,Sunday,Fall,1,Mid-Day,495,172,323
2012-09-09,11,Sunday,Fall,1,Mid-Day,585,194,391
2012-09-09,12,Sunday,Fall,1,Mid-Day,757,247,510
2012-09-09,13,Sunday,Fall,1,Mid-Day,729,238,491
2012-09-09,14,Sunday,Fall,1,Mid-Day,647,232,415
2012-09-09,15,Sunday,Fall,1,Mid-Day,696,284,412
2012-09-09,16,Sunday,Fall,1,Evening Rush,701,228,473
2012-09-09,17,Sunday,Fall,1,Evening Rush,671,213,458
2012-09-09,18,Sunday,Fall,1,Evening Rush,560,156,404
2012-09-09,19,Sunday,Fall,1,Evening Rush,496,134,362
2012-09-09,20,Sunday,Fall,1,Night,356,91,265
2012-09-09,21,Sunday,Fall,1,Night,206,57,149
2012-09-09,22,Sunday,Fall,1,Night,189,64,125
2012-09-09,23,Sunday,Fall,1,Night,92,22,70
2012-09-10,0,Monday,Fall,1,Early Morning,41,6,35
2012-09-10,1,Monday,Fall,1,Early Morning,18,7,11
2012-09-10,2,Monday,Fall,1,Early Morning,17,11,6
2012-09-10,3,Monday,Fall,1,Early Morning,12,5,7
2012-09-10,4,Monday,Fall,1,Early Morning,5,1,4
2012-09-10,5,Monday,Fall,1,Early Morning,40,4,36
2012-09-10,6,Monday,Fall,1,Morning Rush,180,8,172
2012-09-10,7,Monday,Fall,1,Morning Rush,447,20,427
2012-09-10,8,Monday,Fall,1,Morning Rush,730,33,697
2012-09-10,9,Monday,Fall,1,Morning Rush,361,40,321
2012-09-10,10,Monday,Fall,1,Mid-Day,210,42,168
2012-09-10,11,Monday,Fall,1,Mid-Day,236,69,167
2012-09-10,12,Monday,Fall,1,Mid-Day,332,76,256
2012-09-10,13,Monday,Fall,1,Mid-Day,323,72,251
2012-09-10,14,Monday,Fall,1,Mid-Day,340,107,233
2012-09-10,15,Monday,Fall,1,Mid-Day,346,115,231
2012-09-10,16,Monday,Fall,1,Evening Rush,488,108,380
2012-09-10,17,Monday,Fall,1,Evening Rush,871,127,744
2012-09-10,18,Monday,Fall,1,Evening Rush,968,111,857
2012-09-10,19,Monday,Fall,1,Evening Rush,633,71,562
2012-09-10,20,Monday,Fall,1,Night,390,34,356
2012-09-10,21,Monday,Fall,1,Night,285,29,256
2012-09-10,22,Monday,Fall,1,Night,159,15,144
2012-09-10,23,Monday,Fall,1,Night,93,7,86
2012-09-11,0,Tuesday,Fall,1,Early Morning,32,5,27
2012-09-11,1,Tuesday,Fall,1,Early Morning,10,0,10
2012-09-11,2,Tuesday,Fall,1,Early Morning,6,1,5
2012-09-11,3,Tuesday,Fall,1,Early Morning,8,1,7
2012-09-11,4,Tuesday,Fall,1,Early Morning,9,1,8
2012-09-11,5,Tuesday,Fall,1,Early Morning,44,3,41
2012-09-11,6,Tuesday,Fall,1,Morning Rush,211,11,200
2012-09-11,7,Tuesday,Fall,1,Morning Rush,596,24,572
2012-09-11,8,Tuesday,Fall,1,Morning Rush,750,48,702
2012-09-11,9,Tuesday,Fall,1,Morning Rush,358,35,323
2012-09-11,10,Tuesday,Fall,1,Mid-Day,196,54,142
2012-09-11,11,Tuesday,Fall,1,Mid-Day,247,60,187
2012-09-11,12,Tuesday,Fall,1,Mid-Day,316,62,254
2012-09-11,13,Tuesday,Fall,1,Mid-Day,328,72,256
2012-09-11,14,Tuesday,Fall,1,Mid-Day,255,74,181
2012-09-11,15,Tuesday,Fall,1,Mid-Day,326,73,253
2012-09-11,16,Tuesday,Fall,1,Evening Rush,536,99,437
2012-09-11,17,Tuesday,Fall,1,Evening Rush,970,168,802
2012-09-11,18,Tuesday,Fall,1,Evening Rush,877,110,767
2012-09-11,19,Tuesday,Fall,1,Evening Rush,596,56,540
2012-09-11,20,Tuesday,Fall,1,Night,461,40,421
2012-09-11,21,Tuesday,Fall,1,Night,310,28,282
2012-09-11,22,Tuesday,Fall,1,Night,216,27,189
2012-09-11,23,Tuesday,Fall,1,Night,109,18,91
2012-09-12,0,Wednesday,Fall,1,Early Morning,49,8,41
2012-09-12,1,Wednesday,Fall,1,Early Morning,21,2,19
2012-09-12,2,Wednesday,Fall,1,Early Morning,11,2,9
2012-09-12,3,Wednesday,Fall,1,Early Morning,7,0,7
2012-09-12,4,Wednesday,Fall,1,Early Morning,5,0,5
2012-09-12,5,Wednesday,Fall,1,Early Morning,48,4,44
2012-09-12,6,Wednesday,Fall,1,Morning Rush,205,6,199
2012-09-12,7,Wednesday,Fall,1,Morning Rush,557,24,533
2012-09-12,8,Wednesday,Fall,1,Morning Rush,770,43,727
2012-09-12,9,Wednesday,Fall,1,Morning Rush,328,50,278
2012-09-12,10,Wednesday,Fall,1,Mid-Day,205,57,148
2012-09-12,11,Wednesday,Fall,1,Mid-Day,232,51,181
2012-09-12,12,Wednesday,Fall,1,Mid-Day,352,88,264
2012-09-12,13,Wednesday,Fall,1,Mid-Day,323,85,238
2012-09-12,14,Wednesday,Fall,1,Mid-Day,278,78,200
2012-09-12,15,Wednesday,Fall,1,Mid-Day,318,75,243
2012-09-12,16,Wednesday,Fall,1,Evening Rush,509,90,419
2012-09-12,17,Wednesday,Fall,1,Evening Rush,925,114,811
2012-09-12,18,Wednesday,Fall,1,Evening Rush,977,91,886
2012-09-12,19,Wednesday,Fall,1,Evening Rush,635,78,557
2012-09-12,20,Wednesday,Fall,1,Night,470,38,432
2012-09-12,21,Wednesday,Fall,1,Night,306,27,279
2012-09-12,22,Wednesday,Fall,1,Night,212,23,189
2012-09-12,23,Wednesday,Fall,1,Night,127,16,111
2012-09-13,0,Thursday,Fall,1,Early Morning,57,11,46
2012-09-13,1,Thursday,Fall,1,Early Morning,28,6,22
2012-09-13,2,Thursday,Fall,1,Early Morning,9,0,9
2012-09-13,3,Thursday,Fall,1,Early Morning,11,2,9
2012-09-13,4,Thursday,Fall,1,Early Morning,6,0,6
2012-09-13,5,Thursday,Fall,1,Early Morning,57,3,54
2012-09-13,6,Thursday,Fall,1,Morning Rush,195,9,186
2012-09-13,7,Thursday,Fall,1,Morning Rush,571,22,549
2012-09-13,8,Thursday,Fall,1,Morning Rush,758,33,725
2012-09-13,9,Thursday,Fall,1,Morning Rush,338,46,292
2012-09-13,10,Thursday,Fall,1,Mid-Day,212,63,149
2012-09-13,11,Thursday,Fall,1,Mid-Day,254,71,183
2012-09-13,12,Thursday,Fall,1,Mid-Day,297,57,240
2012-09-13,13,Thursday,Fall,1,Mid-Day,283,60,223
2012-09-13,14,Thursday,Fall,1,Mid-Day,274,60,214
2012-09-13,15,Thursday,Fall,1,Mid-Day,352,99,253
2012-09-13,16,Thursday,Fall,1,Evening Rush,491,85,406
2012-09-13,17,Thursday,Fall,1,Evening Rush,884,97,787
2012-09-13,18,Thursday,Fall,1,Evening Rush,852,108,744
2012-09-13,19,Thursday,Fall,1,Evening Rush,674,80,594
2012-09-13,20,Thursday,Fall,1,Night,463,55,408
2012-09-13,21,Thursday,Fall,1,Night,317,26,291
2012-09-13,22,Thursday,Fall,1,Night,251,28,223
2012-09-13,23,Thursday,Fall,1,Night,170,33,137
2012-09-14,0,Friday,Fall,1,Early Morning,87,24,63
2012-09-14,1,Friday,Fall,1,Early Morning,41,6,35
2012-09-14,2,Friday,Fall,1,Early Morning,30,7,23
2012-09-14,3,Friday,Fall,1,Early Morning,14,5,9
2012-09-14,4,Friday,Fall,1,Early Morning,12,1,11
2012-09-14,5,Friday,Fall,1,Early Morning,41,1,40
2012-09-14,6,Friday,Fall,1,Morning Rush,152,8,144
2012-09-14,7,Friday,Fall,2,Morning Rush,454,17,437
2012-09-14,8,Friday,Fall,2,Morning Rush,766,51,715
2012-09-14,9,Friday,Fall,2,Morning Rush,347,46,301
2012-09-14,10,Friday,Fall,2,Mid-Day,246,75,171
2012-09-14,11,Friday,Fall,2,Mid-Day,280,84,196
2012-09-14,12,Friday,Fall,2,Mid-Day,409,119,290
2012-09-14,13,Friday,Fall,2,Mid-Day,408,107,301
2012-09-14,14,Friday,Fall,2,Mid-Day,371,113,258
2012-09-14,15,Friday,Fall,2,Mid-Day,367,94,273
2012-09-14,16,Friday,Fall,2,Evening Rush,563,109,454
2012-09-14,17,Friday,Fall,1,Evening Rush,894,137,757
2012-09-14,18,Friday,Fall,1,Evening Rush,808,116,692
2012-09-14,19,Friday,Fall,1,Evening Rush,579,83,496
2012-09-14,20,Friday,Fall,1,Night,404,67,337
2012-09-14,21,Friday,Fall,1,Night,312,42,270
2012-09-14,22,Friday,Fall,1,Night,229,40,189
2012-09-14,23,Friday,Fall,1,Night,195,27,168
2012-09-15,0,Saturday,Fall,1,Early Morning,207,38,169
2012-09-15,1,Saturday,Fall,1,Early Morning,109,8,101
2012-09-15,2,Saturday,Fall,1,Early Morning,93,18,75
2012-09-15,3,Saturday,Fall,1,Early Morning,37,6,31
2012-09-15,4,Saturday,Fall,2,Early Morning,6,3,3
2012-09-15,5,Saturday,Fall,1,Early Morning,16,1,15
2012-09-15,6,Saturday,Fall,1,Morning Rush,33,6,27
2012-09-15,7,Saturday,Fall,1,Morning Rush,73,10,63
2012-09-15,8,Saturday,Fall,1,Morning Rush,212,43,169
2012-09-15,9,Saturday,Fall,1,Morning Rush,342,79,263
2012-09-15,10,Saturday,Fall,1,Mid-Day,442,119,323
2012-09-15,11,Saturday,Fall,1,Mid-Day,627,228,399
2012-09-15,12,Saturday,Fall,1,Mid-Day,706,287,419
2012-09-15,13,Saturday,Fall,1,Mid-Day,704,327,377
2012-09-15,14,Saturday,Fall,1,Mid-Day,715,325,390
2012-09-15,15,Saturday,Fall,2,Mid-Day,654,312,342
2012-09-15,16,Saturday,Fall,2,Evening Rush,783,350,433
2012-09-15,17,Saturday,Fall,2,Evening Rush,729,295,434
2012-09-15,18,Saturday,Fall,2,Evening Rush,614,232,382
2012-09-15,19,Saturday,Fall,1,Evening Rush,478,169,309
2012-09-15,20,Saturday,Fall,1,Night,330,89,241
2012-09-15,21,Saturday,Fall,1,Night,296,86,210
2012-09-15,22,Saturday,Fall,1,Night,279,82,197
2012-09-15,23,Saturday,Fall,1,Night,229,47,182
2012-09-16,0,Sunday,Fall,1,Early Morning,151,28,123
2012-09-16,1,Sunday,Fall,1,Early Morning,117,35,82
2012-09-16,2,Sunday,Fall,1,Early Morning,89,27,62
2012-09-16,3,Sunday,Fall,1,Early Morning,48,10,38
2012-09-16,4,Sunday,Fall,1,Early Morning,8,2,6
2012-09-16,5,Sunday,Fall,1,Early Morning,13,3,10
2012-09-16,6,Sunday,Fall,1,Morning Rush,35,9,26
2012-09-16,7,Sunday,Fall,1,Morning Rush,71,28,43
2012-09-16,8,Sunday,Fall,1,Morning Rush,128,34,94
2012-09-16,9,Sunday,Fall,1,Morning Rush,296,70,226
2012-09-16,10,Sunday,Fall,1,Mid-Day,490,160,330
2012-09-16,11,Sunday,Fall,1,Mid-Day,559,183,376
2012-09-16,12,Sunday,Fall,1,Mid-Day,656,188,468
2012-09-16,13,Sunday,Fall,1,Mid-Day,694,240,454
2012-09-16,14,Sunday,Fall,1,Mid-Day,635,225,410
2012-09-16,15,Sunday,Fall,1,Mid-Day,557,215,342
2012-09-16,16,Sunday,Fall,1,Evening Rush,596,194,402
2012-09-16,17,Sunday,Fall,1,Evening Rush,570,177,393
2012-09-16,18,Sunday,Fall,1,Evening Rush,481,120,361
2012-09-16,19,Sunday,Fall,1,Evening Rush,403,91,312
2012-09-16,20,Sunday,Fall,1,Night,324,57,267
2012-09-16,21,Sunday,Fall,1,Night,191,43,148
2012-09-16,22,Sunday,Fall,1,Night,127,18,109
2012-09-16,23,Sunday,Fall,1,Night,94,9,85
2012-09-17,0,Monday,Fall,1,Early Morning,45,14,31
2012-09-17,1,Monday,Fall,1,Early Morning,21,9,12
2012-09-17,2,Monday,Fall,1,Early Morning,13,5,8
2012-09-17,3,Monday,Fall,1,Early Morning,7,0,7
2012-09-17,4,Monday,Fall,1,Early Morning,11,2,9
2012-09-17,5,Monday,Fall,1,Early Morning,45,1,44
2012-09-17,6,Monday,Fall,1,Morning Rush,164,7,157
2012-09-17,7,Monday,Fall,1,Morning Rush,492,18,474
2012-09-17,8,Monday,Fall,1,Morning Rush,683,36,647
2012-09-17,9,Monday,Fall,1,Morning Rush,299,34,265
2012-09-17,10,Monday,Fall,2,Mid-Day,202,73,129
2012-09-17,11,Monday,Fall,2,Mid-Day,252,61,191
2012-09-17,12,Monday,Fall,2,Mid-Day,295,62,233
2012-09-17,13,Monday,Fall,1,Mid-Day,343,112,231
2012-09-17,14,Monday,Fall,2,Mid-Day,332,129,203
2012-09-17,15,Monday,Fall,2,Mid-Day,338,82,256
2012-09-17,16,Monday,Fall,2,Evening Rush,453,74,379
2012-09-17,17,Monday,Fall,2,Evening Rush,842,102,740
2012-09-17,18,Monday,Fall,2,Evening Rush,774,66,708
2012-09-17,19,Monday,Fall,2,Evening Rush,486,51,435
2012-09-17,20,Monday,Fall,2,Night,340,32,308
2012-09-17,21,Monday,Fall,3,Night,233,28,205
2012-09-17,22,Monday,Fall,3,Night,129,20,109
2012-09-17,23,Monday,Fall,3,Night,70,4,66
2012-09-18,0,Tuesday,Fall,3,Early Morning,13,2,11
2012-09-18,1,Tuesday,Fall,3,Early Morning,5,0,5
2012-09-18,2,Tuesday,Fall,3,Early Morning,4,0,4
2012-09-18,3,Tuesday,Fall,2,Early Morning,6,0,6
2012-09-18,4,Tuesday,Fall,2,Early Morning,7,2,5
2012-09-18,5,Tuesday,Fall,2,Early Morning,48,3,45
2012-09-18,6,Tuesday,Fall,2,Morning Rush,167,4,163
2012-09-18,7,Tuesday,Fall,2,Morning Rush,356,13,343
2012-09-18,8,Tuesday,Fall,2,Morning Rush,672,32,640
2012-09-18,9,Tuesday,Fall,2,Morning Rush,293,27,266
2012-09-18,10,Tuesday,Fall,3,Mid-Day,160,30,130
2012-09-18,11,Tuesday,Fall,2,Mid-Day,151,36,115
2012-09-18,12,Tuesday,Fall,3,Mid-Day,88,16,72
2012-09-18,13,Tuesday,Fall,2,Mid-Day,114,17,97
2012-09-18,14,Tuesday,Fall,3,Mid-Day,143,27,116
2012-09-18,15,Tuesday,Fall,3,Mid-Day,36,1,35
2012-09-18,16,Tuesday,Fall,3,Evening Rush,141,19,122
2012-09-18,17,Tuesday,Fall,3,Evening Rush,338,36,302
2012-09-18,18,Tuesday,Fall,2,Evening Rush,281,19,262
2012-09-18,19,Tuesday,Fall,2,Evening Rush,324,22,302
2012-09-18,20,Tuesday,Fall,2,Night,290,19,271
2012-09-18,21,Tuesday,Fall,2,Night,207,21,186
2012-09-18,22,Tuesday,Fall,3,Night,151,14,137
2012-09-18,23,Tuesday,Fall,2,Night,78,11,67
2012-09-19,0,Wednesday,Fall,2,Early Morning,26,3,23
2012-09-19,1,Wednesday,Fall,2,Early Morning,12,0,12
2012-09-19,2,Wednesday,Fall,2,Early Morning,3,0,3
2012-09-19,3,Wednesday,Fall,2,Early Morning,5,1,4
2012-09-19,4,Wednesday,Fall,2,Early Morning,10,0,10
2012-09-19,5,Wednesday,Fall,2,Early Morning,56,2,54
2012-09-19,6,Wednesday,Fall,1,Morning Rush,172,6,166
2012-09-19,7,Wednesday,Fall,1,Morning Rush,545,16,529
2012-09-19,8,Wednesday,Fall,1,Morning Rush,797,39,758
2012-09-19,9,Wednesday,Fall,1,Morning Rush,362,26,336
2012-09-19,10,Wednesday,Fall,1,Mid-Day,192,23,169
2012-09-19,11,Wednesday,Fall,1,Mid-Day,247,44,203
2012-09-19,12,Wednesday,Fall,1,Mid-Day,313,53,260
2012-09-19,13,Wednesday,Fall,1,Mid-Day,289,55,234
2012-09-19,14,Wednesday,Fall,1,Mid-Day,286,59,227
2012-09-19,15,Wednesday,Fall,1,Mid-Day,311,57,254
2012-09-19,16,Wednesday,Fall,1,Evening Rush,466,69,397
2012-09-19,17,Wednesday,Fall,1,Evening Rush,886,74,812
2012-09-19,18,Wednesday,Fall,1,Evening Rush,892,85,807
2012-09-19,19,Wednesday,Fall,1,Evening Rush,611,72,539
2012-09-19,20,Wednesday,Fall,1,Night,409,31,378
2012-09-19,21,Wednesday,Fall,1,Night,349,25,324
2012-09-19,22,Wednesday,Fall,1,Night,229,31,198
2012-09-19,23,Wednesday,Fall,1,Night,123,17,106
2012-09-20,0,Thursday,Fall,1,Early Morning,58,12,46
2012-09-20,1,Thursday,Fall,1,Early Morning,18,4,14
2012-09-20,2,Thursday,Fall,1,Early Morning,11,2,9
2012-09-20,3,Thursday,Fall,1,Early Morning,6,0,6
2012-09-20,4,Thursday,Fall,1,Early Morning,6,0,6
2012-09-20,5,Thursday,Fall,1,Early Morning,56,4,52
2012-09-20,6,Thursday,Fall,1,Morning Rush,170,9,161
2012-09-20,7,Thursday,Fall,1,Morning Rush,534,20,514
2012-09-20,8,Thursday,Fall,1,Morning Rush,790,44,746
2012-09-20,9,Thursday,Fall,1,Morning Rush,355,25,330
2012-09-20,10,Thursday,Fall,1,Mid-Day,190,33,157
2012-09-20,11,Thursday,Fall,1,Mid-Day,243,37,206
2012-09-20,12,Thursday,Fall,1,Mid-Day,290,57,233
2012-09-20,13,Thursday,Fall,1,Mid-Day,336,68,268
2012-09-20,14,Thursday,Fall,1,Mid-Day,298,76,222
2012-09-20,15,Thursday,Fall,1,Mid-Day,291,60,231
2012-09-20,16,Thursday,Fall,1,Evening Rush,457,72,385
2012-09-20,17,Thursday,Fall,1,Evening Rush,976,91,885
2012-09-20,18,Thursday,Fall,1,Evening Rush,900,119,781
2012-09-20,19,Thursday,Fall,1,Evening Rush,603,69,534
2012-09-20,20,Thursday,Fall,1,Night,417,57,360
2012-09-20,21,Thursday,Fall,1,Night,274,28,246
2012-09-20,22,Thursday,Fall,1,Night,287,35,252
2012-09-20,23,Thursday,Fall,1,Night,154,17,137
2012-09-21,0,Friday,Fall,1,Early Morning,66,13,53
2012-09-21,1,Friday,Fall,1,Early Morning,49,11,38
2012-09-21,2,Friday,Fall,1,Early Morning,14,6,8
2012-09-21,3,Friday,Fall,1,Early Morning,12,1,11
2012-09-21,4,Friday,Fall,1,Early Morning,10,1,9
2012-09-21,5,Friday,Fall,1,Early Morning,49,2,47
2012-09-21,6,Friday,Fall,1,Morning Rush,165,19,146
2012-09-21,7,Friday,Fall,1,Morning Rush,503,35,468
2012-09-21,8,Friday,Fall,1,Morning Rush,757,31,726
2012-09-21,9,Friday,Fall,1,Morning Rush,383,35,348
2012-09-21,10,Friday,Fall,1,Mid-Day,225,44,181
2012-09-21,11,Friday,Fall,1,Mid-Day,321,79,242
2012-09-21,12,Friday,Fall,1,Mid-Day,389,84,305
2012-09-21,13,Friday,Fall,1,Mid-Day,421,105,316
2012-09-21,14,Friday,Fall,1,Mid-Day,412,113,299
2012-09-21,15,Friday,Fall,1,Mid-Day,423,90,333
2012-09-21,16,Friday,Fall,1,Evening Rush,567,103,464
2012-09-21,17,Friday,Fall,1,Evening Rush,846,107,739
2012-09-21,18,Friday,Fall,1,Evening Rush,805,106,699
2012-09-21,19,Friday,Fall,1,Evening Rush,588,95,493
2012-09-21,20,Friday,Fall,1,Night,369,54,315
2012-09-21,21,Friday,Fall,1,Night,312,46,266
2012-09-21,22,Friday,Fall,1,Night,295,47,248
2012-09-21,23,Friday,Fall,1,Night,186,23,163
2012-09-22,0,Saturday,Fall,1,Early Morning,172,32,140
2012-09-22,1,Saturday,Fall,1,Early Morning,124,18,106
2012-09-22,2,Saturday,Fall,1,Early Morning,83,10,73
2012-09-22,3,Saturday,Fall,1,Early Morning,45,6,39
2012-09-22,4,Saturday,Fall,1,Early Morning,15,5,10
2012-09-22,5,Saturday,Fall,1,Early Morning,17,2,15
2012-09-22,6,Saturday,Fall,1,Morning Rush,41,6,35
2012-09-22,7,Saturday,Fall,1,Morning Rush,77,7,70
2012-09-22,8,Saturday,Fall,1,Morning Rush,218,21,197
2012-09-22,9,Saturday,Fall,1,Morning Rush,377,88,289
2012-09-22,10,Saturday,Fall,1,Mid-Day,474,124,350
2012-09-22,11,Saturday,Fall,1,Mid-Day,626,189,437
2012-09-22,12,Saturday,Fall,1,Mid-Day,688,228,460
2012-09-22,13,Saturday,Fall,1,Mid-Day,707,273,434
2012-09-22,14,Saturday,Fall,1,Mid-Day,654,250,404
2012-09-22,15,Saturday,Fall,1,Mid-Day,750,307,443
2012-09-22,16,Saturday,Fall,1,Evening Rush,680,253,427
2012-09-22,17,Saturday,Fall,1,Evening Rush,646,195,451
2012-09-22,18,Saturday,Fall,1,Evening Rush,598,171,427
2012-09-22,19,Saturday,Fall,1,Evening Rush,407,99,308
2012-09-22,20,Saturday,Fall,1,Night,325,76,249
2012-09-22,21,Saturday,Fall,1,Night,261,59,202
2012-09-22,22,Saturday,Fall,1,Night,239,59,180
2012-09-22,23,Saturday,Fall,1,Night,171,34,137
2012-09-23,0,Sunday,Winter,1,Early Morning,180,34,146
2012-09-23,1,Sunday,Winter,1,Early Morning,142,23,119
2012-09-23,2,Sunday,Winter,1,Early Morning,95,18,77
2012-09-23,3,Sunday,Winter,1,Early Morning,54,13,41
2012-09-23,4,Sunday,Winter,1,Early Morning,10,1,9
2012-09-23,5,Sunday,Winter,1,Early Morning,6,1,5
2012-09-23,6,Sunday,Winter,1,Morning Rush,16,5,11
2012-09-23,7,Sunday,Winter,1,Morning Rush,57,9,48
2012-09-23,8,Sunday,Winter,1,Morning Rush,175,38,137
2012-09-23,9,Sunday,Winter,1,Morning Rush,276,71,205
2012-09-23,10,Sunday,Winter,1,Mid-Day,489,138,351
2012-09-23,11,Sunday,Winter,1,Mid-Day,570,186,384
2012-09-23,12,Sunday,Winter,1,Mid-Day,776,250,526
2012-09-23,13,Sunday,Winter,1,Mid-Day,702,257,445
2012-09-23,14,Sunday,Winter,1,Mid-Day,666,266,400
2012-09-23,15,Sunday,Winter,1,Mid-Day,640,265,375
2012-09-23,16,Sunday,Winter,1,Evening Rush,691,254,437
2012-09-23,17,Sunday,Winter,1,Evening Rush,723,227,496
2012-09-23,18,Sunday,Winter,1,Evening Rush,540,135,405
2012-09-23,19,Sunday,Winter,1,Evening Rush,413,82,331
2012-09-23,20,Sunday,Winter,1,Night,252,60,192
2012-09-23,21,Sunday,Winter,2,Night,196,51,145
2012-09-23,22,Sunday,Winter,1,Night,138,40,98
2012-09-23,23,Sunday,Winter,2,Night,100,30,70
2012-09-24,0,Monday,Winter,1,Early Morning,64,10,54
2012-09-24,1,Monday,Winter,1,Early Morning,18,6,12
2012-09-24,2,Monday,Winter,2,Early Morning,8,0,8
2012-09-24,3,Monday,Winter,1,Early Morning,5,0,5
2012-09-24,4,Monday,Winter,1,Early Morning,8,0,8
2012-09-24,5,Monday,Winter,1,Early Morning,37,2,35
2012-09-24,6,Monday,Winter,1,Morning Rush,168,6,162
2012-09-24,7,Monday,Winter,1,Morning Rush,530,17,513
2012-09-24,8,Monday,Winter,1,Morning Rush,750,31,719
2012-09-24,9,Monday,Winter,1,Morning Rush,328,42,286
2012-09-24,10,Monday,Winter,1,Mid-Day,198,52,146
2012-09-24,11,Monday,Winter,1,Mid-Day,238,71,167
2012-09-24,12,Monday,Winter,1,Mid-Day,342,77,265
2012-09-24,13,Monday,Winter,1,Mid-Day,328,80,248
2012-09-24,14,Monday,Winter,1,Mid-Day,303,77,226
2012-09-24,15,Monday,Winter,1,Mid-Day,300,84,216
2012-09-24,16,Monday,Winter,1,Evening Rush,516,99,417
2012-09-24,17,Monday,Winter,1,Evening Rush,898,89,809
2012-09-24,18,Monday,Winter,1,Evening Rush,853,95,758
2012-09-24,19,Monday,Winter,1,Evening Rush,590,56,534
2012-09-24,20,Monday,Winter,1,Night,432,52,380
2012-09-24,21,Monday,Winter,1,Night,256,26,230
2012-09-24,22,Monday,Winter,1,Night,172,18,154
2012-09-24,23,Monday,Winter,1,Night,94,11,83
2012-09-25,0,Tuesday,Winter,1,Early Morning,64,8,56
2012-09-25,1,Tuesday,Winter,1,Early Morning,13,2,11
2012-09-25,2,Tuesday,Winter,1,Early Morning,14,5,9
2012-09-25,3,Tuesday,Winter,1,Early Morning,5,2,3
2012-09-25,4,Tuesday,Winter,1,Early Morning,9,2,7
2012-09-25,5,Tuesday,Winter,1,Early Morning,47,1,46
2012-09-25,6,Tuesday,Winter,1,Morning Rush,194,5,189
2012-09-25,7,Tuesday,Winter,1,Morning Rush,556,17,539
2012-09-25,8,Tuesday,Winter,1,Morning Rush,805,41,764
2012-09-25,9,Tuesday,Winter,1,Morning Rush,409,28,381
2012-09-25,10,Tuesday,Winter,1,Mid-Day,170,45,125
2012-09-25,11,Tuesday,Winter,1,Mid-Day,218,63,155
2012-09-25,12,Tuesday,Winter,1,Mid-Day,302,69,233
2012-09-25,13,Tuesday,Winter,1,Mid-Day,305,48,257
2012-09-25,14,Tuesday,Winter,1,Mid-Day,293,80,213
2012-09-25,15,Tuesday,Winter,1,Mid-Day,303,56,247
2012-09-25,16,Tuesday,Winter,1,Evening Rush,495,59,436
2012-09-25,17,Tuesday,Winter,1,Evening Rush,967,107,860
2012-09-25,18,Tuesday,Winter,1,Evening Rush,822,64,758
2012-09-25,19,Tuesday,Winter,1,Evening Rush,539,49,490
2012-09-25,20,Tuesday,Winter,1,Night,425,37,388
2012-09-25,21,Tuesday,Winter,1,Night,297,34,263
2012-09-25,22,Tuesday,Winter,1,Night,188,14,174
2012-09-25,23,Tuesday,Winter,1,Night,98,9,89
2012-09-26,0,Wednesday,Winter,1,Early Morning,40,6,34
2012-09-26,1,Wednesday,Winter,1,Early Morning,29,10,19
2012-09-26,2,Wednesday,Winter,2,Early Morning,17,2,15
2012-09-26,3,Wednesday,Winter,2,Early Morning,10,4,6
2012-09-26,4,Wednesday,Winter,1,Early Morning,14,2,12
2012-09-26,5,Wednesday,Winter,1,Early Morning,36,1,35
2012-09-26,6,Wednesday,Winter,1,Morning Rush,182,3,179
2012-09-26,7,Wednesday,Winter,1,Morning Rush,532,9,523
2012-09-26,8,Wednesday,Winter,1,Morning Rush,838,30,808
2012-09-26,9,Wednesday,Winter,1,Morning Rush,334,27,307
2012-09-26,10,Wednesday,Winter,1,Mid-Day,185,29,156
2012-09-26,11,Wednesday,Winter,1,Mid-Day,227,46,181
2012-09-26,12,Wednesday,Winter,1,Mid-Day,316,56,260
2012-09-26,13,Wednesday,Winter,1,Mid-Day,340,67,273
2012-09-26,14,Wednesday,Winter,1,Mid-Day,277,60,217
2012-09-26,15,Wednesday,Winter,1,Mid-Day,300,69,231
2012-09-26,16,Wednesday,Winter,1,Evening Rush,468,71,397
2012-09-26,17,Wednesday,Winter,1,Evening Rush,953,77,876
2012-09-26,18,Wednesday,Winter,1,Evening Rush,884,69,815
2012-09-26,19,Wednesday,Winter,1,Evening Rush,627,38,589
2012-09-26,20,Wednesday,Winter,1,Night,434,45,389
2012-09-26,21,Wednesday,Winter,1,Night,360,32,328
2012-09-26,22,Wednesday,Winter,3,Night,215,21,194
2012-09-26,23,Wednesday,Winter,2,Night,115,13,102
2012-09-27,0,Thursday,Winter,1,Early Morning,65,5,60
2012-09-27,1,Thursday,Winter,1,Early Morning,21,5,16
2012-09-27,2,Thursday,Winter,1,Early Morning,16,3,13
2012-09-27,3,Thursday,Winter,1,Early Morning,7,0,7
2012-09-27,4,Thursday,Winter,1,Early Morning,8,2,6
2012-09-27,5,Thursday,Winter,1,Early Morning,66,2,64
2012-09-27,6,Thursday,Winter,1,Morning Rush,169,5,164
2012-09-27,7,Thursday,Winter,1,Morning Rush,558,12,546
2012-09-27,8,Thursday,Winter,1,Morning Rush,794,20,774
2012-09-27,9,Thursday,Winter,1,Morning Rush,335,30,305
2012-09-27,10,Thursday,Winter,2,Mid-Day,208,40,168
2012-09-27,11,Thursday,Winter,2,Mid-Day,294,67,227
2012-09-27,12,Thursday,Winter,2,Mid-Day,335,63,272
2012-09-27,13,Thursday,Winter,2,Mid-Day,326,61,265
2012-09-27,14,Thursday,Winter,2,Mid-Day,258,44,214
2012-09-27,15,Thursday,Winter,2,Mid-Day,296,41,255
2012-09-27,16,Thursday,Winter,2,Evening Rush,472,73,399
2012-09-27,17,Thursday,Winter,2,Evening Rush,905,87,818
2012-09-27,18,Thursday,Winter,2,Evening Rush,899,77,822
2012-09-27,19,Thursday,Winter,1,Evening Rush,559,48,511
2012-09-27,20,Thursday,Winter,2,Night,457,45,412
2012-09-27,21,Thursday,Winter,3,Night,253,18,235
2012-09-27,22,Thursday,Winter,3,Night,47,2,45
2012-09-27,23,Thursday,Winter,3,Night,45,1,44
2012-09-28,0,Friday,Winter,3,Early Morning,17,2,15
2012-09-28,1,Friday,Winter,3,Early Morning,13,0,13
2012-09-28,2,Friday,Winter,3,Early Morning,10,1,9
2012-09-28,3,Friday,Winter,2,Early Morning,7,0,7
2012-09-28,4,Friday,Winter,3,Early Morning,12,2,10
2012-09-28,5,Friday,Winter,1,Early Morning,38,1,37
2012-09-28,6,Friday,Winter,2,Morning Rush,138,2,136
2012-09-28,7,Friday,Winter,2,Morning Rush,394,10,384
2012-09-28,8,Friday,Winter,1,Morning Rush,705,31,674
2012-09-28,9,Friday,Winter,2,Morning Rush,426,27,399
2012-09-28,10,Friday,Winter,2,Mid-Day,245,51,194
2012-09-28,11,Friday,Winter,2,Mid-Day,361,109,252
2012-09-28,12,Friday,Winter,2,Mid-Day,380,94,286
2012-09-28,13,Friday,Winter,2,Mid-Day,410,106,304
2012-09-28,14,Friday,Winter,2,Mid-Day,399,105,294
2012-09-28,15,Friday,Winter,2,Mid-Day,392,104,288
2012-09-28,16,Friday,Winter,2,Evening Rush,502,83,419
2012-09-28,17,Friday,Winter,2,Evening Rush,808,101,707
2012-09-28,18,Friday,Winter,2,Evening Rush,667,58,609
2012-09-28,19,Friday,Winter,3,Evening Rush,508,38,470
2012-09-28,20,Friday,Winter,3,Night,336,32,304
2012-09-28,21,Friday,Winter,3,Night,237,32,205
2012-09-28,22,Friday,Winter,2,Night,220,30,190
2012-09-28,23,Friday,Winter,2,Night,190,26,164
2012-09-29,0,Saturday,Winter,1,Early Morning,149,15,134
2012-09-29,1,Saturday,Winter,1,Early Morning,101,12,89
2012-09-29,2,Saturday,Winter,2,Early Morning,92,12,80
2012-09-29,3,Saturday,Winter,2,Early Morning,29,4,25
2012-09-29,4,Saturday,Winter,1,Early Morning,14,6,8
2012-09-29,5,Saturday,Winter,1,Early Morning,15,2,13
2012-09-29,6,Saturday,Winter,1,Morning Rush,37,4,33
2012-09-29,7,Saturday,Winter,1,Morning Rush,73,12,61
2012-09-29,8,Saturday,Winter,1,Morning Rush,211,37,174
2012-09-29,9,Saturday,Winter,1,Morning Rush,332,69,263
2012-09-29,10,Saturday,Winter,1,Mid-Day,472,134,338
2012-09-29,11,Saturday,Winter,1,Mid-Day,663,217,446
2012-09-29,12,Saturday,Winter,1,Mid-Day,682,191,491
2012-09-29,13,Saturday,Winter,1,Mid-Day,686,233,453
2012-09-29,14,Saturday,Winter,1,Mid-Day,750,302,448
2012-09-29,15,Saturday,Winter,1,Mid-Day,727,271,456
2012-09-29,16,Saturday,Winter,1,Evening Rush,722,275,447
2012-09-29,17,Saturday,Winter,1,Evening Rush,712,256,456
2012-09-29,18,Saturday,Winter,1,Evening Rush,594,174,420
2012-09-29,19,Saturday,Winter,1,Evening Rush,470,119,351
2012-09-29,20,Saturday,Winter,1,Night,315,88,227
2012-09-29,21,Saturday,Winter,1,Night,292,73,219
2012-09-29,22,Saturday,Winter,1,Night,221,48,173
2012-09-29,23,Saturday,Winter,1,Night,196,35,161
2012-09-30,0,Sunday,Winter,1,Early Morning,147,35,112
2012-09-30,1,Sunday,Winter,1,Early Morning,116,31,85
2012-09-30,2,Sunday,Winter,1,Early Morning,92,21,71
2012-09-30,3,Sunday,Winter,1,Early Morning,58,17,41
2012-09-30,4,Sunday,Winter,1,Early Morning,7,1,6
2012-09-30,5,Sunday,Winter,1,Early Morning,10,1,9
2012-09-30,6,Sunday,Winter,1,Morning Rush,22,2,20
2012-09-30,7,Sunday,Winter,1,Morning Rush,57,14,43
2012-09-30,8,Sunday,Winter,1,Morning Rush,144,18,126
2012-09-30,9,Sunday,Winter,1,Morning Rush,285,74,211
2012-09-30,10,Sunday,Winter,1,Mid-Day,479,160,319
2012-09-30,11,Sunday,Winter,1,Mid-Day,591,222,369
2012-09-30,12,Sunday,Winter,1,Mid-Day,680,206,474
2012-09-30,13,Sunday,Winter,1,Mid-Day,594,180,414
2012-09-30,14,Sunday,Winter,1,Mid-Day,612,208,404
2012-09-30,15,Sunday,Winter,1,Mid-Day,649,230,419
2012-09-30,16,Sunday,Winter,1,Evening Rush,648,202,446
2012-09-30,17,Sunday,Winter,1,Evening Rush,575,195,380
2012-09-30,18,Sunday,Winter,1,Evening Rush,401,91,310
2012-09-30,19,Sunday,Winter,3,Evening Rush,257,34,223
2012-09-30,20,Sunday,Winter,3,Night,194,31,163
2012-09-30,21,Sunday,Winter,1,Night,123,19,104
2012-09-30,22,Sunday,Winter,1,Night,91,15,76
2012-09-30,23,Sunday,Winter,1,Night,57,8,49
2012-10-01,0,Monday,Winter,1,Early Morning,45,6,39
2012-10-01,1,Monday,Winter,1,Early Morning,18,5,13
2012-10-01,2,Monday,Winter,1,Early Morning,12,6,6
2012-10-01,3,Monday,Winter,1,Early Morning,7,1,6
2012-10-01,4,Monday,Winter,1,Early Morning,10,0,10
2012-10-01,5,Monday,Winter,1,Early Morning,36,2,34
2012-10-01,6,Monday,Winter,1,Morning Rush,155,8,147
2012-10-01,7,Monday,Winter,1,Morning Rush,483,13,470
2012-10-01,8,Monday,Winter,2,Morning Rush,784,40,744
2012-10-01,9,Monday,Winter,2,Morning Rush,340,26,314
2012-10-01,10,Monday,Winter,1,Mid-Day,179,44,135
2012-10-01,11,Monday,Winter,1,Mid-Day,272,76,196
2012-10-01,12,Monday,Winter,2,Mid-Day,323,61,262
2012-10-01,13,Monday,Winter,2,Mid-Day,305,80,225
2012-10-01,14,Monday,Winter,2,Mid-Day,244,51,193
2012-10-01,15,Monday,Winter,2,Mid-Day,329,95,234
2012-10-01,16,Monday,Winter,2,Evening Rush,459,51,408
2012-10-01,17,Monday,Winter,3,Evening Rush,856,65,791
2012-10-01,18,Monday,Winter,3,Evening Rush,613,42,571
2012-10-01,19,Monday,Winter,2,Evening Rush,516,33,483
2012-10-01,20,Monday,Winter,3,Night,262,11,251
2012-10-01,21,Monday,Winter,2,Night,218,13,205
2012-10-01,22,Monday,Winter,3,Night,207,17,190
2012-10-01,23,Monday,Winter,3,Night,105,17,88
2012-10-02,0,Tuesday,Winter,2,Early Morning,31,1,30
2012-10-02,1,Tuesday,Winter,2,Early Morning,11,0,11
2012-10-02,2,Tuesday,Winter,2,Early Morning,2,0,2
2012-10-02,3,Tuesday,Winter,2,Early Morning,5,1,4
2012-10-02,4,Tuesday,Winter,2,Early Morning,10,2,8
2012-10-02,5,Tuesday,Winter,2,Early Morning,43,1,42
2012-10-02,6,Tuesday,Winter,3,Morning Rush,179,3,176
2012-10-02,7,Tuesday,Winter,3,Morning Rush,260,4,256
2012-10-02,8,Tuesday,Winter,3,Morning Rush,134,6,128
2012-10-02,9,Tuesday,Winter,3,Morning Rush,86,3,83
2012-10-02,10,Tuesday,Winter,3,Mid-Day,45,3,42
2012-10-02,11,Tuesday,Winter,3,Mid-Day,99,7,92
2012-10-02,12,Tuesday,Winter,2,Mid-Day,104,6,98
2012-10-02,13,Tuesday,Winter,2,Mid-Day,154,6,148
2012-10-02,14,Tuesday,Winter,3,Mid-Day,163,16,147
2012-10-02,15,Tuesday,Winter,3,Mid-Day,209,14,195
2012-10-02,16,Tuesday,Winter,3,Evening Rush,374,46,328
2012-10-02,17,Tuesday,Winter,3,Evening Rush,715,38,677
2012-10-02,18,Tuesday,Winter,3,Evening Rush,687,48,639
2012-10-02,19,Tuesday,Winter,3,Evening Rush,395,27,368
2012-10-02,20,Tuesday,Winter,3,Night,306,20,286
2012-10-02,21,Tuesday,Winter,3,Night,289,24,265
2012-10-02,22,Tuesday,Winter,2,Night,240,28,212
2012-10-02,23,Tuesday,Winter,2,Night,98,11,87
2012-10-03,0,Wednesday,Winter,3,Early Morning,52,5,47
2012-10-03,1,Wednesday,Winter,2,Early Morning,19,3,16
2012-10-03,2,Wednesday,Winter,2,Early Morning,9,2,7
2012-10-03,3,Wednesday,Winter,2,Early Morning,7,0,7
2012-10-03,4,Wednesday,Winter,2,Early Morning,11,2,9
2012-10-03,5,Wednesday,Winter,2,Early Morning,34,2,32
2012-10-03,6,Wednesday,Winter,2,Morning Rush,177,4,173
2012-10-03,7,Wednesday,Winter,2,Morning Rush,515,11,504
2012-10-03,8,Wednesday,Winter,2,Morning Rush,809,28,781
2012-10-03,9,Wednesday,Winter,2,Morning Rush,362,30,332
2012-10-03,10,Wednesday,Winter,1,Mid-Day,175,29,146
2012-10-03,11,Wednesday,Winter,1,Mid-Day,230,52,178
2012-10-03,12,Wednesday,Winter,2,Mid-Day,358,69,289
2012-10-03,13,Wednesday,Winter,2,Mid-Day,279,55,224
2012-10-03,14,Wednesday,Winter,2,Mid-Day,251,56,195
2012-10-03,15,Wednesday,Winter,2,Mid-Day,319,59,260
2012-10-03,16,Wednesday,Winter,2,Evening Rush,478,42,436
2012-10-03,17,Wednesday,Winter,1,Evening Rush,917,84,833
2012-10-03,18,Wednesday,Winter,1,Evening Rush,810,54,756
2012-10-03,19,Wednesday,Winter,1,Evening Rush,593,49,544
2012-10-03,20,Wednesday,Winter,1,Night,497,48,449
2012-10-03,21,Wednesday,Winter,2,Night,209,14,195
2012-10-03,22,Wednesday,Winter,1,Night,241,9,232
2012-10-03,23,Wednesday,Winter,2,Night,220,21,199
2012-10-04,0,Thursday,Winter,3,Early Morning,76,11,65
2012-10-04,1,Thursday,Winter,2,Early Morning,25,2,23
2012-10-04,2,Thursday,Winter,1,Early Morning,13,3,10
2012-10-04,3,Thursday,Winter,2,Early Morning,11,5,6
2012-10-04,4,Thursday,Winter,2,Early Morning,10,0,10
2012-10-04,5,Thursday,Winter,3,Early Morning,39,2,37
2012-10-04,6,Thursday,Winter,3,Morning Rush,133,1,132
2012-10-04,7,Thursday,Winter,2,Morning Rush,391,12,379
2012-10-04,8,Thursday,Winter,1,Morning Rush,738,27,711
2012-10-04,9,Thursday,Winter,2,Morning Rush,359,40,319
2012-10-04,10,Thursday,Winter,2,Mid-Day,177,27,150
2012-10-04,11,Thursday,Winter,2,Mid-Day,214,38,176
2012-10-04,12,Thursday,Winter,2,Mid-Day,288,57,231
2012-10-04,13,Thursday,Winter,2,Mid-Day,294,63,231
2012-10-04,14,Thursday,Winter,1,Mid-Day,267,56,211
2012-10-04,15,Thursday,Winter,1,Mid-Day,325,77,248
2012-10-04,16,Thursday,Winter,1,Evening Rush,497,86,411
2012-10-04,17,Thursday,Winter,1,Evening Rush,901,112,789
2012-10-04,18,Thursday,Winter,1,Evening Rush,887,75,812
2012-10-04,19,Thursday,Winter,1,Evening Rush,534,67,467
2012-10-04,20,Thursday,Winter,1,Night,441,50,391
2012-10-04,21,Thursday,Winter,1,Night,321,33,288
2012-10-04,22,Thursday,Winter,1,Night,232,29,203
2012-10-04,23,Thursday,Winter,1,Night,155,18,137
2012-10-05,0,Friday,Winter,1,Early Morning,102,16,86
2012-10-05,1,Friday,Winter,1,Early Morning,46,3,43
2012-10-05,2,Friday,Winter,1,Early Morning,11,1,10
2012-10-05,3,Friday,Winter,1,Early Morning,16,5,11
2012-10-05,4,Friday,Winter,1,Early Morning,11,0,11
2012-10-05,5,Friday,Winter,1,Early Morning,41,0,41
2012-10-05,6,Friday,Winter,1,Morning Rush,137,4,133
2012-10-05,7,Friday,Winter,1,Morning Rush,428,11,417
2012-10-05,8,Friday,Winter,1,Morning Rush,785,36,749
2012-10-05,9,Friday,Winter,1,Morning Rush,384,58,326
2012-10-05,10,Friday,Winter,1,Mid-Day,260,68,192
2012-10-05,11,Friday,Winter,1,Mid-Day,304,90,214
2012-10-05,12,Friday,Winter,1,Mid-Day,468,161,307
2012-10-05,13,Friday,Winter,1,Mid-Day,424,117,307
2012-10-05,14,Friday,Winter,1,Mid-Day,400,113,287
2012-10-05,15,Friday,Winter,1,Mid-Day,470,150,320
2012-10-05,16,Friday,Winter,1,Evening Rush,634,153,481
2012-10-05,17,Friday,Winter,1,Evening Rush,900,158,742
2012-10-05,18,Friday,Winter,1,Evening Rush,761,106,655
2012-10-05,19,Friday,Winter,1,Evening Rush,500,67,433
2012-10-05,20,Friday,Winter,1,Night,372,66,306
2012-10-05,21,Friday,Winter,1,Night,267,47,220
2012-10-05,22,Friday,Winter,1,Night,264,63,201
2012-10-05,23,Friday,Winter,1,Night,171,23,148
2012-10-06,0,Saturday,Winter,1,Early Morning,191,37,154
2012-10-06,1,Saturday,Winter,1,Early Morning,141,25,116
2012-10-06,2,Saturday,Winter,1,Early Morning,75,13,62
2012-10-06,3,Saturday,Winter,1,Early Morning,56,2,54
2012-10-06,4,Saturday,Winter,1,Early Morning,11,4,7
2012-10-06,5,Saturday,Winter,1,Early Morning,10,2,8
2012-10-06,6,Saturday,Winter,1,Morning Rush,30,2,28
2012-10-06,7,Saturday,Winter,1,Morning Rush,84,13,71
2012-10-06,8,Saturday,Winter,1,Morning Rush,206,22,184
2012-10-06,9,Saturday,Winter,1,Morning Rush,395,130,265
2012-10-06,10,Saturday,Winter,1,Mid-Day,539,198,341
2012-10-06,11,Saturday,Winter,1,Mid-Day,647,258,389
2012-10-06,12,Saturday,Winter,1,Mid-Day,743,362,381
2012-10-06,13,Saturday,Winter,2,Mid-Day,710,310,400
2012-10-06,14,Saturday,Winter,2,Mid-Day,576,269,307
2012-10-06,15,Saturday,Winter,1,Mid-Day,620,279,341
2012-10-06,16,Saturday,Winter,1,Evening Rush,659,317,342
2012-10-06,17,Saturday,Winter,1,Evening Rush,610,268,342
2012-10-06,18,Saturday,Winter,1,Evening Rush,495,183,312
2012-10-06,19,Saturday,Winter,1,Evening Rush,341,102,239
2012-10-06,20,Saturday,Winter,1,Night,247,75,172
2012-10-06,21,Saturday,Winter,1,Night,215,78,137
2012-10-06,22,Saturday,Winter,1,Night,185,45,140
2012-10-06,23,Saturday,Winter,1,Night,179,37,142
2012-10-07,0,Sunday,Winter,1,Early Morning,127,28,99
2012-10-07,1,Sunday,Winter,1,Early Morning,109,29,80
2012-10-07,2,Sunday,Winter,1,Early Morning,74,10,64
2012-10-07,3,Sunday,Winter,2,Early Morning,22,5,17
2012-10-07,4,Sunday,Winter,2,Early Morning,11,5,6
2012-10-07,5,Sunday,Winter,2,Early Morning,10,2,8
2012-10-07,6,Sunday,Winter,2,Morning Rush,23,4,19
2012-10-07,7,Sunday,Winter,3,Morning Rush,35,6,29
2012-10-07,8,Sunday,Winter,3,Morning Rush,62,11,51
2012-10-07,9,Sunday,Winter,3,Morning Rush,86,16,70
2012-10-07,10,Sunday,Winter,2,Mid-Day,185,41,144
2012-10-07,11,Sunday,Winter,2,Mid-Day,336,76,260
2012-10-07,12,Sunday,Winter,2,Mid-Day,392,100,292
2012-10-07,13,Sunday,Winter,2,Mid-Day,320,80,240
2012-10-07,14,Sunday,Winter,2,Mid-Day,314,71,243
2012-10-07,15,Sunday,Winter,3,Mid-Day,306,74,232
2012-10-07,16,Sunday,Winter,3,Evening Rush,333,87,246
2012-10-07,17,Sunday,Winter,3,Evening Rush,157,35,122
2012-10-07,18,Sunday,Winter,3,Evening Rush,106,24,82
2012-10-07,19,Sunday,Winter,2,Evening Rush,114,17,97
2012-10-07,20,Sunday,Winter,1,Night,116,19,97
2012-10-07,21,Sunday,Winter,1,Night,113,22,91
2012-10-07,22,Sunday,Winter,1,Night,79,7,72
2012-10-07,23,Sunday,Winter,1,Night,80,12,68
2012-10-08,0,Monday,Winter,1,Early Morning,51,7,44
2012-10-08,1,Monday,Winter,1,Early Morning,37,2,35
2012-10-08,2,Monday,Winter,1,Early Morning,15,3,12
2012-10-08,3,Monday,Winter,1,Early Morning,10,2,8
2012-10-08,4,Monday,Winter,1,Early Morning,7,1,6
2012-10-08,5,Monday,Winter,1,Early Morning,19,2,17
2012-10-08,6,Monday,Winter,1,Morning Rush,59,5,54
2012-10-08,7,Monday,Winter,2,Morning Rush,154,3,151
2012-10-08,8,Monday,Winter,2,Morning Rush,397,23,374
2012-10-08,9,Monday,Winter,2,Morning Rush,332,59,273
2012-10-08,10,Monday,Winter,2,Mid-Day,298,69,229
2012-10-08,11,Monday,Winter,2,Mid-Day,308,72,236
2012-10-08,12,Monday,Winter,2,Mid-Day,341,74,267
2012-10-08,13,Monday,Winter,2,Mid-Day,405,82,323
2012-10-08,14,Monday,Winter,2,Mid-Day,420,121,299
2012-10-08,15,Monday,Winter,3,Mid-Day,370,76,294
2012-10-08,16,Monday,Winter,3,Evening Rush,377,61,316
2012-10-08,17,Monday,Winter,2,Evening Rush,497,81,416
2012-10-08,18,Monday,Winter,2,Evening Rush,456,41,415
2012-10-08,19,Monday,Winter,2,Evening Rush,371,38,333
2012-10-08,20,Monday,Winter,3,Night,227,20,207
2012-10-08,21,Monday,Winter,2,Night,151,17,134
2012-10-08,22,Monday,Winter,3,Night,107,6,101
2012-10-08,23,Monday,Winter,2,Night,69,9,60
2012-10-09,0,Tuesday,Winter,2,Early Morning,31,9,22
2012-10-09,1,Tuesday,Winter,3,Early Morning,13,0,13
2012-10-09,2,Tuesday,Winter,3,Early Morning,7,2,5
2012-10-09,3,Tuesday,Winter,3,Early Morning,3,0,3
2012-10-09,4,Tuesday,Winter,3,Early Morning,7,1,6
2012-10-09,5,Tuesday,Winter,2,Early Morning,19,0,19
2012-10-09,6,Tuesday,Winter,2,Morning Rush,143,2,141
2012-10-09,7,Tuesday,Winter,1,Morning Rush,362,5,357
2012-10-09,8,Tuesday,Winter,2,Morning Rush,713,15,698
2012-10-09,9,Tuesday,Winter,2,Morning Rush,382,37,345
2012-10-09,10,Tuesday,Winter,2,Mid-Day,164,33,131
2012-10-09,11,Tuesday,Winter,2,Mid-Day,193,37,156
2012-10-09,12,Tuesday,Winter,2,Mid-Day,260,43,217
2012-10-09,13,Tuesday,Winter,2,Mid-Day,238,54,184
2012-10-09,14,Tuesday,Winter,2,Mid-Day,244,43,201
2012-10-09,15,Tuesday,Winter,2,Mid-Day,254,59,195
2012-10-09,16,Tuesday,Winter,2,Evening Rush,424,70,354
2012-10-09,17,Tuesday,Winter,2,Evening Rush,806,73,733
2012-10-09,18,Tuesday,Winter,2,Evening Rush,784,26,758
2012-10-09,19,Tuesday,Winter,2,Evening Rush,514,31,483
2012-10-09,20,Tuesday,Winter,2,Night,360,30,330
2012-10-09,21,Tuesday,Winter,2,Night,225,16,209
2012-10-09,22,Tuesday,Winter,2,Night,162,7,155
2012-10-09,23,Tuesday,Winter,2,Night,84,8,76
2012-10-10,0,Wednesday,Winter,2,Early Morning,33,0,33
2012-10-10,1,Wednesday,Winter,2,Early Morning,8,2,6
2012-10-10,2,Wednesday,Winter,2,Early Morning,8,2,6
2012-10-10,3,Wednesday,Winter,2,Early Morning,6,0,6
2012-10-10,4,Wednesday,Winter,2,Early Morning,6,0,6
2012-10-10,5,Wednesday,Winter,2,Early Morning,40,2,38
2012-10-10,6,Wednesday,Winter,2,Morning Rush,175,3,172
2012-10-10,7,Wednesday,Winter,1,Morning Rush,507,9,498
2012-10-10,8,Wednesday,Winter,1,Morning Rush,839,33,806
2012-10-10,9,Wednesday,Winter,1,Morning Rush,366,35,331
2012-10-10,10,Wednesday,Winter,1,Mid-Day,217,27,190
2012-10-10,11,Wednesday,Winter,1,Mid-Day,291,53,238
2012-10-10,12,Wednesday,Winter,1,Mid-Day,390,78,312
2012-10-10,13,Wednesday,Winter,1,Mid-Day,297,60,237
2012-10-10,14,Wednesday,Winter,1,Mid-Day,271,63,208
2012-10-10,15,Wednesday,Winter,1,Mid-Day,319,58,261
2012-10-10,16,Wednesday,Winter,1,Evening Rush,566,92,474
2012-10-10,17,Wednesday,Winter,1,Evening Rush,948,91,857
2012-10-10,18,Wednesday,Winter,2,Evening Rush,844,57,787
2012-10-10,19,Wednesday,Winter,2,Evening Rush,566,32,534
2012-10-10,20,Wednesday,Winter,1,Night,392,21,371
2012-10-10,21,Wednesday,Winter,1,Night,269,18,251
2012-10-10,22,Wednesday,Winter,1,Night,197,27,170
2012-10-10,23,Wednesday,Winter,1,Night,136,17,119
2012-10-11,0,Thursday,Winter,1,Early Morning,42,1,41
2012-10-11,1,Thursday,Winter,1,Early Morning,11,1,10
2012-10-11,2,Thursday,Winter,1,Early Morning,11,4,7
2012-10-11,3,Thursday,Winter,1,Early Morning,3,0,3
2012-10-11,4,Thursday,Winter,1,Early Morning,10,0,10
2012-10-11,5,Thursday,Winter,1,Early Morning,42,0,42
2012-10-11,6,Thursday,Winter,1,Morning Rush,159,1,158
2012-10-11,7,Thursday,Winter,1,Morning Rush,478,11,467
2012-10-11,8,Thursday,Winter,1,Morning Rush,798,25,773
2012-10-11,9,Thursday,Winter,1,Morning Rush,355,27,328
2012-10-11,10,Thursday,Winter,1,Mid-Day,204,39,165
2012-10-11,11,Thursday,Winter,1,Mid-Day,251,76,175
2012-10-11,12,Thursday,Winter,1,Mid-Day,326,47,279
2012-10-11,13,Thursday,Winter,1,Mid-Day,291,48,243
2012-10-11,14,Thursday,Winter,1,Mid-Day,348,78,270
2012-10-11,15,Thursday,Winter,1,Mid-Day,460,102,358
2012-10-11,16,Thursday,Winter,1,Evening Rush,481,68,413
2012-10-11,17,Thursday,Winter,1,Evening Rush,827,90,737
2012-10-11,18,Thursday,Winter,1,Evening Rush,692,64,628
2012-10-11,19,Thursday,Winter,1,Evening Rush,743,81,662
2012-10-11,20,Thursday,Winter,1,Night,415,27,388
2012-10-11,21,Thursday,Winter,1,Night,260,24,236
2012-10-11,22,Thursday,Winter,1,Night,177,10,167
2012-10-11,23,Thursday,Winter,1,Night,186,10,176
2012-10-12,0,Friday,Winter,1,Early Morning,68,8,60
2012-10-12,1,Friday,Winter,1,Early Morning,37,8,29
2012-10-12,2,Friday,Winter,1,Early Morning,16,0,16
2012-10-12,3,Friday,Winter,1,Early Morning,6,0,6
2012-10-12,4,Friday,Winter,1,Early Morning,8,0,8
2012-10-12,5,Friday,Winter,1,Early Morning,35,2,33
2012-10-12,6,Friday,Winter,1,Morning Rush,143,3,140
2012-10-12,7,Friday,Winter,1,Morning Rush,392,8,384
2012-10-12,8,Friday,Winter,1,Morning Rush,745,34,711
2012-10-12,9,Friday,Winter,1,Morning Rush,400,26,374
2012-10-12,10,Friday,Winter,1,Mid-Day,275,75,200
2012-10-12,11,Friday,Winter,1,Mid-Day,313,61,252
2012-10-12,12,Friday,Winter,1,Mid-Day,387,75,312
2012-10-12,13,Friday,Winter,1,Mid-Day,381,81,300
2012-10-12,14,Friday,Winter,1,Mid-Day,371,109,262
2012-10-12,15,Friday,Winter,1,Mid-Day,455,138,317
2012-10-12,16,Friday,Winter,1,Evening Rush,520,108,412
2012-10-12,17,Friday,Winter,1,Evening Rush,837,131,706
2012-10-12,18,Friday,Winter,1,Evening Rush,642,76,566
2012-10-12,19,Friday,Winter,1,Evening Rush,493,40,453
2012-10-12,20,Friday,Winter,1,Night,308,28,280
2012-10-12,21,Friday,Winter,1,Night,190,21,169
2012-10-12,22,Friday,Winter,1,Night,160,17,143
2012-10-12,23,Friday,Winter,1,Night,100,11,89
2012-10-13,0,Saturday,Winter,1,Early Morning,249,31,218
2012-10-13,1,Saturday,Winter,1,Early Morning,146,23,123
2012-10-13,2,Saturday,Winter,1,Early Morning,67,7,60
2012-10-13,3,Saturday,Winter,1,Early Morning,15,2,13
2012-10-13,4,Saturday,Winter,1,Early Morning,11,2,9
2012-10-13,5,Saturday,Winter,1,Early Morning,11,0,11
2012-10-13,6,Saturday,Winter,1,Morning Rush,28,5,23
2012-10-13,7,Saturday,Winter,1,Morning Rush,70,10,60
2012-10-13,8,Saturday,Winter,1,Morning Rush,174,23,151
2012-10-13,9,Saturday,Winter,1,Morning Rush,266,46,220
2012-10-13,10,Saturday,Winter,1,Mid-Day,347,82,265
2012-10-13,11,Saturday,Winter,1,Mid-Day,527,192,335
2012-10-13,12,Saturday,Winter,1,Mid-Day,573,202,371
2012-10-13,13,Saturday,Winter,1,Mid-Day,670,235,435
2012-10-13,14,Saturday,Winter,1,Mid-Day,597,243,354
2012-10-13,15,Saturday,Winter,1,Mid-Day,615,251,364
2012-10-13,16,Saturday,Winter,1,Evening Rush,637,294,343
2012-10-13,17,Saturday,Winter,1,Evening Rush,528,193,335
2012-10-13,18,Saturday,Winter,1,Evening Rush,473,174,299
2012-10-13,19,Saturday,Winter,1,Evening Rush,332,73,259
2012-10-13,20,Saturday,Winter,1,Night,255,57,198
2012-10-13,21,Saturday,Winter,1,Night,204,47,157
2012-10-13,22,Saturday,Winter,1,Night,189,33,156
2012-10-13,23,Saturday,Winter,1,Night,125,27,98
2012-10-14,0,Sunday,Winter,1,Early Morning,111,8,103
2012-10-14,1,Sunday,Winter,1,Early Morning,112,16,96
2012-10-14,2,Sunday,Winter,1,Early Morning,66,8,58
2012-10-14,3,Sunday,Winter,1,Early Morning,28,3,25
2012-10-14,4,Sunday,Winter,1,Early Morning,12,2,10
2012-10-14,5,Sunday,Winter,1,Early Morning,11,5,6
2012-10-14,6,Sunday,Winter,1,Morning Rush,24,4,20
2012-10-14,7,Sunday,Winter,1,Morning Rush,51,7,44
2012-10-14,8,Sunday,Winter,1,Morning Rush,132,28,104
2012-10-14,9,Sunday,Winter,2,Morning Rush,223,62,161
2012-10-14,10,Sunday,Winter,1,Mid-Day,428,150,278
2012-10-14,11,Sunday,Winter,1,Mid-Day,494,156,338
2012-10-14,12,Sunday,Winter,1,Mid-Day,562,200,362
2012-10-14,13,Sunday,Winter,1,Mid-Day,619,218,401
2012-10-14,14,Sunday,Winter,1,Mid-Day,617,249,368
2012-10-14,15,Sunday,Winter,1,Mid-Day,568,213,355
2012-10-14,16,Sunday,Winter,1,Evening Rush,581,203,378
2012-10-14,17,Sunday,Winter,1,Evening Rush,539,193,346
2012-10-14,18,Sunday,Winter,1,Evening Rush,453,134,319
2012-10-14,19,Sunday,Winter,1,Evening Rush,336,68,268
2012-10-14,20,Sunday,Winter,1,Night,246,48,198
2012-10-14,21,Sunday,Winter,1,Night,196,40,156
2012-10-14,22,Sunday,Winter,1,Night,125,38,87
2012-10-14,23,Sunday,Winter,2,Night,105,27,78
2012-10-15,0,Monday,Winter,2,Early Morning,48,17,31
2012-10-15,1,Monday,Winter,2,Early Morning,29,5,24
2012-10-15,2,Monday,Winter,2,Early Morning,6,1,5
2012-10-15,3,Monday,Winter,2,Early Morning,4,2,2
2012-10-15,4,Monday,Winter,2,Early Morning,10,1,9
2012-10-15,5,Monday,Winter,2,Early Morning,40,2,38
2012-10-15,6,Monday,Winter,2,Morning Rush,147,6,141
2012-10-15,7,Monday,Winter,2,Morning Rush,476,15,461
2012-10-15,8,Monday,Winter,2,Morning Rush,737,24,713
2012-10-15,9,Monday,Winter,3,Morning Rush,359,31,328
2012-10-15,10,Monday,Winter,2,Mid-Day,168,43,125
2012-10-15,11,Monday,Winter,2,Mid-Day,263,88,175
2012-10-15,12,Monday,Winter,3,Mid-Day,284,73,211
2012-10-15,13,Monday,Winter,2,Mid-Day,146,37,109
2012-10-15,14,Monday,Winter,2,Mid-Day,185,57,128
2012-10-15,15,Monday,Winter,1,Mid-Day,260,70,190
2012-10-15,16,Monday,Winter,1,Evening Rush,447,76,371
2012-10-15,17,Monday,Winter,1,Evening Rush,766,96,670
2012-10-15,18,Monday,Winter,3,Evening Rush,592,52,540
2012-10-15,19,Monday,Winter,3,Evening Rush,239,12,227
2012-10-15,20,Monday,Winter,2,Night,256,19,237
2012-10-15,21,Monday,Winter,1,Night,206,16,190
2012-10-15,22,Monday,Winter,1,Night,126,8,118
2012-10-15,23,Monday,Winter,1,Night,81,9,72
2012-10-16,0,Tuesday,Winter,1,Early Morning,48,3,45
2012-10-16,1,Tuesday,Winter,1,Early Morning,13,4,9
2012-10-16,2,Tuesday,Winter,1,Early Morning,3,2,1
2012-10-16,3,Tuesday,Winter,1,Early Morning,2,0,2
2012-10-16,4,Tuesday,Winter,1,Early Morning,7,0,7
2012-10-16,5,Tuesday,Winter,1,Early Morning,52,5,47
2012-10-16,6,Tuesday,Winter,1,Morning Rush,172,4,168
2012-10-16,7,Tuesday,Winter,1,Morning Rush,525,20,505
2012-10-16,8,Tuesday,Winter,1,Morning Rush,835,35,800
2012-10-16,9,Tuesday,Winter,1,Morning Rush,355,32,323
2012-10-16,10,Tuesday,Winter,1,Mid-Day,222,65,157
2012-10-16,11,Tuesday,Winter,1,Mid-Day,228,56,172
2012-10-16,12,Tuesday,Winter,2,Mid-Day,325,69,256
2012-10-16,13,Tuesday,Winter,1,Mid-Day,328,68,260
2012-10-16,14,Tuesday,Winter,1,Mid-Day,308,94,214
2012-10-16,15,Tuesday,Winter,1,Mid-Day,346,76,270
2012-10-16,16,Tuesday,Winter,1,Evening Rush,446,79,367
2012-10-16,17,Tuesday,Winter,1,Evening Rush,943,104,839
2012-10-16,18,Tuesday,Winter,1,Evening Rush,838,71,767
2012-10-16,19,Tuesday,Winter,1,Evening Rush,531,40,491
2012-10-16,20,Tuesday,Winter,1,Night,432,35,397
2012-10-16,21,Tuesday,Winter,1,Night,195,19,176
2012-10-16,22,Tuesday,Winter,1,Night,181,18,163
2012-10-16,23,Tuesday,Winter,1,Night,199,23,176
2012-10-17,0,Wednesday,Winter,1,Early Morning,49,1,48
2012-10-17,1,Wednesday,Winter,1,Early Morning,17,3,14
2012-10-17,2,Wednesday,Winter,1,Early Morning,16,4,12
2012-10-17,3,Wednesday,Winter,1,Early Morning,7,0,7
2012-10-17,4,Wednesday,Winter,1,Early Morning,4,0,4
2012-10-17,5,Wednesday,Winter,2,Early Morning,41,2,39
2012-10-17,6,Wednesday,Winter,1,Morning Rush,178,7,171
2012-10-17,7,Wednesday,Winter,1,Morning Rush,464,15,449
2012-10-17,8,Wednesday,Winter,2,Morning Rush,817,38,779
2012-10-17,9,Wednesday,Winter,2,Morning Rush,382,38,344
2012-10-17,10,Wednesday,Winter,2,Mid-Day,228,60,168
2012-10-17,11,Wednesday,Winter,2,Mid-Day,234,78,156
2012-10-17,12,Wednesday,Winter,2,Mid-Day,332,71,261
2012-10-17,13,Wednesday,Winter,2,Mid-Day,310,73,237
2012-10-17,14,Wednesday,Winter,2,Mid-Day,270,82,188
2012-10-17,15,Wednesday,Winter,2,Mid-Day,301,62,239
2012-10-17,16,Wednesday,Winter,1,Evening Rush,466,70,396
2012-10-17,17,Wednesday,Winter,1,Evening Rush,888,122,766
2012-10-17,18,Wednesday,Winter,1,Evening Rush,884,90,794
2012-10-17,19,Wednesday,Winter,1,Evening Rush,516,49,467
2012-10-17,20,Wednesday,Winter,1,Night,414,54,360
2012-10-17,21,Wednesday,Winter,1,Night,329,28,301
2012-10-17,22,Wednesday,Winter,1,Night,215,17,198
2012-10-17,23,Wednesday,Winter,1,Night,99,15,84
2012-10-18,0,Thursday,Winter,1,Early Morning,57,4,53
2012-10-18,1,Thursday,Winter,1,Early Morning,14,0,14
2012-10-18,2,Thursday,Winter,1,Early Morning,14,1,13
2012-10-18,3,Thursday,Winter,1,Early Morning,5,0,5
2012-10-18,4,Thursday,Winter,1,Early Morning,5,0,5
2012-10-18,5,Thursday,Winter,1,Early Morning,42,1,41
2012-10-18,6,Thursday,Winter,1,Morning Rush,153,3,150
2012-10-18,7,Thursday,Winter,1,Morning Rush,508,20,488
2012-10-18,8,Thursday,Winter,1,Morning Rush,834,31,803
2012-10-18,9,Thursday,Winter,2,Morning Rush,387,41,346
2012-10-18,10,Thursday,Winter,2,Mid-Day,218,60,158
2012-10-18,11,Thursday,Winter,2,Mid-Day,268,79,189
2012-10-18,12,Thursday,Winter,2,Mid-Day,377,93,284
2012-10-18,13,Thursday,Winter,1,Mid-Day,332,96,236
2012-10-18,14,Thursday,Winter,2,Mid-Day,285,94,191
2012-10-18,15,Thursday,Winter,2,Mid-Day,353,69,284
2012-10-18,16,Thursday,Winter,1,Evening Rush,450,94,356
2012-10-18,17,Thursday,Winter,2,Evening Rush,890,102,788
2012-10-18,18,Thursday,Winter,2,Evening Rush,788,68,720
2012-10-18,19,Thursday,Winter,2,Evening Rush,513,42,471
2012-10-18,20,Thursday,Winter,2,Night,387,39,348
2012-10-18,21,Thursday,Winter,2,Night,283,38,245
2012-10-18,22,Thursday,Winter,2,Night,229,27,202
2012-10-18,23,Thursday,Winter,2,Night,117,6,111
2012-10-19,0,Friday,Winter,2,Early Morning,56,5,51
2012-10-19,1,Friday,Winter,3,Early Morning,16,4,12
2012-10-19,2,Friday,Winter,2,Early Morning,10,1,9
2012-10-19,3,Friday,Winter,2,Early Morning,5,0,5
2012-10-19,4,Friday,Winter,2,Early Morning,6,1,5
2012-10-19,5,Friday,Winter,2,Early Morning,36,1,35
2012-10-19,6,Friday,Winter,3,Morning Rush,131,5,126
2012-10-19,7,Friday,Winter,3,Morning Rush,154,5,149
2012-10-19,8,Friday,Winter,2,Morning Rush,467,20,447
2012-10-19,9,Friday,Winter,2,Morning Rush,389,26,363
2012-10-19,10,Friday,Winter,2,Mid-Day,224,26,198
2012-10-19,11,Friday,Winter,1,Mid-Day,252,41,211
2012-10-19,12,Friday,Winter,1,Mid-Day,332,74,258
2012-10-19,13,Friday,Winter,1,Mid-Day,375,87,288
2012-10-19,14,Friday,Winter,1,Mid-Day,365,88,277
2012-10-19,15,Friday,Winter,1,Mid-Day,395,93,302
2012-10-19,16,Friday,Winter,3,Evening Rush,565,131,434
2012-10-19,17,Friday,Winter,3,Evening Rush,425,48,377
2012-10-19,18,Friday,Winter,1,Evening Rush,233,21,212
2012-10-19,19,Friday,Winter,1,Evening Rush,232,19,213
2012-10-19,20,Friday,Winter,1,Night,229,13,216
2012-10-19,21,Friday,Winter,1,Night,206,17,189
2012-10-19,22,Friday,Winter,1,Night,190,14,176
2012-10-19,23,Friday,Winter,1,Night,131,13,118
2012-10-20,0,Saturday,Winter,1,Early Morning,123,13,110
2012-10-20,1,Saturday,Winter,1,Early Morning,95,2,93
2012-10-20,2,Saturday,Winter,1,Early Morning,78,9,69
2012-10-20,3,Saturday,Winter,1,Early Morning,29,2,27
2012-10-20,4,Saturday,Winter,1,Early Morning,18,9,9
2012-10-20,5,Saturday,Winter,1,Early Morning,13,6,7
2012-10-20,6,Saturday,Winter,1,Morning Rush,31,5,26
2012-10-20,7,Saturday,Winter,1,Morning Rush,65,6,59
2012-10-20,8,Saturday,Winter,1,Morning Rush,193,29,164
2012-10-20,9,Saturday,Winter,1,Morning Rush,363,106,257
2012-10-20,10,Saturday,Winter,1,Mid-Day,423,111,312
2012-10-20,11,Saturday,Winter,1,Mid-Day,612,204,408
2012-10-20,12,Saturday,Winter,1,Mid-Day,703,267,436
2012-10-20,13,Saturday,Winter,1,Mid-Day,714,273,441
2012-10-20,14,Saturday,Winter,1,Mid-Day,711,335,376
2012-10-20,15,Saturday,Winter,1,Mid-Day,711,308,403
2012-10-20,16,Saturday,Winter,1,Evening Rush,691,325,366
2012-10-20,17,Saturday,Winter,1,Evening Rush,731,347,384
2012-10-20,18,Saturday,Winter,1,Evening Rush,521,165,356
2012-10-20,19,Saturday,Winter,1,Evening Rush,345,77,268
2012-10-20,20,Saturday,Winter,1,Night,259,61,198
2012-10-20,21,Saturday,Winter,1,Night,296,72,224
2012-10-20,22,Saturday,Winter,1,Night,202,47,155
2012-10-20,23,Saturday,Winter,1,Night,163,27,136
2012-10-21,0,Sunday,Winter,1,Early Morning,154,35,119
2012-10-21,1,Sunday,Winter,1,Early Morning,117,20,97
2012-10-21,2,Sunday,Winter,1,Early Morning,132,44,88
2012-10-21,3,Sunday,Winter,1,Early Morning,41,12,29
2012-10-21,4,Sunday,Winter,1,Early Morning,21,8,13
2012-10-21,5,Sunday,Winter,1,Early Morning,10,6,4
2012-10-21,6,Sunday,Winter,1,Morning Rush,26,8,18
2012-10-21,7,Sunday,Winter,1,Morning Rush,56,13,43
2012-10-21,8,Sunday,Winter,1,Morning Rush,143,39,104
2012-10-21,9,Sunday,Winter,1,Morning Rush,269,77,192
2012-10-21,10,Sunday,Winter,1,Mid-Day,443,167,276
2012-10-21,11,Sunday,Winter,1,Mid-Day,547,191,356
2012-10-21,12,Sunday,Winter,1,Mid-Day,675,236,439
2012-10-21,13,Sunday,Winter,1,Mid-Day,626,243,383
2012-10-21,14,Sunday,Winter,1,Mid-Day,640,235,405
2012-10-21,15,Sunday,Winter,1,Mid-Day,623,240,383
2012-10-21,16,Sunday,Winter,1,Evening Rush,591,182,409
2012-10-21,17,Sunday,Winter,1,Evening Rush,491,153,338
2012-10-21,18,Sunday,Winter,1,Evening Rush,413,71,342
2012-10-21,19,Sunday,Winter,1,Evening Rush,266,50,216
2012-10-21,20,Sunday,Winter,1,Night,195,35,160
2012-10-21,21,Sunday,Winter,1,Night,166,42,124
2012-10-21,22,Sunday,Winter,1,Night,113,18,95
2012-10-21,23,Sunday,Winter,1,Night,66,7,59
2012-10-22,0,Monday,Winter,1,Early Morning,31,3,28
2012-10-22,1,Monday,Winter,1,Early Morning,11,0,11
2012-10-22,2,Monday,Winter,1,Early Morning,5,1,4
2012-10-22,3,Monday,Winter,1,Early Morning,6,1,5
2012-10-22,4,Monday,Winter,1,Early Morning,7,1,6
2012-10-22,5,Monday,Winter,1,Early Morning,46,2,44
2012-10-22,6,Monday,Winter,1,Morning Rush,144,4,140
2012-10-22,7,Monday,Winter,1,Morning Rush,452,15,437
2012-10-22,8,Monday,Winter,1,Morning Rush,728,32,696
2012-10-22,9,Monday,Winter,1,Morning Rush,360,25,335
2012-10-22,10,Monday,Winter,1,Mid-Day,212,51,161
2012-10-22,11,Monday,Winter,1,Mid-Day,211,63,148
2012-10-22,12,Monday,Winter,1,Mid-Day,283,52,231
2012-10-22,13,Monday,Winter,1,Mid-Day,315,88,227
2012-10-22,14,Monday,Winter,1,Mid-Day,282,73,209
2012-10-22,15,Monday,Winter,1,Mid-Day,296,74,222
2012-10-22,16,Monday,Winter,1,Evening Rush,524,80,444
2012-10-22,17,Monday,Winter,1,Evening Rush,922,84,838
2012-10-22,18,Monday,Winter,1,Evening Rush,786,60,726
2012-10-22,19,Monday,Winter,1,Evening Rush,514,36,478
2012-10-22,20,Monday,Winter,1,Night,403,21,382
2012-10-22,21,Monday,Winter,1,Night,174,19,155
2012-10-22,22,Monday,Winter,1,Night,183,25,158
2012-10-22,23,Monday,Winter,1,Night,163,20,143
2012-10-23,0,Tuesday,Winter,1,Early Morning,37,5,32
2012-10-23,1,Tuesday,Winter,1,Early Morning,17,1,16
2012-10-23,2,Tuesday,Winter,1,Early Morning,7,1,6
2012-10-23,3,Tuesday,Winter,1,Early Morning,1,0,1
2012-10-23,4,Tuesday,Winter,1,Early Morning,7,1,6
2012-10-23,5,Tuesday,Winter,1,Early Morning,50,1,49
2012-10-23,6,Tuesday,Winter,1,Morning Rush,158,6,152
2012-10-23,7,Tuesday,Winter,2,Morning Rush,531,12,519
2012-10-23,8,Tuesday,Winter,2,Morning Rush,761,28,733
2012-10-23,9,Tuesday,Winter,2,Morning Rush,334,29,305
2012-10-23,10,Tuesday,Winter,1,Mid-Day,221,50,171
2012-10-23,11,Tuesday,Winter,1,Mid-Day,253,52,201
2012-10-23,12,Tuesday,Winter,2,Mid-Day,378,80,298
2012-10-23,13,Tuesday,Winter,2,Mid-Day,303,59,244
2012-10-23,14,Tuesday,Winter,1,Mid-Day,296,67,229
2012-10-23,15,Tuesday,Winter,1,Mid-Day,346,76,270
2012-10-23,16,Tuesday,Winter,1,Evening Rush,541,108,433
2012-10-23,17,Tuesday,Winter,1,Evening Rush,938,67,871
2012-10-23,18,Tuesday,Winter,1,Evening Rush,826,64,762
2012-10-23,19,Tuesday,Winter,1,Evening Rush,482,25,457
2012-10-23,20,Tuesday,Winter,1,Night,379,45,334
2012-10-23,21,Tuesday,Winter,1,Night,295,35,260
2012-10-23,22,Tuesday,Winter,1,Night,194,20,174
2012-10-23,23,Tuesday,Winter,1,Night,111,9,102
2012-10-24,0,Wednesday,Winter,1,Early Morning,46,7,39
2012-10-24,1,Wednesday,Winter,1,Early Morning,27,4,23
2012-10-24,2,Wednesday,Winter,1,Early Morning,6,0,6
2012-10-24,3,Wednesday,Winter,1,Early Morning,4,0,4
2012-10-24,4,Wednesday,Winter,1,Early Morning,6,1,5
2012-10-24,5,Wednesday,Winter,1,Early Morning,53,1,52
2012-10-24,6,Wednesday,Winter,1,Morning Rush,173,11,162
2012-10-24,7,Wednesday,Winter,1,Morning Rush,526,20,506
2012-10-24,8,Wednesday,Winter,2,Morning Rush,801,24,777
2012-10-24,9,Wednesday,Winter,2,Morning Rush,373,24,349
2012-10-24,10,Wednesday,Winter,2,Mid-Day,171,29,142
2012-10-24,11,Wednesday,Winter,1,Mid-Day,236,47,189
2012-10-24,12,Wednesday,Winter,1,Mid-Day,316,48,268
2012-10-24,13,Wednesday,Winter,1,Mid-Day,306,65,241
2012-10-24,14,Wednesday,Winter,1,Mid-Day,301,64,237
2012-10-24,15,Wednesday,Winter,1,Mid-Day,308,63,245
2012-10-24,16,Wednesday,Winter,1,Evening Rush,532,67,465
2012-10-24,17,Wednesday,Winter,1,Evening Rush,963,87,876
2012-10-24,18,Wednesday,Winter,1,Evening Rush,858,63,795
2012-10-24,19,Wednesday,Winter,2,Evening Rush,572,50,522
2012-10-24,20,Wednesday,Winter,2,Night,441,45,396
2012-10-24,21,Wednesday,Winter,2,Night,313,33,280
2012-10-24,22,Wednesday,Winter,2,Night,238,30,208
2012-10-24,23,Wednesday,Winter,2,Night,123,12,111
2012-10-25,0,Thursday,Winter,2,Early Morning,76,19,57
2012-10-25,1,Thursday,Winter,1,Early Morning,28,6,22
2012-10-25,2,Thursday,Winter,1,Early Morning,18,3,15
2012-10-25,3,Thursday,Winter,2,Early Morning,8,0,8
2012-10-25,4,Thursday,Winter,2,Early Morning,5,1,4
2012-10-25,5,Thursday,Winter,2,Early Morning,55,2,53
2012-10-25,6,Thursday,Winter,2,Morning Rush,171,3,168
2012-10-25,7,Thursday,Winter,2,Morning Rush,495,18,477
2012-10-25,8,Thursday,Winter,2,Morning Rush,779,33,746
2012-10-25,9,Thursday,Winter,2,Morning Rush,343,23,320
2012-10-25,10,Thursday,Winter,2,Mid-Day,225,53,172
2012-10-25,11,Thursday,Winter,2,Mid-Day,238,57,181
2012-10-25,12,Thursday,Winter,2,Mid-Day,319,61,258
2012-10-25,13,Thursday,Winter,2,Mid-Day,313,49,264
2012-10-25,14,Thursday,Winter,1,Mid-Day,285,71,214
2012-10-25,15,Thursday,Winter,1,Mid-Day,305,63,242
2012-10-25,16,Thursday,Winter,1,Evening Rush,499,92,407
2012-10-25,17,Thursday,Winter,1,Evening Rush,886,112,774
2012-10-25,18,Thursday,Winter,1,Evening Rush,809,77,732
2012-10-25,19,Thursday,Winter,1,Evening Rush,542,45,497
2012-10-25,20,Thursday,Winter,2,Night,347,28,319
2012-10-25,21,Thursday,Winter,2,Night,271,24,247
2012-10-25,22,Thursday,Winter,2,Night,207,22,185
2012-10-25,23,Thursday,Winter,2,Night,135,13,122
2012-10-26,0,Friday,Winter,2,Early Morning,71,6,65
2012-10-26,1,Friday,Winter,2,Early Morning,36,4,32
2012-10-26,2,Friday,Winter,2,Early Morning,19,4,15
2012-10-26,3,Friday,Winter,2,Early Morning,13,5,8
2012-10-26,4,Friday,Winter,2,Early Morning,5,1,4
2012-10-26,5,Friday,Winter,2,Early Morning,50,3,47
2012-10-26,6,Friday,Winter,2,Morning Rush,144,2,142
2012-10-26,7,Friday,Winter,2,Morning Rush,421,13,408
2012-10-26,8,Friday,Winter,2,Morning Rush,734,20,714
2012-10-26,9,Friday,Winter,2,Morning Rush,403,56,347
2012-10-26,10,Friday,Winter,2,Mid-Day,197,41,156
2012-10-26,11,Friday,Winter,2,Mid-Day,290,68,222
2012-10-26,12,Friday,Winter,2,Mid-Day,392,90,302
2012-10-26,13,Friday,Winter,2,Mid-Day,337,77,260
2012-10-26,14,Friday,Winter,2,Mid-Day,351,99,252
2012-10-26,15,Friday,Winter,2,Mid-Day,448,142,306
2012-10-26,16,Friday,Winter,2,Evening Rush,582,137,445
2012-10-26,17,Friday,Winter,2,Evening Rush,817,125,692
2012-10-26,18,Friday,Winter,2,Evening Rush,665,81,584
2012-10-26,19,Friday,Winter,2,Evening Rush,471,72,399
2012-10-26,20,Friday,Winter,2,Night,311,40,271
2012-10-26,21,Friday,Winter,2,Night,292,40,252
2012-10-26,22,Friday,Winter,2,Night,217,37,180
2012-10-26,23,Friday,Winter,1,Night,178,19,159
2012-10-27,0,Saturday,Winter,1,Early Morning,142,10,132
2012-10-27,1,Saturday,Winter,2,Early Morning,146,23,123
2012-10-27,2,Saturday,Winter,2,Early Morning,90,19,71
2012-10-27,3,Saturday,Winter,1,Early Morning,26,5,21
2012-10-27,4,Saturday,Winter,2,Early Morning,13,1,12
2012-10-27,5,Saturday,Winter,2,Early Morning,9,2,7
2012-10-27,6,Saturday,Winter,2,Morning Rush,31,2,29
2012-10-27,7,Saturday,Winter,1,Morning Rush,86,7,79
2012-10-27,8,Saturday,Winter,1,Morning Rush,213,26,187
2012-10-27,9,Saturday,Winter,1,Morning Rush,328,88,240
2012-10-27,10,Saturday,Winter,1,Mid-Day,479,165,314
2012-10-27,11,Saturday,Winter,1,Mid-Day,585,197,388
2012-10-27,12,Saturday,Winter,1,Mid-Day,668,264,404
2012-10-27,13,Saturday,Winter,1,Mid-Day,760,310,450
2012-10-27,14,Saturday,Winter,1,Mid-Day,750,325,425
2012-10-27,15,Saturday,Winter,2,Mid-Day,711,310,401
2012-10-27,16,Saturday,Winter,2,Evening Rush,612,257,355
2012-10-27,17,Saturday,Winter,2,Evening Rush,618,248,370
2012-10-27,18,Saturday,Winter,2,Evening Rush,456,138,318
2012-10-27,19,Saturday,Winter,2,Evening Rush,300,67,233
2012-10-27,20,Saturday,Winter,2,Night,296,58,238
2012-10-27,21,Saturday,Winter,2,Night,209,49,160
2012-10-27,22,Saturday,Winter,2,Night,157,41,116
2012-10-27,23,Saturday,Winter,2,Night,167,31,136
2012-10-28,0,Sunday,Winter,3,Early Morning,117,20,97
2012-10-28,1,Sunday,Winter,2,Early Morning,133,22,111
2012-10-28,2,Sunday,Winter,2,Early Morning,116,17,99
2012-10-28,3,Sunday,Winter,2,Early Morning,79,18,61
2012-10-28,4,Sunday,Winter,2,Early Morning,20,1,19
2012-10-28,5,Sunday,Winter,2,Early Morning,28,6,22
2012-10-28,6,Sunday,Winter,2,Morning Rush,39,7,32
2012-10-28,7,Sunday,Winter,2,Morning Rush,65,17,48
2012-10-28,8,Sunday,Winter,2,Morning Rush,173,55,118
2012-10-28,9,Sunday,Winter,2,Morning Rush,330,124,206
2012-10-28,10,Sunday,Winter,2,Mid-Day,434,120,314
2012-10-28,11,Sunday,Winter,2,Mid-Day,462,110,352
2012-10-28,12,Sunday,Winter,2,Mid-Day,491,118,373
2012-10-28,13,Sunday,Winter,2,Mid-Day,391,75,316
2012-10-28,14,Sunday,Winter,2,Mid-Day,402,98,304
2012-10-28,15,Sunday,Winter,2,Mid-Day,301,76,225
2012-10-28,16,Sunday,Winter,3,Evening Rush,293,42,251
2012-10-28,17,Sunday,Winter,3,Evening Rush,225,37,188
2012-10-28,18,Sunday,Winter,3,Evening Rush,154,18,136
2012-10-28,19,Sunday,Winter,3,Evening Rush,54,7,47
2012-10-28,20,Sunday,Winter,3,Night,55,4,51
2012-10-28,21,Sunday,Winter,3,Night,46,2,44
2012-10-28,22,Sunday,Winter,3,Night,37,2,35
2012-10-28,23,Sunday,Winter,3,Night,14,2,12
2012-10-29,0,Monday,Winter,3,Early Morning,22,2,20
2012-10-30,13,Tuesday,Winter,3,Mid-Day,116,11,105
2012-10-30,14,Tuesday,Winter,3,Mid-Day,126,8,118
2012-10-30,15,Tuesday,Winter,3,Mid-Day,124,10,114
2012-10-30,16,Tuesday,Winter,3,Evening Rush,98,15,83
2012-10-30,17,Tuesday,Winter,3,Evening Rush,124,19,105
2012-10-30,18,Tuesday,Winter,3,Evening Rush,143,4,139
2012-10-30,19,Tuesday,Winter,2,Evening Rush,115,6,109
2012-10-30,20,Tuesday,Winter,2,Night,81,5,76
2012-10-30,21,Tuesday,Winter,2,Night,64,4,60
2012-10-30,22,Tuesday,Winter,1,Night,66,2,64
2012-10-30,23,Tuesday,Winter,1,Night,39,3,36
2012-10-31,0,Wednesday,Winter,2,Early Morning,16,0,16
2012-10-31,1,Wednesday,Winter,2,Early Morning,8,0,8
2012-10-31,2,Wednesday,Winter,2,Early Morning,7,0,7
2012-10-31,3,Wednesday,Winter,2,Early Morning,3,0,3
2012-10-31,4,Wednesday,Winter,2,Early Morning,5,0,5
2012-10-31,5,Wednesday,Winter,2,Early Morning,24,0,24
2012-10-31,6,Wednesday,Winter,1,Morning Rush,116,0,116
2012-10-31,7,Wednesday,Winter,2,Morning Rush,337,3,334
2012-10-31,8,Wednesday,Winter,1,Morning Rush,621,6,615
2012-10-31,9,Wednesday,Winter,1,Morning Rush,297,17,280
2012-10-31,10,Wednesday,Winter,1,Mid-Day,168,21,147
2012-10-31,11,Wednesday,Winter,2,Mid-Day,189,37,152
2012-10-31,12,Wednesday,Winter,1,Mid-Day,241,44,197
2012-10-31,13,Wednesday,Winter,1,Mid-Day,213,22,191
2012-10-31,14,Wednesday,Winter,2,Mid-Day,224,45,179
2012-10-31,15,Wednesday,Winter,1,Mid-Day,230,33,197
2012-10-31,16,Wednesday,Winter,2,Evening Rush,424,51,373
2012-10-31,17,Wednesday,Winter,2,Evening Rush,723,39,684
2012-10-31,18,Wednesday,Winter,2,Evening Rush,584,28,556
2012-10-31,19,Wednesday,Winter,2,Evening Rush,410,27,383
2012-10-31,20,Wednesday,Winter,2,Night,268,9,259
2012-10-31,21,Wednesday,Winter,2,Night,192,12,180
2012-10-31,22,Wednesday,Winter,1,Night,165,18,147
2012-10-31,23,Wednesday,Winter,1,Night,101,7,94
2012-11-01,0,Thursday,Winter,1,Early Morning,60,8,52
2012-11-01,1,Thursday,Winter,1,Early Morning,30,8,22
2012-11-01,2,Thursday,Winter,1,Early Morning,20,10,10
2012-11-01,3,Thursday,Winter,1,Early Morning,15,5,10
2012-11-01,4,Thursday,Winter,2,Early Morning,10,2,8
2012-11-01,5,Thursday,Winter,1,Early Morning,40,1,39
2012-11-01,6,Thursday,Winter,1,Morning Rush,148,2,146
2012-11-01,7,Thursday,Winter,2,Morning Rush,420,6,414
2012-11-01,8,Thursday,Winter,2,Morning Rush,680,12,668
2012-11-01,9,Thursday,Winter,3,Morning Rush,331,21,310
2012-11-01,10,Thursday,Winter,3,Mid-Day,146,13,133
2012-11-01,11,Thursday,Winter,3,Mid-Day,170,14,156
2012-11-01,12,Thursday,Winter,3,Mid-Day,221,23,198
2012-11-01,13,Thursday,Winter,2,Mid-Day,248,49,199
2012-11-01,14,Thursday,Winter,2,Mid-Day,185,31,154
2012-11-01,15,Thursday,Winter,2,Mid-Day,214,35,179
2012-11-01,16,Thursday,Winter,2,Evening Rush,344,31,313
2012-11-01,17,Thursday,Winter,3,Evening Rush,689,37,652
2012-11-01,18,Thursday,Winter,2,Evening Rush,678,50,628
2012-11-01,19,Thursday,Winter,2,Evening Rush,452,28,424
2012-11-01,20,Thursday,Winter,2,Night,296,16,280
2012-11-01,21,Thursday,Winter,2,Night,267,29,238
2012-11-01,22,Thursday,Winter,1,Night,202,27,175
2012-11-01,23,Thursday,Winter,1,Night,120,8,112
2012-11-02,0,Friday,Winter,1,Early Morning,50,10,40
2012-11-02,1,Friday,Winter,1,Early Morning,24,5,19
2012-11-02,2,Friday,Winter,1,Early Morning,10,3,7
2012-11-02,3,Friday,Winter,1,Early Morning,3,0,3
2012-11-02,4,Friday,Winter,1,Early Morning,7,1,6
2012-11-02,5,Friday,Winter,2,Early Morning,26,1,25
2012-11-02,6,Friday,Winter,1,Morning Rush,122,2,120
2012-11-02,7,Friday,Winter,2,Morning Rush,357,8,349
2012-11-02,8,Friday,Winter,1,Morning Rush,687,31,656
2012-11-02,9,Friday,Winter,1,Morning Rush,382,27,355
2012-11-02,10,Friday,Winter,1,Mid-Day,204,21,183
2012-11-02,11,Friday,Winter,1,Mid-Day,221,42,179
2012-11-02,12,Friday,Winter,1,Mid-Day,292,52,240
2012-11-02,13,Friday,Winter,1,Mid-Day,294,64,230
2012-11-02,14,Friday,Winter,2,Mid-Day,262,63,199
2012-11-02,15,Friday,Winter,2,Mid-Day,306,51,255
2012-11-02,16,Friday,Winter,1,Evening Rush,421,48,373
2012-11-02,17,Friday,Winter,1,Evening Rush,638,57,581
2012-11-02,18,Friday,Winter,2,Evening Rush,522,32,490
2012-11-02,19,Friday,Winter,2,Evening Rush,374,38,336
2012-11-02,20,Friday,Winter,2,Night,221,14,207
2012-11-02,21,Friday,Winter,2,Night,156,23,133
2012-11-02,22,Friday,Winter,1,Night,149,14,135
2012-11-02,23,Friday,Winter,1,Night,119,11,108
2012-11-03,0,Saturday,Winter,1,Early Morning,108,9,99
2012-11-03,1,Saturday,Winter,2,Early Morning,89,6,83
2012-11-03,2,Saturday,Winter,2,Early Morning,46,10,36
2012-11-03,3,Saturday,Winter,2,Early Morning,28,6,22
2012-11-03,4,Saturday,Winter,2,Early Morning,16,8,8
2012-11-03,5,Saturday,Winter,2,Early Morning,9,1,8
2012-11-03,6,Saturday,Winter,2,Morning Rush,21,4,17
2012-11-03,7,Saturday,Winter,2,Morning Rush,59,1,58
2012-11-03,8,Saturday,Winter,2,Morning Rush,142,10,132
2012-11-03,9,Saturday,Winter,2,Morning Rush,219,31,188
2012-11-03,10,Saturday,Winter,1,Mid-Day,328,68,260
2012-11-03,11,Saturday,Winter,2,Mid-Day,340,56,284
2012-11-03,12,Saturday,Winter,2,Mid-Day,394,74,320
2012-11-03,13,Saturday,Winter,2,Mid-Day,449,110,339
2012-11-03,14,Saturday,Winter,2,Mid-Day,455,136,319
2012-11-03,15,Saturday,Winter,2,Mid-Day,448,117,331
2012-11-03,16,Saturday,Winter,2,Evening Rush,400,108,292
2012-11-03,17,Saturday,Winter,2,Evening Rush,410,112,298
2012-11-03,18,Saturday,Winter,2,Evening Rush,297,58,239
2012-11-03,19,Saturday,Winter,1,Evening Rush,239,22,217
2012-11-03,20,Saturday,Winter,1,Night,181,23,158
2012-11-03,21,Saturday,Winter,1,Night,166,31,135
2012-11-03,22,Saturday,Winter,1,Night,146,13,133
2012-11-03,23,Saturday,Winter,1,Night,148,15,133
2012-11-04,0,Sunday,Winter,1,Early Morning,102,5,97
2012-11-04,1,Sunday,Winter,1,Early Morning,165,26,139
2012-11-04,2,Sunday,Winter,1,Early Morning,37,6,31
2012-11-04,3,Sunday,Winter,1,Early Morning,11,1,10
2012-11-04,4,Sunday,Winter,1,Early Morning,9,2,7
2012-11-04,5,Sunday,Winter,1,Early Morning,5,0,5
2012-11-04,6,Sunday,Winter,1,Morning Rush,16,2,14
2012-11-04,7,Sunday,Winter,1,Morning Rush,50,11,39
2012-11-04,8,Sunday,Winter,1,Morning Rush,149,34,115
2012-11-04,9,Sunday,Winter,1,Morning Rush,217,56,161
2012-11-04,10,Sunday,Winter,1,Mid-Day,360,73,287
2012-11-04,11,Sunday,Winter,1,Mid-Day,445,134,311
2012-11-04,12,Sunday,Winter,1,Mid-Day,504,150,354
2012-11-04,13,Sunday,Winter,1,Mid-Day,493,122,371
2012-11-04,14,Sunday,Winter,1,Mid-Day,509,149,360
2012-11-04,15,Sunday,Winter,1,Mid-Day,449,149,300
2012-11-04,16,Sunday,Winter,1,Evening Rush,435,119,316
2012-11-04,17,Sunday,Winter,1,Evening Rush,327,57,270
2012-11-04,18,Sunday,Winter,1,Evening Rush,237,31,206
2012-11-04,19,Sunday,Winter,1,Evening Rush,227,24,203
2012-11-04,20,Sunday,Winter,1,Night,141,7,134
2012-11-04,21,Sunday,Winter,1,Night,87,16,71
2012-11-04,22,Sunday,Winter,1,Night,79,15,64
2012-11-04,23,Sunday,Winter,2,Night,53,12,41
2012-11-05,0,Monday,Winter,2,Early Morning,23,3,20
2012-11-05,1,Monday,Winter,2,Early Morning,8,0,8
2012-11-05,2,Monday,Winter,2,Early Morning,6,2,4
2012-11-05,3,Monday,Winter,2,Early Morning,4,1,3
2012-11-05,4,Monday,Winter,2,Early Morning,16,5,11
2012-11-05,5,Monday,Winter,2,Early Morning,39,1,38
2012-11-05,6,Monday,Winter,2,Morning Rush,139,4,135
2012-11-05,7,Monday,Winter,2,Morning Rush,461,8,453
2012-11-05,8,Monday,Winter,2,Morning Rush,648,19,629
2012-11-05,9,Monday,Winter,2,Morning Rush,257,18,239
2012-11-05,10,Monday,Winter,1,Mid-Day,142,30,112
2012-11-05,11,Monday,Winter,1,Mid-Day,150,31,119
2012-11-05,12,Monday,Winter,1,Mid-Day,244,38,206
2012-11-05,13,Monday,Winter,1,Mid-Day,222,39,183
2012-11-05,14,Monday,Winter,1,Mid-Day,196,31,165
2012-11-05,15,Monday,Winter,1,Mid-Day,231,24,207
2012-11-05,16,Monday,Winter,1,Evening Rush,360,35,325
2012-11-05,17,Monday,Winter,1,Evening Rush,638,34,604
2012-11-05,18,Monday,Winter,1,Evening Rush,542,19,523
2012-11-05,19,Monday,Winter,1,Evening Rush,372,11,361
2012-11-05,20,Monday,Winter,1,Night,241,13,228
2012-11-05,21,Monday,Winter,1,Night,152,8,144
2012-11-05,22,Monday,Winter,1,Night,115,4,111
2012-11-05,23,Monday,Winter,1,Night,53,0,53
2012-11-06,0,Tuesday,Winter,1,Early Morning,19,1,18
2012-11-06,1,Tuesday,Winter,1,Early Morning,8,0,8
2012-11-06,2,Tuesday,Winter,1,Early Morning,2,0,2
2012-11-06,3,Tuesday,Winter,1,Early Morning,4,0,4
2012-11-06,4,Tuesday,Winter,1,Early Morning,7,0,7
2012-11-06,5,Tuesday,Winter,2,Early Morning,41,1,40
2012-11-06,6,Tuesday,Winter,1,Morning Rush,149,6,143
2012-11-06,7,Tuesday,Winter,1,Morning Rush,387,9,378
2012-11-06,8,Tuesday,Winter,1,Morning Rush,588,20,568
2012-11-06,9,Tuesday,Winter,1,Morning Rush,363,25,338
2012-11-06,10,Tuesday,Winter,1,Mid-Day,230,41,189
2012-11-06,11,Tuesday,Winter,1,Mid-Day,216,39,177
2012-11-06,12,Tuesday,Winter,1,Mid-Day,248,31,217
2012-11-06,13,Tuesday,Winter,1,Mid-Day,278,46,232
2012-11-06,14,Tuesday,Winter,1,Mid-Day,240,44,196
2012-11-06,15,Tuesday,Winter,1,Mid-Day,272,45,227
2012-11-06,16,Tuesday,Winter,1,Evening Rush,402,33,369
2012-11-06,17,Tuesday,Winter,1,Evening Rush,627,30,597
2012-11-06,18,Tuesday,Winter,1,Evening Rush,497,20,477
2012-11-06,19,Tuesday,Winter,1,Evening Rush,371,15,356
2012-11-06,20,Tuesday,Winter,1,Night,228,10,218
2012-11-06,21,Tuesday,Winter,2,Night,151,14,137
2012-11-06,22,Tuesday,Winter,2,Night,153,17,136
2012-11-06,23,Tuesday,Winter,1,Night,205,19,186
2012-11-07,0,Wednesday,Winter,2,Early Morning,283,49,234
2012-11-07,1,Wednesday,Winter,2,Early Morning,92,6,86
2012-11-07,2,Wednesday,Winter,2,Early Morning,74,6,68
2012-11-07,3,Wednesday,Winter,2,Early Morning,11,2,9
2012-11-07,4,Wednesday,Winter,2,Early Morning,9,0,9
2012-11-07,5,Wednesday,Winter,2,Early Morning,27,0,27
2012-11-07,6,Wednesday,Winter,2,Morning Rush,118,3,115
2012-11-07,7,Wednesday,Winter,2,Morning Rush,319,5,314
2012-11-07,8,Wednesday,Winter,2,Morning Rush,601,18,583
2012-11-07,9,Wednesday,Winter,2,Morning Rush,368,17,351
2012-11-07,10,Wednesday,Winter,2,Mid-Day,178,27,151
2012-11-07,11,Wednesday,Winter,2,Mid-Day,147,15,132
2012-11-07,12,Wednesday,Winter,2,Mid-Day,212,24,188
2012-11-07,13,Wednesday,Winter,2,Mid-Day,181,23,158
2012-11-07,14,Wednesday,Winter,2,Mid-Day,161,19,142
2012-11-07,15,Wednesday,Winter,2,Mid-Day,198,20,178
2012-11-07,16,Wednesday,Winter,2,Evening Rush,273,23,250
2012-11-07,17,Wednesday,Winter,2,Evening Rush,517,16,501
2012-11-07,18,Wednesday,Winter,2,Evening Rush,465,17,448
2012-11-07,19,Wednesday,Winter,2,Evening Rush,319,17,302
2012-11-07,20,Wednesday,Winter,2,Night,256,7,249
2012-11-07,21,Wednesday,Winter,2,Night,126,5,121
2012-11-07,22,Wednesday,Winter,3,Night,60,4,56
2012-11-07,23,Wednesday,Winter,3,Night,40,3,37
2012-11-08,0,Thursday,Winter,3,Early Morning,15,1,14
2012-11-08,1,Thursday,Winter,3,Early Morning,12,1,11
2012-11-08,2,Thursday,Winter,2,Early Morning,6,1,5
2012-11-08,4,Thursday,Winter,2,Early Morning,10,1,9
2012-11-08,5,Thursday,Winter,2,Early Morning,35,0,35
2012-11-08,6,Thursday,Winter,1,Morning Rush,124,2,122
2012-11-08,7,Thursday,Winter,1,Morning Rush,423,12,411
2012-11-08,8,Thursday,Winter,1,Morning Rush,668,16,652
2012-11-08,9,Thursday,Winter,1,Morning Rush,275,22,253
2012-11-08,10,Thursday,Winter,1,Mid-Day,161,13,148
2012-11-08,11,Thursday,Winter,1,Mid-Day,171,16,155
2012-11-08,12,Thursday,Winter,1,Mid-Day,235,33,202
2012-11-08,13,Thursday,Winter,1,Mid-Day,228,33,195
2012-11-08,14,Thursday,Winter,1,Mid-Day,182,33,149
2012-11-08,15,Thursday,Winter,1,Mid-Day,233,32,201
2012-11-08,16,Thursday,Winter,1,Evening Rush,339,18,321
2012-11-08,17,Thursday,Winter,1,Evening Rush,592,36,556
2012-11-08,18,Thursday,Winter,1,Evening Rush,507,16,491
2012-11-08,19,Thursday,Winter,1,Evening Rush,373,14,359
2012-11-08,20,Thursday,Winter,1,Night,245,10,235
2012-11-08,21,Thursday,Winter,1,Night,233,11,222
2012-11-08,22,Thursday,Winter,1,Night,161,14,147
2012-11-08,23,Thursday,Winter,1,Night,87,5,82
2012-11-09,0,Friday,Winter,1,Early Morning,55,9,46
2012-11-09,1,Friday,Winter,1,Early Morning,20,3,17
2012-11-09,2,Friday,Winter,1,Early Morning,12,1,11
2012-11-09,3,Friday,Winter,1,Early Morning,9,3,6
2012-11-09,4,Friday,Winter,1,Early Morning,14,0,14
2012-11-09,5,Friday,Winter,1,Early Morning,27,2,25
2012-11-09,6,Friday,Winter,1,Morning Rush,131,5,126
2012-11-09,7,Friday,Winter,1,Morning Rush,341,9,332
2012-11-09,8,Friday,Winter,1,Morning Rush,693,25,668
2012-11-09,9,Friday,Winter,1,Morning Rush,327,23,304
2012-11-09,10,Friday,Winter,1,Mid-Day,197,34,163
2012-11-09,11,Friday,Winter,1,Mid-Day,251,66,185
2012-11-09,12,Friday,Winter,1,Mid-Day,262,48,214
2012-11-09,13,Friday,Winter,1,Mid-Day,299,62,237
2012-11-09,14,Friday,Winter,1,Mid-Day,274,67,207
2012-11-09,15,Friday,Winter,1,Mid-Day,356,78,278
2012-11-09,16,Friday,Winter,1,Evening Rush,434,57,377
2012-11-09,17,Friday,Winter,1,Evening Rush,654,61,593
2012-11-09,18,Friday,Winter,1,Evening Rush,496,46,450
2012-11-09,19,Friday,Winter,1,Evening Rush,361,30,331
2012-11-09,20,Friday,Winter,1,Night,255,20,235
2012-11-09,21,Friday,Winter,1,Night,199,23,176
2012-11-09,22,Friday,Winter,1,Night,163,17,146
2012-11-09,23,Friday,Winter,1,Night,162,20,142
2012-11-10,0,Saturday,Winter,1,Early Morning,122,16,106
2012-11-10,1,Saturday,Winter,1,Early Morning,76,8,68
2012-11-10,2,Saturday,Winter,1,Early Morning,44,2,42
2012-11-10,3,Saturday,Winter,1,Early Morning,20,9,11
2012-11-10,4,Saturday,Winter,1,Early Morning,6,2,4
2012-11-10,5,Saturday,Winter,1,Early Morning,10,1,9
2012-11-10,6,Saturday,Winter,1,Morning Rush,16,5,11
2012-11-10,7,Saturday,Winter,1,Morning Rush,71,14,57
2012-11-10,8,Saturday,Winter,1,Morning Rush,146,16,130
2012-11-10,9,Saturday,Winter,1,Morning Rush,259,43,216
2012-11-10,10,Saturday,Winter,1,Mid-Day,350,86,264
2012-11-10,11,Saturday,Winter,1,Mid-Day,466,143,323
2012-11-10,12,Saturday,Winter,1,Mid-Day,606,258,348
2012-11-10,13,Saturday,Winter,1,Mid-Day,651,268,383
2012-11-10,14,Saturday,Winter,1,Mid-Day,627,280,347
2012-11-10,15,Saturday,Winter,1,Mid-Day,567,216,351
2012-11-10,16,Saturday,Winter,1,Evening Rush,605,227,378
2012-11-10,17,Saturday,Winter,1,Evening Rush,501,183,318
2012-11-10,18,Saturday,Winter,1,Evening Rush,359,103,256
2012-11-10,19,Saturday,Winter,1,Evening Rush,283,55,228
2012-11-10,20,Saturday,Winter,1,Night,192,39,153
2012-11-10,21,Saturday,Winter,1,Night,220,51,169
2012-11-10,22,Saturday,Winter,1,Night,193,39,154
2012-11-10,23,Saturday,Winter,1,Night,146,26,120
2012-11-11,0,Sunday,Winter,1,Early Morning,124,14,110
2012-11-11,1,Sunday,Winter,1,Early Morning,108,26,82
2012-11-11,2,Sunday,Winter,1,Early Morning,70,12,58
2012-11-11,3,Sunday,Winter,1,Early Morning,48,9,39
2012-11-11,4,Sunday,Winter,1,Early Morning,11,5,6
2012-11-11,5,Sunday,Winter,1,Early Morning,12,0,12
2012-11-11,6,Sunday,Winter,1,Morning Rush,19,3,16
2012-11-11,7,Sunday,Winter,1,Morning Rush,68,12,56
2012-11-11,8,Sunday,Winter,1,Morning Rush,119,32,87
2012-11-11,9,Sunday,Winter,1,Morning Rush,273,94,179
2012-11-11,10,Sunday,Winter,1,Mid-Day,405,133,272
2012-11-11,11,Sunday,Winter,1,Mid-Day,504,180,324
2012-11-11,12,Sunday,Winter,1,Mid-Day,585,195,390
2012-11-11,13,Sunday,Winter,1,Mid-Day,686,262,424
2012-11-11,14,Sunday,Winter,1,Mid-Day,654,292,362
2012-11-11,15,Sunday,Winter,1,Mid-Day,724,304,420
2012-11-11,16,Sunday,Winter,1,Evening Rush,653,260,393
2012-11-11,17,Sunday,Winter,1,Evening Rush,493,151,342
2012-11-11,18,Sunday,Winter,1,Evening Rush,405,102,303
2012-11-11,19,Sunday,Winter,1,Evening Rush,277,69,208
2012-11-11,20,Sunday,Winter,1,Night,200,54,146
2012-11-11,21,Sunday,Winter,1,Night,171,44,127
2012-11-11,22,Sunday,Winter,1,Night,134,21,113
2012-11-11,23,Sunday,Winter,1,Night,109,16,93
2012-11-12,0,Monday,Winter,1,Early Morning,49,6,43
2012-11-12,1,Monday,Winter,1,Early Morning,30,4,26
2012-11-12,2,Monday,Winter,1,Early Morning,20,6,14
2012-11-12,3,Monday,Winter,1,Early Morning,4,1,3
2012-11-12,4,Monday,Winter,1,Early Morning,4,1,3
2012-11-12,5,Monday,Winter,1,Early Morning,24,1,23
2012-11-12,6,Monday,Winter,1,Morning Rush,71,7,64
2012-11-12,7,Monday,Winter,1,Morning Rush,264,16,248
2012-11-12,8,Monday,Winter,1,Morning Rush,540,50,490
2012-11-12,9,Monday,Winter,1,Morning Rush,397,60,337
2012-11-12,10,Monday,Winter,1,Mid-Day,266,82,184
2012-11-12,11,Monday,Winter,1,Mid-Day,367,112,255
2012-11-12,12,Monday,Winter,1,Mid-Day,419,105,314
2012-11-12,13,Monday,Winter,1,Mid-Day,420,108,312
2012-11-12,14,Monday,Winter,1,Mid-Day,444,134,310
2012-11-12,15,Monday,Winter,1,Mid-Day,382,102,280
2012-11-12,16,Monday,Winter,1,Evening Rush,434,87,347
2012-11-12,17,Monday,Winter,1,Evening Rush,596,66,530
2012-11-12,18,Monday,Winter,1,Evening Rush,551,65,486
2012-11-12,19,Monday,Winter,1,Evening Rush,353,30,323
2012-11-12,20,Monday,Winter,2,Night,304,31,273
2012-11-12,21,Monday,Winter,3,Night,155,10,145
2012-11-12,22,Monday,Winter,1,Night,112,12,100
2012-11-12,23,Monday,Winter,2,Night,63,1,62
2012-11-13,0,Tuesday,Winter,2,Early Morning,23,5,18
2012-11-13,1,Tuesday,Winter,3,Early Morning,5,0,5
2012-11-13,2,Tuesday,Winter,3,Early Morning,11,7,4
2012-11-13,3,Tuesday,Winter,3,Early Morning,5,2,3
2012-11-13,4,Tuesday,Winter,2,Early Morning,9,0,9
2012-11-13,5,Tuesday,Winter,2,Early Morning,18,0,18
2012-11-13,6,Tuesday,Winter,3,Morning Rush,50,2,48
2012-11-13,7,Tuesday,Winter,3,Morning Rush,107,1,106
2012-11-13,8,Tuesday,Winter,3,Morning Rush,211,4,207
2012-11-13,9,Tuesday,Winter,3,Morning Rush,110,1,109
2012-11-13,10,Tuesday,Winter,3,Mid-Day,94,10,84
2012-11-13,11,Tuesday,Winter,1,Mid-Day,155,22,133
2012-11-13,12,Tuesday,Winter,1,Mid-Day,196,16,180
2012-11-13,13,Tuesday,Winter,1,Mid-Day,218,30,188
2012-11-13,14,Tuesday,Winter,1,Mid-Day,203,34,169
2012-11-13,15,Tuesday,Winter,1,Mid-Day,217,33,184
2012-11-13,16,Tuesday,Winter,1,Evening Rush,310,28,282
2012-11-13,17,Tuesday,Winter,1,Evening Rush,608,33,575
2012-11-13,18,Tuesday,Winter,1,Evening Rush,559,45,514
2012-11-13,19,Tuesday,Winter,1,Evening Rush,356,12,344
2012-11-13,20,Tuesday,Winter,1,Night,223,12,211
2012-11-13,21,Tuesday,Winter,1,Night,187,9,178
2012-11-13,22,Tuesday,Winter,1,Night,135,15,120
2012-11-13,23,Tuesday,Winter,1,Night,84,6,78
2012-11-14,0,Wednesday,Winter,1,Early Morning,24,4,20
2012-11-14,1,Wednesday,Winter,1,Early Morning,12,2,10
2012-11-14,2,Wednesday,Winter,1,Early Morning,1,0,1
2012-11-14,3,Wednesday,Winter,1,Early Morning,5,0,5
2012-11-14,4,Wednesday,Winter,1,Early Morning,6,0,6
2012-11-14,5,Wednesday,Winter,1,Early Morning,39,0,39
2012-11-14,6,Wednesday,Winter,1,Morning Rush,146,4,142
2012-11-14,7,Wednesday,Winter,1,Morning Rush,415,10,405
2012-11-14,8,Wednesday,Winter,1,Morning Rush,691,27,664
2012-11-14,9,Wednesday,Winter,1,Morning Rush,332,22,310
2012-11-14,10,Wednesday,Winter,1,Mid-Day,171,18,153
2012-11-14,11,Wednesday,Winter,1,Mid-Day,151,25,126
2012-11-14,12,Wednesday,Winter,1,Mid-Day,240,40,200
2012-11-14,13,Wednesday,Winter,1,Mid-Day,214,32,182
2012-11-14,14,Wednesday,Winter,1,Mid-Day,181,20,161
2012-11-14,15,Wednesday,Winter,1,Mid-Day,260,32,228
2012-11-14,16,Wednesday,Winter,1,Evening Rush,321,31,290
2012-11-14,17,Wednesday,Winter,1,Evening Rush,583,19,564
2012-11-14,18,Wednesday,Winter,1,Evening Rush,567,24,543
2012-11-14,19,Wednesday,Winter,1,Evening Rush,396,28,368
2012-11-14,20,Wednesday,Winter,1,Night,267,15,252
2012-11-14,21,Wednesday,Winter,1,Night,213,5,208
2012-11-14,22,Wednesday,Winter,1,Night,173,6,167
2012-11-14,23,Wednesday,Winter,1,Night,87,9,78
2012-11-15,0,Thursday,Winter,2,Early Morning,34,1,33
2012-11-15,1,Thursday,Winter,2,Early Morning,16,2,14
2012-11-15,2,Thursday,Winter,2,Early Morning,7,0,7
2012-11-15,3,Thursday,Winter,2,Early Morning,2,0,2
2012-11-15,4,Thursday,Winter,2,Early Morning,5,0,5
2012-11-15,5,Thursday,Winter,2,Early Morning,37,3,34
2012-11-15,6,Thursday,Winter,2,Morning Rush,147,1,146
2012-11-15,7,Thursday,Winter,2,Morning Rush,410,7,403
2012-11-15,8,Thursday,Winter,2,Morning Rush,646,21,625
2012-11-15,9,Thursday,Winter,2,Morning Rush,323,17,306
2012-11-15,10,Thursday,Winter,2,Mid-Day,153,11,142
2012-11-15,11,Thursday,Winter,2,Mid-Day,166,28,138
2012-11-15,12,Thursday,Winter,2,Mid-Day,213,29,184
2012-11-15,13,Thursday,Winter,2,Mid-Day,217,20,197
2012-11-15,14,Thursday,Winter,2,Mid-Day,201,27,174
2012-11-15,15,Thursday,Winter,2,Mid-Day,217,26,191
2012-11-15,16,Thursday,Winter,2,Evening Rush,342,24,318
2012-11-15,17,Thursday,Winter,2,Evening Rush,563,22,541
2012-11-15,18,Thursday,Winter,2,Evening Rush,573,10,563
2012-11-15,19,Thursday,Winter,2,Evening Rush,386,11,375
2012-11-15,20,Thursday,Winter,1,Night,285,23,262
2012-11-15,21,Thursday,Winter,2,Night,224,20,204
2012-11-15,22,Thursday,Winter,2,Night,153,10,143
2012-11-15,23,Thursday,Winter,2,Night,125,7,118
2012-11-16,0,Friday,Winter,2,Early Morning,65,7,58
2012-11-16,1,Friday,Winter,2,Early Morning,21,5,16
2012-11-16,2,Friday,Winter,2,Early Morning,9,0,9
2012-11-16,3,Friday,Winter,2,Early Morning,6,0,6
2012-11-16,4,Friday,Winter,2,Early Morning,5,0,5
2012-11-16,5,Friday,Winter,2,Early Morning,36,2,34
2012-11-16,6,Friday,Winter,2,Morning Rush,130,4,126
2012-11-16,7,Friday,Winter,2,Morning Rush,367,5,362
2012-11-16,8,Friday,Winter,2,Morning Rush,711,17,694
2012-11-16,9,Friday,Winter,1,Morning Rush,351,21,330
2012-11-16,10,Friday,Winter,1,Mid-Day,198,33,165
2012-11-16,11,Friday,Winter,1,Mid-Day,218,33,185
2012-11-16,12,Friday,Winter,1,Mid-Day,290,28,262
2012-11-16,13,Friday,Winter,1,Mid-Day,278,52,226
2012-11-16,14,Friday,Winter,1,Mid-Day,251,47,204
2012-11-16,15,Friday,Winter,1,Mid-Day,267,30,237
2012-11-16,16,Friday,Winter,1,Evening Rush,383,33,350
2012-11-16,17,Friday,Winter,1,Evening Rush,580,41,539
2012-11-16,18,Friday,Winter,1,Evening Rush,505,22,483
2012-11-16,19,Friday,Winter,1,Evening Rush,332,26,306
2012-11-16,20,Friday,Winter,1,Night,227,20,207
2012-11-16,21,Friday,Winter,1,Night,178,21,157
2012-11-16,22,Friday,Winter,1,Night,162,23,139
2012-11-16,23,Friday,Winter,1,Night,128,14,114
2012-11-17,0,Saturday,Winter,1,Early Morning,106,11,95
2012-11-17,1,Saturday,Winter,1,Early Morning,87,13,74
2012-11-17,2,Saturday,Winter,1,Early Morning,49,8,41
2012-11-17,3,Saturday,Winter,1,Early Morning,21,2,19
2012-11-17,4,Saturday,Winter,1,Early Morning,7,1,6
2012-11-17,5,Saturday,Winter,1,Early Morning,11,1,10
2012-11-17,6,Saturday,Winter,1,Morning Rush,21,0,21
2012-11-17,7,Saturday,Winter,1,Morning Rush,78,8,70
2012-11-17,8,Saturday,Winter,1,Morning Rush,168,30,138
2012-11-17,9,Saturday,Winter,1,Morning Rush,248,48,200
2012-11-17,10,Saturday,Winter,1,Mid-Day,320,62,258
2012-11-17,11,Saturday,Winter,1,Mid-Day,423,80,343
2012-11-17,12,Saturday,Winter,1,Mid-Day,476,117,359
2012-11-17,13,Saturday,Winter,1,Mid-Day,525,179,346
2012-11-17,14,Saturday,Winter,1,Mid-Day,555,175,380
2012-11-17,15,Saturday,Winter,1,Mid-Day,549,175,374
2012-11-17,16,Saturday,Winter,1,Evening Rush,469,144,325
2012-11-17,17,Saturday,Winter,1,Evening Rush,403,101,302
2012-11-17,18,Saturday,Winter,1,Evening Rush,271,34,237
2012-11-17,19,Saturday,Winter,1,Evening Rush,253,45,208
2012-11-17,20,Saturday,Winter,2,Night,172,30,142
2012-11-17,21,Saturday,Winter,2,Night,139,15,124
2012-11-17,22,Saturday,Winter,2,Night,145,15,130
2012-11-17,23,Saturday,Winter,2,Night,133,19,114
2012-11-18,0,Sunday,Winter,2,Early Morning,129,11,118
2012-11-18,1,Sunday,Winter,1,Early Morning,95,14,81
2012-11-18,2,Sunday,Winter,1,Early Morning,73,8,65
2012-11-18,3,Sunday,Winter,2,Early Morning,46,9,37
2012-11-18,4,Sunday,Winter,2,Early Morning,12,4,8
2012-11-18,5,Sunday,Winter,1,Early Morning,12,5,7
2012-11-18,6,Sunday,Winter,1,Morning Rush,15,2,13
2012-11-18,7,Sunday,Winter,1,Morning Rush,42,3,39
2012-11-18,8,Sunday,Winter,1,Morning Rush,119,19,100
2012-11-18,9,Sunday,Winter,1,Morning Rush,204,49,155
2012-11-18,10,Sunday,Winter,1,Mid-Day,329,79,250
2012-11-18,11,Sunday,Winter,1,Mid-Day,359,92,267
2012-11-18,12,Sunday,Winter,1,Mid-Day,442,101,341
2012-11-18,13,Sunday,Winter,1,Mid-Day,447,113,334
2012-11-18,14,Sunday,Winter,1,Mid-Day,428,125,303
2012-11-18,15,Sunday,Winter,1,Mid-Day,407,89,318
2012-11-18,16,Sunday,Winter,2,Evening Rush,372,59,313
2012-11-18,17,Sunday,Winter,2,Evening Rush,280,48,232
2012-11-18,18,Sunday,Winter,1,Evening Rush,276,36,240
2012-11-18,19,Sunday,Winter,1,Evening Rush,210,16,194
2012-11-18,20,Sunday,Winter,1,Night,129,9,120
2012-11-18,21,Sunday,Winter,1,Night,110,17,93
2012-11-18,22,Sunday,Winter,2,Night,74,8,66
2012-11-18,23,Sunday,Winter,1,Night,59,6,53
2012-11-19,0,Monday,Winter,1,Early Morning,27,5,22
2012-11-19,1,Monday,Winter,2,Early Morning,19,0,19
2012-11-19,2,Monday,Winter,2,Early Morning,5,0,5
2012-11-19,3,Monday,Winter,2,Early Morning,2,0,2
2012-11-19,4,Monday,Winter,2,Early Morning,12,1,11
2012-11-19,5,Monday,Winter,2,Early Morning,39,1,38
2012-11-19,6,Monday,Winter,2,Morning Rush,131,3,128
2012-11-19,7,Monday,Winter,2,Morning Rush,386,5,381
2012-11-19,8,Monday,Winter,2,Morning Rush,663,13,650
2012-11-19,9,Monday,Winter,2,Morning Rush,278,18,260
2012-11-19,10,Monday,Winter,2,Mid-Day,139,33,106
2012-11-19,11,Monday,Winter,2,Mid-Day,197,33,164
2012-11-19,12,Monday,Winter,2,Mid-Day,242,35,207
2012-11-19,13,Monday,Winter,1,Mid-Day,251,46,205
2012-11-19,14,Monday,Winter,1,Mid-Day,217,47,170
2012-11-19,15,Monday,Winter,1,Mid-Day,257,44,213
2012-11-19,16,Monday,Winter,1,Evening Rush,380,55,325
2012-11-19,17,Monday,Winter,2,Evening Rush,619,33,586
2012-11-19,18,Monday,Winter,2,Evening Rush,580,21,559
2012-11-19,19,Monday,Winter,2,Evening Rush,406,25,381
2012-11-19,20,Monday,Winter,2,Night,259,7,252
2012-11-19,21,Monday,Winter,2,Night,203,15,188
2012-11-19,22,Monday,Winter,1,Night,113,7,106
2012-11-19,23,Monday,Winter,1,Night,74,2,72
2012-11-20,0,Tuesday,Winter,1,Early Morning,29,3,26
2012-11-20,1,Tuesday,Winter,1,Early Morning,13,3,10
2012-11-20,2,Tuesday,Winter,2,Early Morning,5,0,5
2012-11-20,3,Tuesday,Winter,2,Early Morning,2,0,2
2012-11-20,4,Tuesday,Winter,2,Early Morning,6,0,6
2012-11-20,5,Tuesday,Winter,2,Early Morning,34,2,32
2012-11-20,6,Tuesday,Winter,2,Morning Rush,148,2,146
2012-11-20,7,Tuesday,Winter,1,Morning Rush,418,7,411
2012-11-20,8,Tuesday,Winter,1,Morning Rush,665,16,649
2012-11-20,9,Tuesday,Winter,2,Morning Rush,326,28,298
2012-11-20,10,Tuesday,Winter,2,Mid-Day,176,32,144
2012-11-20,11,Tuesday,Winter,2,Mid-Day,205,45,160
2012-11-20,12,Tuesday,Winter,2,Mid-Day,313,70,243
2012-11-20,13,Tuesday,Winter,2,Mid-Day,267,49,218
2012-11-20,14,Tuesday,Winter,2,Mid-Day,224,47,177
2012-11-20,15,Tuesday,Winter,2,Mid-Day,287,61,226
2012-11-20,16,Tuesday,Winter,2,Evening Rush,395,60,335
2012-11-20,17,Tuesday,Winter,2,Evening Rush,590,37,553
2012-11-20,18,Tuesday,Winter,2,Evening Rush,550,16,534
2012-11-20,19,Tuesday,Winter,2,Evening Rush,384,23,361
2012-11-20,20,Tuesday,Winter,2,Night,235,11,224
2012-11-20,21,Tuesday,Winter,1,Night,157,14,143
2012-11-20,22,Tuesday,Winter,1,Night,122,7,115
2012-11-20,23,Tuesday,Winter,1,Night,83,1,82
2012-11-21,0,Wednesday,Winter,1,Early Morning,26,1,25
2012-11-21,1,Wednesday,Winter,1,Early Morning,14,1,13
2012-11-21,2,Wednesday,Winter,1,Early Morning,8,2,6
2012-11-21,3,Wednesday,Winter,1,Early Morning,2,0,2
2012-11-21,4,Wednesday,Winter,1,Early Morning,10,0,10
2012-11-21,5,Wednesday,Winter,1,Early Morning,29,1,28
2012-11-21,6,Wednesday,Winter,1,Morning Rush,101,2,99
2012-11-21,7,Wednesday,Winter,1,Morning Rush,273,11,262
2012-11-21,8,Wednesday,Winter,2,Morning Rush,551,12,539
2012-11-21,9,Wednesday,Winter,1,Morning Rush,365,45,320
2012-11-21,10,Wednesday,Winter,1,Mid-Day,172,22,150
2012-11-21,11,Wednesday,Winter,1,Mid-Day,241,43,198
2012-11-21,12,Wednesday,Winter,1,Mid-Day,344,74,270
2012-11-21,13,Wednesday,Winter,1,Mid-Day,365,70,295
2012-11-21,14,Wednesday,Winter,1,Mid-Day,413,84,329
2012-11-21,15,Wednesday,Winter,1,Mid-Day,449,68,381
2012-11-21,16,Wednesday,Winter,1,Evening Rush,469,59,410
2012-11-21,17,Wednesday,Winter,1,Evening Rush,374,41,333
2012-11-21,18,Wednesday,Winter,1,Evening Rush,311,24,287
2012-11-21,19,Wednesday,Winter,1,Evening Rush,243,23,220
2012-11-21,20,Wednesday,Winter,1,Night,136,11,125
2012-11-21,21,Wednesday,Winter,1,Night,105,8,97
2012-11-21,22,Wednesday,Winter,1,Night,88,6,82
2012-11-21,23,Wednesday,Winter,1,Night,57,7,50
2012-11-22,0,Thursday,Winter,1,Early Morning,46,3,43
2012-11-22,1,Thursday,Winter,1,Early Morning,42,5,37
2012-11-22,2,Thursday,Winter,1,Early Morning,18,3,15
2012-11-22,3,Thursday,Winter,1,Early Morning,6,0,6
2012-11-22,4,Thursday,Winter,1,Early Morning,3,1,2
2012-11-22,5,Thursday,Winter,1,Early Morning,8,2,6
2012-11-22,6,Thursday,Winter,1,Morning Rush,17,2,15
2012-11-22,7,Thursday,Winter,1,Morning Rush,56,7,49
2012-11-22,8,Thursday,Winter,1,Morning Rush,97,20,77
2012-11-22,9,Thursday,Winter,1,Morning Rush,119,25,94
2012-11-22,10,Thursday,Winter,1,Mid-Day,219,65,154
2012-11-22,11,Thursday,Winter,1,Mid-Day,232,89,143
2012-11-22,12,Thursday,Winter,1,Mid-Day,262,117,145
2012-11-22,13,Thursday,Winter,1,Mid-Day,269,125,144
2012-11-22,14,Thursday,Winter,1,Mid-Day,220,125,95
2012-11-22,15,Thursday,Winter,1,Mid-Day,228,132,96
2012-11-22,16,Thursday,Winter,1,Evening Rush,182,101,81
2012-11-22,17,Thursday,Winter,1,Evening Rush,109,66,43
2012-11-22,18,Thursday,Winter,1,Evening Rush,70,16,54
2012-11-22,19,Thursday,Winter,1,Evening Rush,44,13,31
2012-11-22,20,Thursday,Winter,1,Night,52,15,37
2012-11-22,21,Thursday,Winter,1,Night,46,7,39
2012-11-22,22,Thursday,Winter,1,Night,44,8,36
2012-11-22,23,Thursday,Winter,1,Night,36,8,28
2012-11-23,0,Friday,Winter,1,Early Morning,32,0,32
2012-11-23,1,Friday,Winter,1,Early Morning,13,2,11
2012-11-23,2,Friday,Winter,1,Early Morning,5,1,4
2012-11-23,3,Friday,Winter,1,Early Morning,1,1,0
2012-11-23,4,Friday,Winter,1,Early Morning,4,1,3
2012-11-23,5,Friday,Winter,1,Early Morning,10,0,10
2012-11-23,6,Friday,Winter,1,Morning Rush,20,0,20
2012-11-23,7,Friday,Winter,1,Morning Rush,77,5,72
2012-11-23,8,Friday,Winter,1,Morning Rush,94,11,83
2012-11-23,9,Friday,Winter,1,Morning Rush,112,32,80
2012-11-23,10,Friday,Winter,1,Mid-Day,201,87,114
2012-11-23,11,Friday,Winter,1,Mid-Day,251,121,130
2012-11-23,12,Friday,Winter,1,Mid-Day,379,186,193
2012-11-23,13,Friday,Winter,1,Mid-Day,424,224,200
2012-11-23,14,Friday,Winter,1,Mid-Day,435,240,195
2012-11-23,15,Friday,Winter,1,Mid-Day,447,233,214
2012-11-23,16,Friday,Winter,2,Evening Rush,357,158,199
2012-11-23,17,Friday,Winter,2,Evening Rush,300,117,183
2012-11-23,18,Friday,Winter,2,Evening Rush,208,50,158
2012-11-23,19,Friday,Winter,2,Evening Rush,154,33,121
2012-11-23,20,Friday,Winter,1,Night,142,42,100
2012-11-23,21,Friday,Winter,1,Night,98,23,75
2012-11-23,22,Friday,Winter,1,Night,79,16,63
2012-11-23,23,Friday,Winter,1,Night,67,20,47
2012-11-24,0,Saturday,Winter,1,Early Morning,42,9,33
2012-11-24,1,Saturday,Winter,1,Early Morning,20,1,19
2012-11-24,2,Saturday,Winter,1,Early Morning,32,10,22
2012-11-24,3,Saturday,Winter,1,Early Morning,11,6,5
2012-11-24,4,Saturday,Winter,1,Early Morning,3,1,2
2012-11-24,5,Saturday,Winter,1,Early Morning,3,1,2
2012-11-24,6,Saturday,Winter,1,Morning Rush,10,1,9
2012-11-24,7,Saturday,Winter,2,Morning Rush,25,4,21
2012-11-24,8,Saturday,Winter,2,Morning Rush,62,7,55
2012-11-24,9,Saturday,Winter,2,Morning Rush,122,26,96
2012-11-24,10,Saturday,Winter,2,Mid-Day,142,46,96
2012-11-24,11,Saturday,Winter,2,Mid-Day,186,55,131
2012-11-24,12,Saturday,Winter,2,Mid-Day,199,53,146
2012-11-24,13,Saturday,Winter,1,Mid-Day,225,64,161
2012-11-24,14,Saturday,Winter,1,Mid-Day,207,58,149
2012-11-24,15,Saturday,Winter,1,Mid-Day,198,59,139
2012-11-24,16,Saturday,Winter,1,Evening Rush,170,43,127
2012-11-24,17,Saturday,Winter,1,Evening Rush,126,29,97
2012-11-24,18,Saturday,Winter,1,Evening Rush,145,22,123
2012-11-24,19,Saturday,Winter,1,Evening Rush,83,9,74
2012-11-24,20,Saturday,Winter,1,Night,58,3,55
2012-11-24,21,Saturday,Winter,1,Night,75,9,66
2012-11-24,22,Saturday,Winter,1,Night,76,7,69
2012-11-24,23,Saturday,Winter,1,Night,57,9,48
2012-11-25,0,Sunday,Winter,1,Early Morning,34,3,31
2012-11-25,1,Sunday,Winter,1,Early Morning,36,4,32
2012-11-25,2,Sunday,Winter,1,Early Morning,28,1,27
2012-11-25,3,Sunday,Winter,1,Early Morning,8,0,8
2012-11-25,4,Sunday,Winter,1,Early Morning,2,1,1
2012-11-25,5,Sunday,Winter,2,Early Morning,3,0,3
2012-11-25,6,Sunday,Winter,2,Morning Rush,11,1,10
2012-11-25,7,Sunday,Winter,2,Morning Rush,21,2,19
2012-11-25,8,Sunday,Winter,2,Morning Rush,34,2,32
2012-11-25,9,Sunday,Winter,2,Morning Rush,96,13,83
2012-11-25,10,Sunday,Winter,1,Mid-Day,139,15,124
2012-11-25,11,Sunday,Winter,2,Mid-Day,204,49,155
2012-11-25,12,Sunday,Winter,2,Mid-Day,202,37,165
2012-11-25,13,Sunday,Winter,2,Mid-Day,195,37,158
2012-11-25,14,Sunday,Winter,2,Mid-Day,203,33,170
2012-11-25,15,Sunday,Winter,1,Mid-Day,245,36,209
2012-11-25,16,Sunday,Winter,1,Evening Rush,228,25,203
2012-11-25,17,Sunday,Winter,1,Evening Rush,181,11,170
2012-11-25,18,Sunday,Winter,1,Evening Rush,141,9,132
2012-11-25,19,Sunday,Winter,1,Evening Rush,127,13,114
2012-11-25,20,Sunday,Winter,1,Night,119,9,110
2012-11-25,21,Sunday,Winter,1,Night,64,4,60
2012-11-25,22,Sunday,Winter,1,Night,62,3,59
2012-11-25,23,Sunday,Winter,1,Night,41,1,40
2012-11-26,0,Monday,Winter,1,Early Morning,23,4,19
2012-11-26,1,Monday,Winter,1,Early Morning,10,1,9
2012-11-26,2,Monday,Winter,1,Early Morning,5,0,5
2012-11-26,3,Monday,Winter,1,Early Morning,5,1,4
2012-11-26,4,Monday,Winter,1,Early Morning,10,0,10
2012-11-26,5,Monday,Winter,1,Early Morning,41,0,41
2012-11-26,6,Monday,Winter,1,Morning Rush,124,1,123
2012-11-26,7,Monday,Winter,1,Morning Rush,365,2,363
2012-11-26,8,Monday,Winter,1,Morning Rush,638,9,629
2012-11-26,9,Monday,Winter,1,Morning Rush,286,10,276
2012-11-26,10,Monday,Winter,1,Mid-Day,147,20,127
2012-11-26,11,Monday,Winter,1,Mid-Day,130,18,112
2012-11-26,12,Monday,Winter,1,Mid-Day,210,22,188
2012-11-26,13,Monday,Winter,1,Mid-Day,217,20,197
2012-11-26,14,Monday,Winter,1,Mid-Day,228,51,177
2012-11-26,15,Monday,Winter,1,Mid-Day,230,49,181
2012-11-26,16,Monday,Winter,1,Evening Rush,346,49,297
2012-11-26,17,Monday,Winter,1,Evening Rush,553,13,540
2012-11-26,18,Monday,Winter,1,Evening Rush,521,19,502
2012-11-26,19,Monday,Winter,1,Evening Rush,371,16,355
2012-11-26,20,Monday,Winter,1,Night,277,12,265
2012-11-26,21,Monday,Winter,1,Night,181,9,172
2012-11-26,22,Monday,Winter,1,Night,104,3,101
2012-11-26,23,Monday,Winter,2,Night,65,8,57
2012-11-27,0,Tuesday,Winter,2,Early Morning,26,2,24
2012-11-27,1,Tuesday,Winter,2,Early Morning,6,0,6
2012-11-27,2,Tuesday,Winter,2,Early Morning,5,0,5
2012-11-27,3,Tuesday,Winter,3,Early Morning,4,1,3
2012-11-27,4,Tuesday,Winter,3,Early Morning,5,0,5
2012-11-27,5,Tuesday,Winter,2,Early Morning,31,0,31
2012-11-27,6,Tuesday,Winter,2,Morning Rush,100,3,97
2012-11-27,7,Tuesday,Winter,3,Morning Rush,293,4,289
2012-11-27,8,Tuesday,Winter,3,Morning Rush,500,6,494
2012-11-27,9,Tuesday,Winter,2,Morning Rush,268,11,257
2012-11-27,10,Tuesday,Winter,3,Mid-Day,57,5,52
2012-11-27,11,Tuesday,Winter,3,Mid-Day,65,6,59
2012-11-27,12,Tuesday,Winter,3,Mid-Day,76,6,70
2012-11-27,13,Tuesday,Winter,3,Mid-Day,77,4,73
2012-11-27,14,Tuesday,Winter,3,Mid-Day,94,8,86
2012-11-27,15,Tuesday,Winter,2,Mid-Day,155,9,146
2012-11-27,16,Tuesday,Winter,2,Evening Rush,257,5,252
2012-11-27,17,Tuesday,Winter,2,Evening Rush,527,13,514
2012-11-27,18,Tuesday,Winter,1,Evening Rush,482,13,469
2012-11-27,19,Tuesday,Winter,1,Evening Rush,350,12,338
2012-11-27,20,Tuesday,Winter,1,Night,232,4,228
2012-11-27,21,Tuesday,Winter,1,Night,185,6,179
2012-11-27,22,Tuesday,Winter,1,Night,97,2,95
2012-11-27,23,Tuesday,Winter,2,Night,67,3,64
2012-11-28,0,Wednesday,Winter,2,Early Morning,23,1,22
2012-11-28,1,Wednesday,Winter,2,Early Morning,12,0,12
2012-11-28,2,Wednesday,Winter,2,Early Morning,1,0,1
2012-11-28,3,Wednesday,Winter,2,Early Morning,3,0,3
2012-11-28,4,Wednesday,Winter,2,Early Morning,4,0,4
2012-11-28,5,Wednesday,Winter,2,Early Morning,39,0,39
2012-11-28,6,Wednesday,Winter,2,Morning Rush,136,4,132
2012-11-28,7,Wednesday,Winter,2,Morning Rush,409,6,403
2012-11-28,8,Wednesday,Winter,1,Morning Rush,692,9,683
2012-11-28,9,Wednesday,Winter,1,Morning Rush,322,13,309
2012-11-28,10,Wednesday,Winter,1,Mid-Day,161,17,144
2012-11-28,11,Wednesday,Winter,1,Mid-Day,146,19,127
2012-11-28,12,Wednesday,Winter,1,Mid-Day,208,19,189
2012-11-28,13,Wednesday,Winter,1,Mid-Day,214,21,193
2012-11-28,14,Wednesday,Winter,1,Mid-Day,176,15,161
2012-11-28,15,Wednesday,Winter,1,Mid-Day,179,7,172
2012-11-28,16,Wednesday,Winter,1,Evening Rush,325,9,316
2012-11-28,17,Wednesday,Winter,1,Evening Rush,563,17,546
2012-11-28,18,Wednesday,Winter,1,Evening Rush,542,12,530
2012-11-28,19,Wednesday,Winter,1,Evening Rush,387,9,378
2012-11-28,20,Wednesday,Winter,1,Night,263,5,258
2012-11-28,21,Wednesday,Winter,1,Night,223,4,219
2012-11-28,22,Wednesday,Winter,1,Night,154,6,148
2012-11-28,23,Wednesday,Winter,1,Night,78,5,73
2012-11-29,0,Thursday,Winter,1,Early Morning,29,4,25
2012-11-29,1,Thursday,Winter,1,Early Morning,16,1,15
2012-11-29,2,Thursday,Winter,1,Early Morning,7,1,6
2012-11-29,4,Thursday,Winter,1,Early Morning,7,0,7
2012-11-29,5,Thursday,Winter,1,Early Morning,42,0,42
2012-11-29,6,Thursday,Winter,1,Morning Rush,121,1,120
2012-11-29,7,Thursday,Winter,1,Morning Rush,362,8,354
2012-11-29,8,Thursday,Winter,1,Morning Rush,679,15,664
2012-11-29,9,Thursday,Winter,1,Morning Rush,299,13,286
2012-11-29,10,Thursday,Winter,1,Mid-Day,178,25,153
2012-11-29,11,Thursday,Winter,1,Mid-Day,163,13,150
2012-11-29,12,Thursday,Winter,1,Mid-Day,236,11,225
2012-11-29,13,Thursday,Winter,1,Mid-Day,224,15,209
2012-11-29,14,Thursday,Winter,1,Mid-Day,187,13,174
2012-11-29,15,Thursday,Winter,1,Mid-Day,220,19,201
2012-11-29,16,Thursday,Winter,1,Evening Rush,370,24,346
2012-11-29,17,Thursday,Winter,1,Evening Rush,561,17,544
2012-11-29,18,Thursday,Winter,1,Evening Rush,537,17,520
2012-11-29,19,Thursday,Winter,1,Evening Rush,344,18,326
2012-11-29,20,Thursday,Winter,1,Night,252,11,241
2012-11-29,21,Thursday,Winter,1,Night,208,7,201
2012-11-29,22,Thursday,Winter,1,Night,151,4,147
2012-11-29,23,Thursday,Winter,1,Night,130,6,124
2012-11-30,0,Friday,Winter,1,Early Morning,52,4,48
2012-11-30,1,Friday,Winter,1,Early Morning,19,2,17
2012-11-30,2,Friday,Winter,1,Early Morning,12,2,10
2012-11-30,3,Friday,Winter,1,Early Morning,4,0,4
2012-11-30,4,Friday,Winter,1,Early Morning,3,0,3
2012-11-30,5,Friday,Winter,1,Early Morning,40,1,39
2012-11-30,6,Friday,Winter,1,Morning Rush,106,2,104
2012-11-30,7,Friday,Winter,1,Morning Rush,352,6,346
2012-11-30,8,Friday,Winter,2,Morning Rush,729,20,709
2012-11-30,9,Friday,Winter,1,Morning Rush,330,17,313
2012-11-30,10,Friday,Winter,2,Mid-Day,169,10,159
2012-11-30,11,Friday,Winter,2,Mid-Day,201,31,170
2012-11-30,12,Friday,Winter,2,Mid-Day,268,25,243
2012-11-30,13,Friday,Winter,2,Mid-Day,262,21,241
2012-11-30,14,Friday,Winter,2,Mid-Day,251,26,225
2012-11-30,15,Friday,Winter,2,Mid-Day,296,34,262
2012-11-30,16,Friday,Winter,1,Evening Rush,405,37,368
2012-11-30,17,Friday,Winter,1,Evening Rush,582,31,551
2012-11-30,18,Friday,Winter,2,Evening Rush,509,20,489
2012-11-30,19,Friday,Winter,1,Evening Rush,377,18,359
2012-11-30,20,Friday,Winter,1,Night,245,12,233
2012-11-30,21,Friday,Winter,1,Night,183,14,169
2012-11-30,22,Friday,Winter,1,Night,163,18,145
2012-11-30,23,Friday,Winter,2,Night,110,11,99
2012-12-01,0,Saturday,Winter,1,Early Morning,108,9,99
2012-12-01,1,Saturday,Winter,1,Early Morning,69,5,64
2012-12-01,2,Saturday,Winter,2,Early Morning,50,3,47
2012-12-01,3,Saturday,Winter,2,Early Morning,15,1,14
2012-12-01,4,Saturday,Winter,1,Early Morning,5,0,5
2012-12-01,5,Saturday,Winter,1,Early Morning,13,1,12
2012-12-01,6,Saturday,Winter,1,Morning Rush,27,7,20
2012-12-01,7,Saturday,Winter,2,Morning Rush,63,7,56
2012-12-01,8,Saturday,Winter,2,Morning Rush,144,11,133
2012-12-01,9,Saturday,Winter,2,Morning Rush,193,34,159
2012-12-01,10,Saturday,Winter,2,Mid-Day,256,45,211
2012-12-01,11,Saturday,Winter,2,Mid-Day,392,74,318
2012-12-01,12,Saturday,Winter,2,Mid-Day,446,119,327
2012-12-01,13,Saturday,Winter,2,Mid-Day,509,123,386
2012-12-01,14,Saturday,Winter,2,Mid-Day,479,110,369
2012-12-01,15,Saturday,Winter,2,Mid-Day,484,113,371
2012-12-01,16,Saturday,Winter,2,Evening Rush,443,89,354
2012-12-01,17,Saturday,Winter,2,Evening Rush,320,50,270
2012-12-01,18,Saturday,Winter,2,Evening Rush,297,42,255
2012-12-01,19,Saturday,Winter,2,Evening Rush,249,30,219
2012-12-01,20,Saturday,Winter,1,Night,198,28,170
2012-12-01,21,Saturday,Winter,2,Night,158,23,135
2012-12-01,22,Saturday,Winter,2,Night,147,17,130
2012-12-01,23,Saturday,Winter,2,Night,126,10,116
2012-12-02,0,Sunday,Winter,2,Early Morning,117,9,108
2012-12-02,1,Sunday,Winter,2,Early Morning,94,10,84
2012-12-02,2,Sunday,Winter,2,Early Morning,74,2,72
2012-12-02,3,Sunday,Winter,2,Early Morning,25,4,21
2012-12-02,4,Sunday,Winter,2,Early Morning,7,1,6
2012-12-02,5,Sunday,Winter,2,Early Morning,8,1,7
2012-12-02,6,Sunday,Winter,2,Morning Rush,16,1,15
2012-12-02,7,Sunday,Winter,2,Morning Rush,31,5,26
2012-12-02,8,Sunday,Winter,2,Morning Rush,93,12,81
2012-12-02,9,Sunday,Winter,2,Morning Rush,172,37,135
2012-12-02,10,Sunday,Winter,2,Mid-Day,293,63,230
2012-12-02,11,Sunday,Winter,2,Mid-Day,355,81,274
2012-12-02,12,Sunday,Winter,2,Mid-Day,520,111,409
2012-12-02,13,Sunday,Winter,1,Mid-Day,431,84,347
2012-12-02,14,Sunday,Winter,1,Mid-Day,473,142,331
2012-12-02,15,Sunday,Winter,1,Mid-Day,417,106,311
2012-12-02,16,Sunday,Winter,2,Evening Rush,443,85,358
2012-12-02,17,Sunday,Winter,3,Evening Rush,303,59,244
2012-12-02,18,Sunday,Winter,2,Evening Rush,203,25,178
2012-12-02,19,Sunday,Winter,2,Evening Rush,174,16,158
2012-12-02,20,Sunday,Winter,2,Night,154,12,142
2012-12-02,21,Sunday,Winter,2,Night,99,8,91
2012-12-02,22,Sunday,Winter,2,Night,96,11,85
2012-12-02,23,Sunday,Winter,2,Night,51,7,44
2012-12-03,0,Monday,Winter,2,Early Morning,21,3,18
2012-12-03,1,Monday,Winter,1,Early Morning,13,2,11
2012-12-03,2,Monday,Winter,1,Early Morning,10,1,9
2012-12-03,3,Monday,Winter,1,Early Morning,8,2,6
2012-12-03,4,Monday,Winter,1,Early Morning,5,1,4
2012-12-03,5,Monday,Winter,1,Early Morning,38,0,38
2012-12-03,6,Monday,Winter,1,Morning Rush,138,2,136
2012-12-03,7,Monday,Winter,2,Morning Rush,396,9,387
2012-12-03,8,Monday,Winter,1,Morning Rush,731,19,712
2012-12-03,9,Monday,Winter,1,Morning Rush,308,19,289
2012-12-03,10,Monday,Winter,1,Mid-Day,136,31,105
2012-12-03,11,Monday,Winter,1,Mid-Day,233,51,182
2012-12-03,12,Monday,Winter,1,Mid-Day,268,40,228
2012-12-03,13,Monday,Winter,1,Mid-Day,321,81,240
2012-12-03,14,Monday,Winter,1,Mid-Day,260,51,209
2012-12-03,15,Monday,Winter,1,Mid-Day,268,58,210
2012-12-03,16,Monday,Winter,1,Evening Rush,442,45,397
2012-12-03,17,Monday,Winter,1,Evening Rush,708,43,665
2012-12-03,18,Monday,Winter,1,Evening Rush,692,26,666
2012-12-03,19,Monday,Winter,1,Evening Rush,471,27,444
2012-12-03,20,Monday,Winter,2,Night,300,16,284
2012-12-03,21,Monday,Winter,1,Night,221,14,207
2012-12-03,22,Monday,Winter,1,Night,144,5,139
2012-12-03,23,Monday,Winter,1,Night,102,9,93
2012-12-04,0,Tuesday,Winter,1,Early Morning,55,6,49
2012-12-04,1,Tuesday,Winter,1,Early Morning,25,3,22
2012-12-04,2,Tuesday,Winter,1,Early Morning,8,3,5
2012-12-04,3,Tuesday,Winter,2,Early Morning,4,1,3
2012-12-04,4,Tuesday,Winter,2,Early Morning,7,0,7
2012-12-04,5,Tuesday,Winter,2,Early Morning,46,1,45
2012-12-04,6,Tuesday,Winter,2,Morning Rush,153,3,150
2012-12-04,7,Tuesday,Winter,1,Morning Rush,502,7,495
2012-12-04,8,Tuesday,Winter,2,Morning Rush,721,21,700
2012-12-04,9,Tuesday,Winter,1,Morning Rush,336,19,317
2012-12-04,10,Tuesday,Winter,1,Mid-Day,156,26,130
2012-12-04,11,Tuesday,Winter,1,Mid-Day,207,24,183
2012-12-04,12,Tuesday,Winter,1,Mid-Day,312,39,273
2012-12-04,13,Tuesday,Winter,2,Mid-Day,272,39,233
2012-12-04,14,Tuesday,Winter,2,Mid-Day,270,39,231
2012-12-04,15,Tuesday,Winter,2,Mid-Day,300,56,244
2012-12-04,16,Tuesday,Winter,1,Evening Rush,435,44,391
2012-12-04,17,Tuesday,Winter,1,Evening Rush,743,43,700
2012-12-04,18,Tuesday,Winter,1,Evening Rush,731,38,693
2012-12-04,19,Tuesday,Winter,1,Evening Rush,460,46,414
2012-12-04,20,Tuesday,Winter,2,Night,306,34,272
2012-12-04,21,Tuesday,Winter,2,Night,280,28,252
2012-12-04,22,Tuesday,Winter,2,Night,181,26,155
2012-12-04,23,Tuesday,Winter,1,Night,96,5,91
2012-12-05,0,Wednesday,Winter,1,Early Morning,37,6,31
2012-12-05,1,Wednesday,Winter,1,Early Morning,11,0,11
2012-12-05,2,Wednesday,Winter,1,Early Morning,9,2,7
2012-12-05,3,Wednesday,Winter,1,Early Morning,7,0,7
2012-12-05,4,Wednesday,Winter,1,Early Morning,10,1,9
2012-12-05,5,Wednesday,Winter,1,Early Morning,49,1,48
2012-12-05,6,Wednesday,Winter,3,Morning Rush,124,5,119
2012-12-05,7,Wednesday,Winter,3,Morning Rush,398,9,389
2012-12-05,8,Wednesday,Winter,2,Morning Rush,759,22,737
2012-12-05,9,Wednesday,Winter,2,Morning Rush,388,26,362
2012-12-05,10,Wednesday,Winter,2,Mid-Day,141,14,127
2012-12-05,11,Wednesday,Winter,1,Mid-Day,172,11,161
2012-12-05,12,Wednesday,Winter,1,Mid-Day,232,24,208
2012-12-05,13,Wednesday,Winter,1,Mid-Day,214,14,200
2012-12-05,14,Wednesday,Winter,1,Mid-Day,218,39,179
2012-12-05,15,Wednesday,Winter,1,Mid-Day,285,20,265
2012-12-05,16,Wednesday,Winter,1,Evening Rush,377,23,354
2012-12-05,17,Wednesday,Winter,1,Evening Rush,605,29,576
2012-12-05,18,Wednesday,Winter,1,Evening Rush,609,29,580
2012-12-05,19,Wednesday,Winter,1,Evening Rush,414,14,400
2012-12-05,20,Wednesday,Winter,1,Night,293,19,274
2012-12-05,21,Wednesday,Winter,1,Night,198,14,184
2012-12-05,22,Wednesday,Winter,1,Night,105,4,101
2012-12-05,23,Wednesday,Winter,1,Night,74,5,69
2012-12-06,0,Thursday,Winter,1,Early Morning,44,1,43
2012-12-06,1,Thursday,Winter,1,Early Morning,16,0,16
2012-12-06,2,Thursday,Winter,1,Early Morning,9,0,9
2012-12-06,3,Thursday,Winter,1,Early Morning,2,0,2
2012-12-06,4,Thursday,Winter,1,Early Morning,9,1,8
2012-12-06,5,Thursday,Winter,1,Early Morning,32,0,32
2012-12-06,6,Thursday,Winter,1,Morning Rush,124,2,122
2012-12-06,7,Thursday,Winter,1,Morning Rush,389,8,381
2012-12-06,8,Thursday,Winter,1,Morning Rush,659,13,646
2012-12-06,9,Thursday,Winter,1,Morning Rush,276,19,257
2012-12-06,10,Thursday,Winter,1,Mid-Day,145,23,122
2012-12-06,11,Thursday,Winter,1,Mid-Day,178,16,162
2012-12-06,12,Thursday,Winter,1,Mid-Day,235,29,206
2012-12-06,13,Thursday,Winter,1,Mid-Day,245,33,212
2012-12-06,14,Thursday,Winter,1,Mid-Day,212,37,175
2012-12-06,15,Thursday,Winter,1,Mid-Day,270,38,232
2012-12-06,16,Thursday,Winter,1,Evening Rush,331,39,292
2012-12-06,17,Thursday,Winter,1,Evening Rush,617,31,586
2012-12-06,18,Thursday,Winter,1,Evening Rush,565,23,542
2012-12-06,19,Thursday,Winter,1,Evening Rush,373,13,360
2012-12-06,20,Thursday,Winter,2,Night,227,5,222
2012-12-06,21,Thursday,Winter,2,Night,191,7,184
2012-12-06,22,Thursday,Winter,1,Night,133,2,131
2012-12-06,23,Thursday,Winter,1,Night,93,0,93
2012-12-07,0,Friday,Winter,1,Early Morning,48,3,45
2012-12-07,1,Friday,Winter,2,Early Morning,28,2,26
2012-12-07,2,Friday,Winter,2,Early Morning,11,0,11
2012-12-07,3,Friday,Winter,2,Early Morning,5,0,5
2012-12-07,4,Friday,Winter,1,Early Morning,10,0,10
2012-12-07,5,Friday,Winter,2,Early Morning,26,1,25
2012-12-07,6,Friday,Winter,2,Morning Rush,84,0,84
2012-12-07,7,Friday,Winter,3,Morning Rush,215,3,212
2012-12-07,8,Friday,Winter,2,Morning Rush,441,11,430
2012-12-07,9,Friday,Winter,2,Morning Rush,301,10,291
2012-12-07,10,Friday,Winter,2,Mid-Day,166,16,150
2012-12-07,11,Friday,Winter,2,Mid-Day,203,20,183
2012-12-07,12,Friday,Winter,2,Mid-Day,240,36,204
2012-12-07,13,Friday,Winter,2,Mid-Day,220,23,197
2012-12-07,14,Friday,Winter,2,Mid-Day,215,40,175
2012-12-07,15,Friday,Winter,2,Mid-Day,303,34,269
2012-12-07,16,Friday,Winter,1,Evening Rush,375,39,336
2012-12-07,17,Friday,Winter,2,Evening Rush,568,29,539
2012-12-07,18,Friday,Winter,2,Evening Rush,498,25,473
2012-12-07,19,Friday,Winter,2,Evening Rush,352,15,337
2012-12-07,20,Friday,Winter,3,Night,241,12,229
2012-12-07,21,Friday,Winter,2,Night,171,9,162
2012-12-07,22,Friday,Winter,2,Night,165,15,150
2012-12-07,23,Friday,Winter,2,Night,122,6,116
2012-12-08,0,Saturday,Winter,2,Early Morning,103,5,98
2012-12-08,1,Saturday,Winter,2,Early Morning,100,16,84
2012-12-08,2,Saturday,Winter,2,Early Morning,70,3,67
2012-12-08,3,Saturday,Winter,2,Early Morning,29,6,23
2012-12-08,4,Saturday,Winter,2,Early Morning,12,3,9
2012-12-08,5,Saturday,Winter,2,Early Morning,6,2,4
2012-12-08,6,Saturday,Winter,2,Morning Rush,20,1,19
2012-12-08,7,Saturday,Winter,2,Morning Rush,39,3,36
2012-12-08,8,Saturday,Winter,2,Morning Rush,111,5,106
2012-12-08,9,Saturday,Winter,2,Morning Rush,170,17,153
2012-12-08,10,Saturday,Winter,2,Mid-Day,287,43,244
2012-12-08,11,Saturday,Winter,2,Mid-Day,404,63,341
2012-12-08,12,Saturday,Winter,2,Mid-Day,486,122,364
2012-12-08,13,Saturday,Winter,2,Mid-Day,547,148,399
2012-12-08,14,Saturday,Winter,2,Mid-Day,542,164,378
2012-12-08,15,Saturday,Winter,1,Mid-Day,541,167,374
2012-12-08,16,Saturday,Winter,1,Evening Rush,507,139,368
2012-12-08,17,Saturday,Winter,1,Evening Rush,345,77,268
2012-12-08,18,Saturday,Winter,1,Evening Rush,304,40,264
2012-12-08,19,Saturday,Winter,1,Evening Rush,246,34,212
2012-12-08,20,Saturday,Winter,2,Night,182,20,162
2012-12-08,21,Saturday,Winter,2,Night,209,34,175
2012-12-08,22,Saturday,Winter,2,Night,160,23,137
2012-12-08,23,Saturday,Winter,2,Night,162,18,144
2012-12-09,0,Sunday,Winter,2,Early Morning,118,15,103
2012-12-09,1,Sunday,Winter,2,Early Morning,102,17,85
2012-12-09,2,Sunday,Winter,2,Early Morning,78,8,70
2012-12-09,3,Sunday,Winter,2,Early Morning,48,14,34
2012-12-09,4,Sunday,Winter,2,Early Morning,12,1,11
2012-12-09,5,Sunday,Winter,2,Early Morning,8,0,8
2012-12-09,6,Sunday,Winter,3,Morning Rush,6,0,6
2012-12-09,7,Sunday,Winter,3,Morning Rush,23,1,22
2012-12-09,8,Sunday,Winter,3,Morning Rush,69,1,68
2012-12-09,9,Sunday,Winter,2,Morning Rush,103,9,94
2012-12-09,10,Sunday,Winter,2,Mid-Day,219,39,180
2012-12-09,11,Sunday,Winter,2,Mid-Day,250,40,210
2012-12-09,12,Sunday,Winter,2,Mid-Day,315,60,255
2012-12-09,13,Sunday,Winter,2,Mid-Day,285,65,220
2012-12-09,14,Sunday,Winter,2,Mid-Day,232,42,190
2012-12-09,15,Sunday,Winter,3,Mid-Day,225,25,200
2012-12-09,16,Sunday,Winter,3,Evening Rush,253,33,220
2012-12-09,17,Sunday,Winter,3,Evening Rush,229,20,209
2012-12-09,18,Sunday,Winter,3,Evening Rush,198,17,181
2012-12-09,19,Sunday,Winter,3,Evening Rush,122,12,110
2012-12-09,20,Sunday,Winter,3,Night,108,6,102
2012-12-09,21,Sunday,Winter,2,Night,96,10,86
2012-12-09,22,Sunday,Winter,3,Night,78,3,75
2012-12-09,23,Sunday,Winter,3,Night,51,3,48
2012-12-10,0,Monday,Winter,3,Early Morning,20,0,20
2012-12-10,1,Monday,Winter,2,Early Morning,4,0,4
2012-12-10,2,Monday,Winter,2,Early Morning,5,2,3
2012-12-10,3,Monday,Winter,2,Early Morning,4,0,4
2012-12-10,4,Monday,Winter,2,Early Morning,12,3,9
2012-12-10,5,Monday,Winter,2,Early Morning,27,0,27
2012-12-10,6,Monday,Winter,2,Morning Rush,123,2,121
2012-12-10,7,Monday,Winter,2,Morning Rush,294,3,291
2012-12-10,8,Monday,Winter,2,Morning Rush,584,9,575
2012-12-10,9,Monday,Winter,2,Morning Rush,284,11,273
2012-12-10,10,Monday,Winter,2,Mid-Day,133,12,121
2012-12-10,11,Monday,Winter,3,Mid-Day,134,8,126
2012-12-10,12,Monday,Winter,3,Mid-Day,173,23,150
2012-12-10,13,Monday,Winter,3,Mid-Day,220,30,190
2012-12-10,14,Monday,Winter,2,Mid-Day,210,31,179
2012-12-10,15,Monday,Winter,2,Mid-Day,236,29,207
2012-12-10,16,Monday,Winter,2,Evening Rush,345,37,308
2012-12-10,17,Monday,Winter,2,Evening Rush,616,38,578
2012-12-10,18,Monday,Winter,2,Evening Rush,564,20,544
2012-12-10,19,Monday,Winter,1,Evening Rush,427,18,409
2012-12-10,20,Monday,Winter,1,Night,300,13,287
2012-12-10,21,Monday,Winter,2,Night,245,21,224
2012-12-10,22,Monday,Winter,2,Night,126,11,115
2012-12-10,23,Monday,Winter,1,Night,84,8,76
2012-12-11,0,Tuesday,Winter,3,Early Morning,31,2,29
2012-12-11,1,Tuesday,Winter,1,Early Morning,8,1,7
2012-12-11,2,Tuesday,Winter,2,Early Morning,1,0,1
2012-12-11,3,Tuesday,Winter,3,Early Morning,3,0,3
2012-12-11,4,Tuesday,Winter,2,Early Morning,8,0,8
2012-12-11,5,Tuesday,Winter,3,Early Morning,41,1,40
2012-12-11,6,Tuesday,Winter,2,Morning Rush,118,0,118
2012-12-11,7,Tuesday,Winter,1,Morning Rush,380,8,372
2012-12-11,8,Tuesday,Winter,2,Morning Rush,724,16,708
2012-12-11,9,Tuesday,Winter,1,Morning Rush,334,12,322
2012-12-11,10,Tuesday,Winter,1,Mid-Day,154,12,142
2012-12-11,11,Tuesday,Winter,2,Mid-Day,173,28,145
2012-12-11,12,Tuesday,Winter,2,Mid-Day,226,13,213
2012-12-11,13,Tuesday,Winter,2,Mid-Day,254,28,226
2012-12-11,14,Tuesday,Winter,2,Mid-Day,204,19,185
2012-12-11,15,Tuesday,Winter,2,Mid-Day,270,20,250
2012-12-11,16,Tuesday,Winter,2,Evening Rush,358,24,334
2012-12-11,17,Tuesday,Winter,1,Evening Rush,601,21,580
2012-12-11,18,Tuesday,Winter,1,Evening Rush,546,23,523
2012-12-11,19,Tuesday,Winter,1,Evening Rush,433,21,412
2012-12-11,20,Tuesday,Winter,1,Night,257,9,248
2012-12-11,21,Tuesday,Winter,1,Night,207,14,193
2012-12-11,22,Tuesday,Winter,1,Night,106,6,100
2012-12-11,23,Tuesday,Winter,1,Night,64,4,60
2012-12-12,0,Wednesday,Winter,1,Early Morning,34,1,33
2012-12-12,1,Wednesday,Winter,1,Early Morning,21,3,18
2012-12-12,2,Wednesday,Winter,1,Early Morning,9,5,4
2012-12-12,3,Wednesday,Winter,1,Early Morning,10,3,7
2012-12-12,4,Wednesday,Winter,1,Early Morning,4,0,4
2012-12-12,5,Wednesday,Winter,1,Early Morning,37,0,37
2012-12-12,6,Wednesday,Winter,2,Morning Rush,128,2,126
2012-12-12,7,Wednesday,Winter,2,Morning Rush,369,3,366
2012-12-12,8,Wednesday,Winter,2,Morning Rush,688,18,670
2012-12-12,9,Wednesday,Winter,2,Morning Rush,285,13,272
2012-12-12,10,Wednesday,Winter,2,Mid-Day,136,20,116
2012-12-12,11,Wednesday,Winter,2,Mid-Day,172,24,148
2012-12-12,12,Wednesday,Winter,2,Mid-Day,232,14,218
2012-12-12,13,Wednesday,Winter,2,Mid-Day,238,18,220
2012-12-12,14,Wednesday,Winter,2,Mid-Day,225,34,191
2012-12-12,15,Wednesday,Winter,2,Mid-Day,228,21,207
2012-12-12,16,Wednesday,Winter,2,Evening Rush,329,19,310
2012-12-12,17,Wednesday,Winter,2,Evening Rush,561,21,540
2012-12-12,18,Wednesday,Winter,2,Evening Rush,540,25,515
2012-12-12,19,Wednesday,Winter,2,Evening Rush,402,18,384
2012-12-12,20,Wednesday,Winter,1,Night,268,25,243
2012-12-12,21,Wednesday,Winter,2,Night,202,16,186
2012-12-12,22,Wednesday,Winter,2,Night,122,4,118
2012-12-12,23,Wednesday,Winter,2,Night,79,3,76
2012-12-13,0,Thursday,Winter,2,Early Morning,32,1,31
2012-12-13,1,Thursday,Winter,2,Early Morning,23,4,19
2012-12-13,2,Thursday,Winter,2,Early Morning,8,3,5
2012-12-13,3,Thursday,Winter,2,Early Morning,2,0,2
2012-12-13,4,Thursday,Winter,2,Early Morning,8,0,8
2012-12-13,5,Thursday,Winter,2,Early Morning,33,2,31
2012-12-13,6,Thursday,Winter,1,Morning Rush,114,2,112
2012-12-13,7,Thursday,Winter,1,Morning Rush,385,5,380
2012-12-13,8,Thursday,Winter,1,Morning Rush,679,24,655
2012-12-13,9,Thursday,Winter,1,Morning Rush,325,25,300
2012-12-13,10,Thursday,Winter,1,Mid-Day,167,28,139
2012-12-13,11,Thursday,Winter,1,Mid-Day,189,25,164
2012-12-13,12,Thursday,Winter,1,Mid-Day,282,30,252
2012-12-13,13,Thursday,Winter,1,Mid-Day,271,41,230
2012-12-13,14,Thursday,Winter,1,Mid-Day,242,31,211
2012-12-13,15,Thursday,Winter,1,Mid-Day,280,40,240
2012-12-13,16,Thursday,Winter,1,Evening Rush,406,50,356
2012-12-13,17,Thursday,Winter,1,Evening Rush,550,43,507
2012-12-13,18,Thursday,Winter,1,Evening Rush,466,20,446
2012-12-13,19,Thursday,Winter,1,Evening Rush,348,20,328
2012-12-13,20,Thursday,Winter,1,Night,241,6,235
2012-12-13,21,Thursday,Winter,1,Night,213,13,200
2012-12-13,22,Thursday,Winter,1,Night,148,7,141
2012-12-13,23,Thursday,Winter,1,Night,120,5,115
2012-12-14,0,Friday,Winter,1,Early Morning,47,4,43
2012-12-14,1,Friday,Winter,1,Early Morning,26,0,26
2012-12-14,2,Friday,Winter,1,Early Morning,9,3,6
2012-12-14,3,Friday,Winter,1,Early Morning,12,0,12
2012-12-14,4,Friday,Winter,1,Early Morning,10,1,9
2012-12-14,5,Friday,Winter,1,Early Morning,34,0,34
2012-12-14,6,Friday,Winter,1,Morning Rush,113,1,112
2012-12-14,7,Friday,Winter,1,Morning Rush,308,3,305
2012-12-14,8,Friday,Winter,1,Morning Rush,636,13,623
2012-12-14,9,Friday,Winter,1,Morning Rush,343,13,330
2012-12-14,10,Friday,Winter,1,Mid-Day,190,28,162
2012-12-14,11,Friday,Winter,1,Mid-Day,211,31,180
2012-12-14,12,Friday,Winter,1,Mid-Day,273,29,244
2012-12-14,13,Friday,Winter,1,Mid-Day,313,39,274
2012-12-14,14,Friday,Winter,1,Mid-Day,299,48,251
2012-12-14,15,Friday,Winter,1,Mid-Day,309,57,252
2012-12-14,16,Friday,Winter,1,Evening Rush,417,45,372
2012-12-14,17,Friday,Winter,1,Evening Rush,622,40,582
2012-12-14,18,Friday,Winter,1,Evening Rush,455,23,432
2012-12-14,19,Friday,Winter,1,Evening Rush,319,17,302
2012-12-14,20,Friday,Winter,1,Night,221,12,209
2012-12-14,21,Friday,Winter,1,Night,172,7,165
2012-12-14,22,Friday,Winter,1,Night,138,4,134
2012-12-14,23,Friday,Winter,1,Night,134,11,123
2012-12-15,0,Saturday,Winter,1,Early Morning,94,4,90
2012-12-15,1,Saturday,Winter,2,Early Morning,95,9,86
2012-12-15,2,Saturday,Winter,1,Early Morning,69,6,63
2012-12-15,3,Saturday,Winter,2,Early Morning,23,5,18
2012-12-15,4,Saturday,Winter,2,Early Morning,6,1,5
2012-12-15,5,Saturday,Winter,2,Early Morning,3,0,3
2012-12-15,6,Saturday,Winter,2,Morning Rush,11,0,11
2012-12-15,7,Saturday,Winter,2,Morning Rush,48,1,47
2012-12-15,8,Saturday,Winter,2,Morning Rush,119,8,111
2012-12-15,9,Saturday,Winter,1,Morning Rush,220,17,203
2012-12-15,10,Saturday,Winter,1,Mid-Day,273,23,250
2012-12-15,11,Saturday,Winter,1,Mid-Day,393,66,327
2012-12-15,12,Saturday,Winter,1,Mid-Day,453,89,364
2012-12-15,13,Saturday,Winter,1,Mid-Day,456,88,368
2012-12-15,14,Saturday,Winter,1,Mid-Day,426,92,334
2012-12-15,15,Saturday,Winter,1,Mid-Day,447,95,352
2012-12-15,16,Saturday,Winter,1,Evening Rush,413,85,328
2012-12-15,17,Saturday,Winter,1,Evening Rush,309,35,274
2012-12-15,18,Saturday,Winter,1,Evening Rush,272,40,232
2012-12-15,19,Saturday,Winter,1,Evening Rush,257,32,225
2012-12-15,20,Saturday,Winter,2,Night,201,23,178
2012-12-15,21,Saturday,Winter,1,Night,184,15,169
2012-12-15,22,Saturday,Winter,1,Night,156,22,134
2012-12-15,23,Saturday,Winter,2,Night,119,11,108
2012-12-16,0,Sunday,Winter,2,Early Morning,110,8,102
2012-12-16,1,Sunday,Winter,3,Early Morning,96,14,82
2012-12-16,2,Sunday,Winter,2,Early Morning,87,8,79
2012-12-16,3,Sunday,Winter,2,Early Morning,38,1,37
2012-12-16,4,Sunday,Winter,2,Early Morning,11,1,10
2012-12-16,5,Sunday,Winter,2,Early Morning,9,0,9
2012-12-16,6,Sunday,Winter,2,Morning Rush,6,0,6
2012-12-16,7,Sunday,Winter,2,Morning Rush,27,5,22
2012-12-16,8,Sunday,Winter,2,Morning Rush,88,12,76
2012-12-16,9,Sunday,Winter,2,Morning Rush,132,19,113
2012-12-16,10,Sunday,Winter,2,Mid-Day,257,42,215
2012-12-16,11,Sunday,Winter,2,Mid-Day,295,47,248
2012-12-16,12,Sunday,Winter,2,Mid-Day,417,67,350
2012-12-16,13,Sunday,Winter,2,Mid-Day,356,67,289
2012-12-16,14,Sunday,Winter,2,Mid-Day,310,50,260
2012-12-16,15,Sunday,Winter,2,Mid-Day,338,46,292
2012-12-16,16,Sunday,Winter,2,Evening Rush,400,66,334
2012-12-16,17,Sunday,Winter,2,Evening Rush,243,29,214
2012-12-16,18,Sunday,Winter,3,Evening Rush,107,8,99
2012-12-16,19,Sunday,Winter,1,Evening Rush,109,10,99
2012-12-16,20,Sunday,Winter,2,Night,122,14,108
2012-12-16,21,Sunday,Winter,2,Night,106,14,92
2012-12-16,22,Sunday,Winter,2,Night,89,6,83
2012-12-16,23,Sunday,Winter,2,Night,33,4,29
2012-12-17,0,Monday,Winter,2,Early Morning,28,2,26
2012-12-17,1,Monday,Winter,2,Early Morning,15,1,14
2012-12-17,2,Monday,Winter,2,Early Morning,5,1,4
2012-12-17,3,Monday,Winter,2,Early Morning,3,0,3
2012-12-17,4,Monday,Winter,3,Early Morning,5,2,3
2012-12-17,5,Monday,Winter,2,Early Morning,24,0,24
2012-12-17,6,Monday,Winter,2,Morning Rush,108,1,107
2012-12-17,7,Monday,Winter,2,Morning Rush,319,5,314
2012-12-17,8,Monday,Winter,2,Morning Rush,592,10,582
2012-12-17,9,Monday,Winter,2,Morning Rush,282,11,271
2012-12-17,10,Monday,Winter,2,Mid-Day,135,15,120
2012-12-17,11,Monday,Winter,2,Mid-Day,170,22,148
2012-12-17,12,Monday,Winter,2,Mid-Day,232,21,211
2012-12-17,13,Monday,Winter,2,Mid-Day,210,16,194
2012-12-17,14,Monday,Winter,2,Mid-Day,181,12,169
2012-12-17,15,Monday,Winter,2,Mid-Day,211,15,196
2012-12-17,16,Monday,Winter,3,Evening Rush,302,15,287
2012-12-17,17,Monday,Winter,2,Evening Rush,495,17,478
2012-12-17,18,Monday,Winter,2,Evening Rush,507,14,493
2012-12-17,19,Monday,Winter,2,Evening Rush,340,7,333
2012-12-17,20,Monday,Winter,2,Night,200,8,192
2012-12-17,21,Monday,Winter,2,Night,120,6,114
2012-12-17,22,Monday,Winter,2,Night,54,5,49
2012-12-17,23,Monday,Winter,3,Night,47,6,41
2012-12-18,0,Tuesday,Winter,2,Early Morning,18,0,18
2012-12-18,1,Tuesday,Winter,2,Early Morning,15,0,15
2012-12-18,2,Tuesday,Winter,2,Early Morning,7,2,5
2012-12-18,3,Tuesday,Winter,1,Early Morning,5,0,5
2012-12-18,4,Tuesday,Winter,1,Early Morning,8,3,5
2012-12-18,5,Tuesday,Winter,1,Early Morning,36,0,36
2012-12-18,6,Tuesday,Winter,1,Morning Rush,118,1,117
2012-12-18,7,Tuesday,Winter,1,Morning Rush,355,4,351
2012-12-18,8,Tuesday,Winter,1,Morning Rush,662,10,652
2012-12-18,9,Tuesday,Winter,1,Morning Rush,326,19,307
2012-12-18,10,Tuesday,Winter,1,Mid-Day,184,22,162
2012-12-18,11,Tuesday,Winter,1,Mid-Day,269,58,211
2012-12-18,12,Tuesday,Winter,3,Mid-Day,313,49,264
2012-12-18,13,Tuesday,Winter,1,Mid-Day,286,51,235
2012-12-18,14,Tuesday,Winter,1,Mid-Day,247,56,191
2012-12-18,15,Tuesday,Winter,1,Mid-Day,246,28,218
2012-12-18,16,Tuesday,Winter,1,Evening Rush,363,40,323
2012-12-18,17,Tuesday,Winter,1,Evening Rush,572,39,533
2012-12-18,18,Tuesday,Winter,1,Evening Rush,525,13,512
2012-12-18,19,Tuesday,Winter,1,Evening Rush,353,19,334
2012-12-18,20,Tuesday,Winter,1,Night,268,4,264
2012-12-18,21,Tuesday,Winter,1,Night,168,9,159
2012-12-18,22,Tuesday,Winter,1,Night,132,5,127
2012-12-18,23,Tuesday,Winter,1,Night,81,1,80
2012-12-19,0,Wednesday,Winter,1,Early Morning,41,6,35
2012-12-19,1,Wednesday,Winter,1,Early Morning,15,1,14
2012-12-19,2,Wednesday,Winter,1,Early Morning,3,1,2
2012-12-19,3,Wednesday,Winter,1,Early Morning,5,0,5
2012-12-19,4,Wednesday,Winter,1,Early Morning,7,1,6
2012-12-19,5,Wednesday,Winter,1,Early Morning,31,2,29
2012-12-19,6,Wednesday,Winter,1,Morning Rush,112,3,109
2012-12-19,7,Wednesday,Winter,1,Morning Rush,363,3,360
2012-12-19,8,Wednesday,Winter,1,Morning Rush,678,13,665
2012-12-19,9,Wednesday,Winter,1,Morning Rush,317,8,309
2012-12-19,10,Wednesday,Winter,1,Mid-Day,164,17,147
2012-12-19,11,Wednesday,Winter,1,Mid-Day,200,31,169
2012-12-19,12,Wednesday,Winter,1,Mid-Day,236,33,203
2012-12-19,13,Wednesday,Winter,1,Mid-Day,213,30,183
2012-12-19,14,Wednesday,Winter,1,Mid-Day,218,33,185
2012-12-19,15,Wednesday,Winter,1,Mid-Day,237,28,209
2012-12-19,16,Wednesday,Winter,1,Evening Rush,334,37,297
2012-12-19,17,Wednesday,Winter,1,Evening Rush,562,26,536
2012-12-19,18,Wednesday,Winter,1,Evening Rush,569,23,546
2012-12-19,19,Wednesday,Winter,1,Evening Rush,336,7,329
2012-12-19,20,Wednesday,Winter,1,Night,241,10,231
2012-12-19,21,Wednesday,Winter,1,Night,168,4,164
2012-12-19,22,Wednesday,Winter,1,Night,129,12,117
2012-12-19,23,Wednesday,Winter,1,Night,88,4,84
2012-12-20,0,Thursday,Winter,1,Early Morning,42,2,40
2012-12-20,1,Thursday,Winter,1,Early Morning,20,1,19
2012-12-20,2,Thursday,Winter,1,Early Morning,8,2,6
2012-12-20,3,Thursday,Winter,2,Early Morning,4,1,3
2012-12-20,4,Thursday,Winter,2,Early Morning,6,0,6
2012-12-20,5,Thursday,Winter,2,Early Morning,35,0,35
2012-12-20,6,Thursday,Winter,2,Morning Rush,118,4,114
2012-12-20,7,Thursday,Winter,2,Morning Rush,350,4,346
2012-12-20,8,Thursday,Winter,2,Morning Rush,599,14,585
2012-12-20,9,Thursday,Winter,2,Morning Rush,317,14,303
2012-12-20,10,Thursday,Winter,2,Mid-Day,161,23,138
2012-12-20,11,Thursday,Winter,2,Mid-Day,190,22,168
2012-12-20,12,Thursday,Winter,2,Mid-Day,212,31,181
2012-12-20,13,Thursday,Winter,2,Mid-Day,217,46,171
2012-12-20,14,Thursday,Winter,2,Mid-Day,214,43,171
2012-12-20,15,Thursday,Winter,2,Mid-Day,249,33,216
2012-12-20,16,Thursday,Winter,2,Evening Rush,302,21,281
2012-12-20,17,Thursday,Winter,2,Evening Rush,475,25,450
2012-12-20,18,Thursday,Winter,2,Evening Rush,381,22,359
2012-12-20,19,Thursday,Winter,3,Evening Rush,118,3,115
2012-12-20,20,Thursday,Winter,3,Night,50,1,49
2012-12-20,21,Thursday,Winter,3,Night,26,1,25
2012-12-20,22,Thursday,Winter,3,Night,21,1,20
2012-12-20,23,Thursday,Winter,3,Night,13,0,13
2012-12-21,0,Friday,Spring,3,Early Morning,17,0,17
2012-12-21,1,Friday,Spring,3,Early Morning,9,2,7
2012-12-21,2,Friday,Spring,3,Early Morning,3,0,3
2012-12-21,3,Friday,Spring,3,Early Morning,3,0,3
2012-12-21,4,Friday,Spring,2,Early Morning,6,1,5
2012-12-21,5,Friday,Spring,2,Early Morning,13,0,13
2012-12-21,6,Friday,Spring,2,Morning Rush,80,4,76
2012-12-21,7,Friday,Spring,2,Morning Rush,208,3,205
2012-12-21,8,Friday,Spring,2,Morning Rush,472,8,464
2012-12-21,9,Friday,Spring,2,Morning Rush,267,2,265
2012-12-21,10,Friday,Spring,1,Mid-Day,154,8,146
2012-12-21,11,Friday,Spring,2,Mid-Day,162,12,150
2012-12-21,12,Friday,Spring,2,Mid-Day,224,25,199
2012-12-21,13,Friday,Spring,2,Mid-Day,240,26,214
2012-12-21,14,Friday,Spring,2,Mid-Day,219,20,199
2012-12-21,15,Friday,Spring,2,Mid-Day,263,29,234
2012-12-21,16,Friday,Spring,2,Evening Rush,281,28,253
2012-12-21,17,Friday,Spring,2,Evening Rush,321,24,297
2012-12-21,18,Friday,Spring,2,Evening Rush,243,7,236
2012-12-21,19,Friday,Spring,1,Evening Rush,153,5,148
2012-12-21,20,Friday,Spring,1,Night,112,8,104
2012-12-21,21,Friday,Spring,1,Night,70,2,68
2012-12-21,22,Friday,Spring,1,Night,63,6,57
2012-12-21,23,Friday,Spring,1,Night,40,1,39
2012-12-22,0,Saturday,Spring,1,Early Morning,31,1,30
2012-12-22,1,Saturday,Spring,1,Early Morning,35,1,34
2012-12-22,2,Saturday,Spring,1,Early Morning,23,0,23
2012-12-22,3,Saturday,Spring,1,Early Morning,7,0,7
2012-12-22,4,Saturday,Spring,1,Early Morning,5,3,2
2012-12-22,5,Saturday,Spring,1,Early Morning,5,0,5
2012-12-22,6,Saturday,Spring,1,Morning Rush,13,0,13
2012-12-22,7,Saturday,Spring,1,Morning Rush,20,2,18
2012-12-22,8,Saturday,Spring,1,Morning Rush,29,0,29
2012-12-22,9,Saturday,Spring,1,Morning Rush,90,13,77
2012-12-22,10,Saturday,Spring,1,Mid-Day,118,13,105
2012-12-22,11,Saturday,Spring,1,Mid-Day,159,29,130
2012-12-22,12,Saturday,Spring,1,Mid-Day,146,18,128
2012-12-22,13,Saturday,Spring,1,Mid-Day,158,23,135
2012-12-22,14,Saturday,Spring,1,Mid-Day,161,20,141
2012-12-22,15,Saturday,Spring,1,Mid-Day,153,14,139
2012-12-22,16,Saturday,Spring,1,Evening Rush,147,23,124
2012-12-22,17,Saturday,Spring,1,Evening Rush,114,15,99
2012-12-22,18,Saturday,Spring,1,Evening Rush,82,7,75
2012-12-22,19,Saturday,Spring,1,Evening Rush,60,9,51
2012-12-22,20,Saturday,Spring,1,Night,61,6,55
2012-12-22,21,Saturday,Spring,1,Night,53,4,49
2012-12-22,22,Saturday,Spring,1,Night,39,1,38
2012-12-22,23,Saturday,Spring,1,Night,40,3,37
2012-12-23,0,Sunday,Spring,1,Early Morning,27,3,24
2012-12-23,1,Sunday,Spring,1,Early Morning,20,1,19
2012-12-23,2,Sunday,Spring,1,Early Morning,18,1,17
2012-12-23,3,Sunday,Spring,1,Early Morning,9,0,9
2012-12-23,4,Sunday,Spring,1,Early Morning,4,1,3
2012-12-23,5,Sunday,Spring,1,Early Morning,6,0,6
2012-12-23,6,Sunday,Spring,1,Morning Rush,9,4,5
2012-12-23,7,Sunday,Spring,1,Morning Rush,19,3,16
2012-12-23,8,Sunday,Spring,1,Morning Rush,48,5,43
2012-12-23,9,Sunday,Spring,1,Morning Rush,56,7,49
2012-12-23,10,Sunday,Spring,1,Mid-Day,93,26,67
2012-12-23,11,Sunday,Spring,1,Mid-Day,152,48,104
2012-12-23,12,Sunday,Spring,1,Mid-Day,196,52,144
2012-12-23,13,Sunday,Spring,1,Mid-Day,186,63,123
2012-12-23,14,Sunday,Spring,1,Mid-Day,175,57,118
2012-12-23,15,Sunday,Spring,1,Mid-Day,137,39,98
2012-12-23,16,Sunday,Spring,1,Evening Rush,190,53,137
2012-12-23,17,Sunday,Spring,1,Evening Rush,114,21,93
2012-12-23,18,Sunday,Spring,1,Evening Rush,93,8,85
2012-12-23,19,Sunday,Spring,1,Evening Rush,58,4,54
2012-12-23,20,Sunday,Spring,1,Night,52,0,52
2012-12-23,21,Sunday,Spring,1,Night,42,4,38
2012-12-23,22,Sunday,Spring,1,Night,58,5,53
2012-12-23,23,Sunday,Spring,1,Night,25,3,22
2012-12-24,0,Monday,Spring,1,Early Morning,12,0,12
2012-12-24,1,Monday,Spring,1,Early Morning,11,0,11
2012-12-24,2,Monday,Spring,1,Early Morning,5,0,5
2012-12-24,3,Monday,Spring,1,Early Morning,3,1,2
2012-12-24,5,Monday,Spring,1,Early Morning,9,0,9
2012-12-24,6,Monday,Spring,1,Morning Rush,17,1,16
2012-12-24,7,Monday,Spring,1,Morning Rush,30,3,27
2012-12-24,8,Monday,Spring,1,Morning Rush,66,4,62
2012-12-24,9,Monday,Spring,2,Morning Rush,85,17,68
2012-12-24,10,Monday,Spring,2,Mid-Day,103,21,82
2012-12-24,11,Monday,Spring,2,Mid-Day,124,20,104
2012-12-24,12,Monday,Spring,2,Mid-Day,135,22,113
2012-12-24,13,Monday,Spring,3,Mid-Day,70,16,54
2012-12-24,14,Monday,Spring,3,Mid-Day,46,13,33
2012-12-24,15,Monday,Spring,3,Mid-Day,33,6,27
2012-12-24,16,Monday,Spring,3,Evening Rush,33,6,27
2012-12-24,17,Monday,Spring,3,Evening Rush,26,7,19
2012-12-24,18,Monday,Spring,3,Evening Rush,26,6,20
2012-12-24,19,Monday,Spring,2,Evening Rush,18,4,14
2012-12-24,20,Monday,Spring,3,Night,23,6,17
2012-12-24,21,Monday,Spring,3,Night,22,13,9
2012-12-24,22,Monday,Spring,2,Night,12,7,5
2012-12-24,23,Monday,Spring,3,Night,11,1,10
2012-12-25,0,Tuesday,Spring,3,Early Morning,13,3,10
2012-12-25,1,Tuesday,Spring,2,Early Morning,13,0,13
2012-12-25,2,Tuesday,Spring,2,Early Morning,7,0,7
2012-12-25,4,Tuesday,Spring,2,Early Morning,1,0,1
2012-12-25,5,Tuesday,Spring,2,Early Morning,3,2,1
2012-12-25,6,Tuesday,Spring,2,Morning Rush,7,1,6
2012-12-25,7,Tuesday,Spring,2,Morning Rush,6,0,6
2012-12-25,8,Tuesday,Spring,2,Morning Rush,11,1,10
2012-12-25,9,Tuesday,Spring,2,Morning Rush,28,7,21
2012-12-25,10,Tuesday,Spring,1,Mid-Day,32,11,21
2012-12-25,11,Tuesday,Spring,1,Mid-Day,86,43,43
2012-12-25,12,Tuesday,Spring,1,Mid-Day,114,62,52
2012-12-25,13,Tuesday,Spring,1,Mid-Day,121,75,46
2012-12-25,14,Tuesday,Spring,1,Mid-Day,126,58,68
2012-12-25,15,Tuesday,Spring,1,Mid-Day,107,51,56
2012-12-25,16,Tuesday,Spring,2,Evening Rush,86,48,38
2012-12-25,17,Tuesday,Spring,2,Evening Rush,50,16,34
2012-12-25,18,Tuesday,Spring,2,Evening Rush,43,20,23
2012-12-25,19,Tuesday,Spring,2,Evening Rush,36,16,20
2012-12-25,20,Tuesday,Spring,2,Night,40,11,29
2012-12-25,21,Tuesday,Spring,2,Night,34,8,26
2012-12-25,22,Tuesday,Spring,2,Night,19,3,16
2012-12-25,23,Tuesday,Spring,2,Night,30,4,26
2012-12-26,0,Wednesday,Spring,2,Early Morning,9,1,8
2012-12-26,1,Wednesday,Spring,2,Early Morning,7,0,7
2012-12-26,2,Wednesday,Spring,2,Early Morning,1,0,1
2012-12-26,3,Wednesday,Spring,2,Early Morning,2,0,2
2012-12-26,4,Wednesday,Spring,1,Early Morning,2,0,2
2012-12-26,5,Wednesday,Spring,2,Early Morning,11,0,11
2012-12-26,6,Wednesday,Spring,2,Morning Rush,36,0,36
2012-12-26,7,Wednesday,Spring,3,Morning Rush,26,0,26
2012-12-26,8,Wednesday,Spring,3,Morning Rush,31,0,31
2012-12-26,9,Wednesday,Spring,3,Morning Rush,23,1,22
2012-12-26,10,Wednesday,Spring,3,Mid-Day,8,0,8
2012-12-26,11,Wednesday,Spring,3,Mid-Day,10,0,10
2012-12-26,12,Wednesday,Spring,3,Mid-Day,10,0,10
2012-12-26,13,Wednesday,Spring,3,Mid-Day,15,0,15
2012-12-26,14,Wednesday,Spring,3,Mid-Day,20,0,20
2012-12-26,15,Wednesday,Spring,3,Mid-Day,13,0,13
2012-12-26,16,Wednesday,Spring,3,Evening Rush,13,0,13
2012-12-26,17,Wednesday,Spring,3,Evening Rush,53,2,51
2012-12-26,18,Wednesday,Spring,3,Evening Rush,43,1,42
2012-12-26,19,Wednesday,Spring,3,Evening Rush,35,2,33
2012-12-26,20,Wednesday,Spring,3,Night,32,0,32
2012-12-26,21,Wednesday,Spring,2,Night,20,0,20
2012-12-26,22,Wednesday,Spring,3,Night,11,0,11
2012-12-26,23,Wednesday,Spring,3,Night,10,2,8
2012-12-27,0,Thursday,Spring,3,Early Morning,3,0,3
2012-12-27,1,Thursday,Spring,3,Early Morning,5,0,5
2012-12-27,2,Thursday,Spring,2,Early Morning,2,0,2
2012-12-27,3,Thursday,Spring,2,Early Morning,1,0,1
2012-12-27,4,Thursday,Spring,2,Early Morning,3,0,3
2012-12-27,5,Thursday,Spring,1,Early Morning,11,1,10
2012-12-27,6,Thursday,Spring,1,Morning Rush,45,0,45
2012-12-27,7,Thursday,Spring,1,Morning Rush,90,0,90
2012-12-27,8,Thursday,Spring,1,Morning Rush,208,2,206
2012-12-27,9,Thursday,Spring,1,Morning Rush,133,6,127
2012-12-27,10,Thursday,Spring,1,Mid-Day,75,8,67
2012-12-27,11,Thursday,Spring,2,Mid-Day,103,23,80
2012-12-27,12,Thursday,Spring,1,Mid-Day,109,22,87
2012-12-27,13,Thursday,Spring,1,Mid-Day,118,19,99
2012-12-27,14,Thursday,Spring,2,Mid-Day,119,25,94
2012-12-27,15,Thursday,Spring,2,Mid-Day,120,31,89
2012-12-27,16,Thursday,Spring,2,Evening Rush,174,23,151
2012-12-27,17,Thursday,Spring,2,Evening Rush,257,30,227
2012-12-27,18,Thursday,Spring,2,Evening Rush,197,9,188
2012-12-27,19,Thursday,Spring,1,Evening Rush,117,11,106
2012-12-27,20,Thursday,Spring,1,Night,91,12,79
2012-12-27,21,Thursday,Spring,2,Night,63,12,51
2012-12-27,22,Thursday,Spring,2,Night,44,11,33
2012-12-27,23,Thursday,Spring,2,Night,26,2,24
2012-12-28,0,Friday,Spring,2,Early Morning,25,3,22
2012-12-28,1,Friday,Spring,1,Early Morning,9,0,9
2012-12-28,2,Friday,Spring,1,Early Morning,5,0,5
2012-12-28,3,Friday,Spring,2,Early Morning,2,0,2
2012-12-28,4,Friday,Spring,2,Early Morning,4,0,4
2012-12-28,5,Friday,Spring,2,Early Morning,15,0,15
2012-12-28,6,Friday,Spring,1,Morning Rush,51,2,49
2012-12-28,7,Friday,Spring,1,Morning Rush,112,1,111
2012-12-28,8,Friday,Spring,2,Morning Rush,239,1,238
2012-12-28,9,Friday,Spring,2,Morning Rush,191,18,173
2012-12-28,10,Friday,Spring,2,Mid-Day,162,77,85
2012-12-28,11,Friday,Spring,2,Mid-Day,178,71,107
2012-12-28,12,Friday,Spring,2,Mid-Day,222,72,150
2012-12-28,13,Friday,Spring,2,Mid-Day,222,76,146
2012-12-28,14,Friday,Spring,2,Mid-Day,261,84,177
2012-12-28,15,Friday,Spring,2,Mid-Day,225,74,151
2012-12-28,16,Friday,Spring,1,Evening Rush,250,42,208
2012-12-28,17,Friday,Spring,1,Evening Rush,271,43,228
2012-12-28,18,Friday,Spring,1,Evening Rush,213,16,197
2012-12-28,19,Friday,Spring,2,Evening Rush,128,15,113
2012-12-28,20,Friday,Spring,2,Night,97,14,83
2012-12-28,21,Friday,Spring,2,Night,92,17,75
2012-12-28,22,Friday,Spring,2,Night,62,13,49
2012-12-28,23,Friday,Spring,2,Night,59,5,54
2012-12-29,0,Saturday,Spring,2,Early Morning,26,1,25
2012-12-29,1,Saturday,Spring,2,Early Morning,37,6,31
2012-12-29,2,Saturday,Spring,2,Early Morning,19,1,18
2012-12-29,3,Saturday,Spring,2,Early Morning,6,1,5
2012-12-29,4,Saturday,Spring,2,Early Morning,3,0,3
2012-12-29,5,Saturday,Spring,2,Early Morning,3,0,3
2012-12-29,6,Saturday,Spring,2,Morning Rush,7,0,7
2012-12-29,7,Saturday,Spring,2,Morning Rush,18,1,17
2012-12-29,8,Saturday,Spring,2,Morning Rush,44,9,35
2012-12-29,9,Saturday,Spring,2,Morning Rush,49,16,33
2012-12-29,10,Saturday,Spring,3,Mid-Day,41,6,35
2012-12-29,11,Saturday,Spring,3,Mid-Day,45,7,38
2012-12-29,12,Saturday,Spring,3,Mid-Day,48,5,43
2012-12-29,13,Saturday,Spring,3,Mid-Day,84,13,71
2012-12-29,14,Saturday,Spring,2,Mid-Day,98,10,88
2012-12-29,15,Saturday,Spring,2,Mid-Day,129,19,110
2012-12-29,16,Saturday,Spring,1,Evening Rush,147,22,125
2012-12-29,17,Saturday,Spring,1,Evening Rush,118,18,100
2012-12-29,18,Saturday,Spring,1,Evening Rush,110,8,102
2012-12-29,19,Saturday,Spring,2,Evening Rush,97,7,90
2012-12-29,20,Saturday,Spring,2,Night,66,2,64
2012-12-29,21,Saturday,Spring,2,Night,60,4,56
2012-12-29,22,Saturday,Spring,2,Night,54,3,51
2012-12-29,23,Saturday,Spring,2,Night,32,0,32
2012-12-30,0,Sunday,Spring,2,Early Morning,41,0,41
2012-12-30,1,Sunday,Spring,2,Early Morning,28,1,27
2012-12-30,2,Sunday,Spring,2,Early Morning,19,0,19
2012-12-30,3,Sunday,Spring,2,Early Morning,15,1,14
2012-12-30,4,Sunday,Spring,2,Early Morning,7,0,7
2012-12-30,5,Sunday,Spring,2,Early Morning,2,0,2
2012-12-30,6,Sunday,Spring,2,Morning Rush,8,1,7
2012-12-30,7,Sunday,Spring,1,Morning Rush,13,0,13
2012-12-30,8,Sunday,Spring,1,Morning Rush,33,1,32
2012-12-30,9,Sunday,Spring,1,Morning Rush,74,9,65
2012-12-30,10,Sunday,Spring,1,Mid-Day,122,31,91
2012-12-30,11,Sunday,Spring,1,Mid-Day,136,33,103
2012-12-30,12,Sunday,Spring,1,Mid-Day,144,47,97
2012-12-30,13,Sunday,Spring,1,Mid-Day,169,49,120
2012-12-30,14,Sunday,Spring,1,Mid-Day,160,39,121
2012-12-30,15,Sunday,Spring,1,Mid-Day,138,37,101
2012-12-30,16,Sunday,Spring,1,Evening Rush,133,31,102
2012-12-30,17,Sunday,Spring,1,Evening Rush,123,26,97
2012-12-30,18,Sunday,Spring,2,Evening Rush,125,12,113
2012-12-30,19,Sunday,Spring,1,Evening Rush,102,16,86
2012-12-30,20,Sunday,Spring,1,Night,72,9,63
2012-12-30,21,Sunday,Spring,1,Night,47,5,42
2012-12-30,22,Sunday,Spring,1,Night,36,6,30
2012-12-30,23,Sunday,Spring,1,Night,49,10,39
2012-12-31,0,Monday,Spring,1,Early Morning,34,4,30
2012-12-31,1,Monday,Spring,1,Early Morning,19,6,13
2012-12-31,2,Monday,Spring,1,Early Morning,11,3,8
2012-12-31,3,Monday,Spring,1,Early Morning,1,0,1
2012-12-31,4,Monday,Spring,1,Early Morning,3,0,3
2012-12-31,5,Monday,Spring,1,Early Morning,9,0,9
2012-12-31,6,Monday,Spring,1,Morning Rush,40,0,40
2012-12-31,7,Monday,Spring,1,Morning Rush,85,2,83
2012-12-31,8,Monday,Spring,1,Morning Rush,196,9,187
2012-12-31,9,Monday,Spring,2,Morning Rush,157,13,144
2012-12-31,10,Monday,Spring,2,Mid-Day,120,33,87
2012-12-31,11,Monday,Spring,2,Mid-Day,157,43,114
2012-12-31,12,Monday,Spring,2,Mid-Day,224,52,172
2012-12-31,13,Monday,Spring,2,Mid-Day,203,38,165
2012-12-31,14,Monday,Spring,2,Mid-Day,247,62,185
2012-12-31,15,Monday,Spring,2,Mid-Day,315,69,246
2012-12-31,16,Monday,Spring,2,Evening Rush,214,30,184
2012-12-31,17,Monday,Spring,2,Evening Rush,164,14,150
2012-12-31,18,Monday,Spring,2,Evening Rush,122,10,112
2012-12-31,19,Monday,Spring,2,Evening Rush,119,11,108
2012-12-31,20,Monday,Spring,2,Night,89,8,81
2012-12-31,21,Monday,Spring,1,Night,90,7,83
2012-12-31,22,Monday,Spring,1,Night,61,13,48
2012-12-31,23,Monday,Spring,1,Night,49,12,37
