DATE,HOUR,DAY_NAME,TIME_OF_DAY,CASUAL_USERS,REGISTERED_USERS,TOTAL_RENTALS,CASUAL_PERCENTAGE
2011-01-01,0,Saturday,Early Morning,3,13,16,18.75
2011-01-01,1,Saturday,Early Morning,8,32,40,20.0
2011-01-01,2,Saturday,Early Morning,5,27,32,15.63
2011-01-01,3,Saturday,Early Morning,3,10,13,23.08
2011-01-01,4,Saturday,Early Morning,0,1,1,0.0
2011-01-01,5,Saturday,Early Morning,0,1,1,0.0
2011-01-01,6,Saturday,Morning Rush,2,0,2,100.0
2011-01-01,7,Saturday,Morning Rush,1,2,3,33.33
2011-01-01,8,Saturday,Morning Rush,1,7,8,12.5
2011-01-01,9,Saturday,Morning Rush,8,6,14,57.14
2011-01-01,10,Saturday,Mid-Day,12,24,36,33.33
2011-01-01,11,Saturday,Mid-Day,26,30,56,46.43
2011-01-01,12,Saturday,Mid-Day,29,55,84,34.52
2011-01-01,13,Saturday,Mid-Day,47,47,94,50.0
2011-01-01,14,Saturday,Mid-Day,35,71,106,33.02
2011-01-01,15,Saturday,Mid-Day,40,70,110,36.36
2011-01-01,16,Saturday,Evening Rush,41,52,93,44.09
2011-01-01,17,Saturday,Evening Rush,15,52,67,22.39
2011-01-01,18,Saturday,Evening Rush,9,26,35,25.71
2011-01-01,19,Saturday,Evening Rush,6,31,37,16.22
2011-01-01,20,Saturday,Night,11,25,36,30.56
2011-01-01,21,Saturday,Night,3,31,34,8.82
2011-01-01,22,Saturday,Night,11,17,28,39.29
2011-01-01,23,Saturday,Night,15,24,39,38.46
2011-01-02,0,Sunday,Early Morning,4,13,17,23.53
2011-01-02,1,Sunday,Early Morning,1,16,17,5.88
2011-01-02,2,Sunday,Early Morning,1,8,9,11.11
2011-01-02,3,Sunday,Early Morning,2,4,6,33.33
2011-01-02,4,Sunday,Early Morning,2,1,3,66.67
2011-01-02,6,Sunday,Morning Rush,0,2,2,0.0
2011-01-02,7,Sunday,Morning Rush,0,1,1,0.0
2011-01-02,8,Sunday,Morning Rush,0,8,8,0.0
2011-01-02,9,Sunday,Morning Rush,1,19,20,5.0
2011-01-02,10,Sunday,Mid-Day,7,46,53,13.21
2011-01-02,11,Sunday,Mid-Day,16,54,70,22.86
2011-01-02,12,Sunday,Mid-Day,20,73,93,21.51
2011-01-02,13,Sunday,Mid-Day,11,64,75,14.67
2011-01-02,14,Sunday,Mid-Day,4,55,59,6.78
2011-01-02,15,Sunday,Mid-Day,19,55,74,25.68
2011-01-02,16,Sunday,Evening Rush,9,67,76,11.84
2011-01-02,17,Sunday,Evening Rush,7,58,65,10.77
2011-01-02,18,Sunday,Evening Rush,10,43,53,18.87
2011-01-02,19,Sunday,Evening Rush,1,29,30,3.33
2011-01-02,20,Sunday,Night,5,17,22,22.73
2011-01-02,21,Sunday,Night,11,20,31,35.48
2011-01-02,22,Sunday,Night,0,9,9,0.0
2011-01-02,23,Sunday,Night,0,8,8,0.0
2011-01-03,0,Monday,Early Morning,0,5,5,0.0
2011-01-03,1,Monday,Early Morning,0,2,2,0.0
2011-01-03,4,Monday,Early Morning,0,1,1,0.0
2011-01-03,5,Monday,Early Morning,0,3,3,0.0
2011-01-03,6,Monday,Morning Rush,0,30,30,0.0
2011-01-03,7,Monday,Morning Rush,1,63,64,1.56
2011-01-03,8,Monday,Morning Rush,1,153,154,0.65
2011-01-03,9,Monday,Morning Rush,7,81,88,7.95
2011-01-03,10,Monday,Mid-Day,11,33,44,25.0
2011-01-03,11,Monday,Mid-Day,10,41,51,19.61
2011-01-03,12,Monday,Mid-Day,13,48,61,21.31
2011-01-03,13,Monday,Mid-Day,8,53,61,13.11
2011-01-03,14,Monday,Mid-Day,11,66,77,14.29
2011-01-03,15,Monday,Mid-Day,14,58,72,19.44
2011-01-03,16,Monday,Evening Rush,9,67,76,11.84
2011-01-03,17,Monday,Evening Rush,11,146,157,7.01
2011-01-03,18,Monday,Evening Rush,9,148,157,5.73
2011-01-03,19,Monday,Evening Rush,8,102,110,7.27
2011-01-03,20,Monday,Night,3,49,52,5.77
2011-01-03,21,Monday,Night,3,49,52,5.77
2011-01-03,22,Monday,Night,0,20,20,0.0
2011-01-03,23,Monday,Night,1,11,12,8.33
2011-01-04,0,Tuesday,Early Morning,0,5,5,0.0
2011-01-04,1,Tuesday,Early Morning,0,2,2,0.0
2011-01-04,2,Tuesday,Early Morning,0,1,1,0.0
2011-01-04,4,Tuesday,Early Morning,0,2,2,0.0
2011-01-04,5,Tuesday,Early Morning,0,4,4,0.0
2011-01-04,6,Tuesday,Morning Rush,0,36,36,0.0
2011-01-04,7,Tuesday,Morning Rush,2,92,94,2.13
2011-01-04,8,Tuesday,Morning Rush,2,177,179,1.12
2011-01-04,9,Tuesday,Morning Rush,2,98,100,2.0
2011-01-04,10,Tuesday,Mid-Day,5,37,42,11.9
2011-01-04,11,Tuesday,Mid-Day,7,50,57,12.28
2011-01-04,12,Tuesday,Mid-Day,12,66,78,15.38
2011-01-04,13,Tuesday,Mid-Day,18,79,97,18.56
2011-01-04,14,Tuesday,Mid-Day,9,54,63,14.29
2011-01-04,15,Tuesday,Mid-Day,17,48,65,26.15
2011-01-04,16,Tuesday,Evening Rush,15,68,83,18.07
2011-01-04,17,Tuesday,Evening Rush,10,202,212,4.72
2011-01-04,18,Tuesday,Evening Rush,3,179,182,1.65
2011-01-04,19,Tuesday,Evening Rush,2,110,112,1.79
2011-01-04,20,Tuesday,Night,1,53,54,1.85
2011-01-04,21,Tuesday,Night,0,48,48,0.0
2011-01-04,22,Tuesday,Night,1,34,35,2.86
2011-01-04,23,Tuesday,Night,2,9,11,18.18
2011-01-05,0,Wednesday,Early Morning,0,6,6,0.0
2011-01-05,1,Wednesday,Early Morning,0,6,6,0.0
2011-01-05,2,Wednesday,Early Morning,0,2,2,0.0
2011-01-05,4,Wednesday,Early Morning,0,2,2,0.0
2011-01-05,5,Wednesday,Early Morning,0,3,3,0.0
2011-01-05,6,Wednesday,Morning Rush,0,33,33,0.0
2011-01-05,7,Wednesday,Morning Rush,1,87,88,1.14
2011-01-05,8,Wednesday,Morning Rush,3,192,195,1.54
2011-01-05,9,Wednesday,Morning Rush,6,109,115,5.22
2011-01-05,10,Wednesday,Mid-Day,4,53,57,7.02
2011-01-05,11,Wednesday,Mid-Day,12,34,46,26.09
2011-01-05,12,Wednesday,Mid-Day,5,74,79,6.33
2011-01-05,13,Wednesday,Mid-Day,6,65,71,8.45
2011-01-05,14,Wednesday,Mid-Day,10,52,62,16.13
2011-01-05,15,Wednesday,Mid-Day,7,55,62,11.29
2011-01-05,16,Wednesday,Evening Rush,4,85,89,4.49
2011-01-05,17,Wednesday,Evening Rush,4,186,190,2.11
2011-01-05,18,Wednesday,Evening Rush,3,166,169,1.78
2011-01-05,19,Wednesday,Evening Rush,5,127,132,3.79
2011-01-05,20,Wednesday,Night,7,82,89,7.87
2011-01-05,21,Wednesday,Night,3,40,43,6.98
2011-01-05,22,Wednesday,Night,1,41,42,2.38
2011-01-05,23,Wednesday,Night,1,18,19,5.26
2011-01-06,0,Thursday,Early Morning,0,11,11,0.0
2011-01-06,1,Thursday,Early Morning,0,4,4,0.0
2011-01-06,2,Thursday,Early Morning,0,2,2,0.0
2011-01-06,4,Thursday,Early Morning,0,1,1,0.0
2011-01-06,5,Thursday,Early Morning,0,4,4,0.0
2011-01-06,6,Thursday,Morning Rush,0,36,36,0.0
2011-01-06,7,Thursday,Morning Rush,0,95,95,0.0
2011-01-06,8,Thursday,Morning Rush,3,216,219,1.37
2011-01-06,9,Thursday,Morning Rush,6,116,122,4.92
2011-01-06,10,Thursday,Mid-Day,3,42,45,6.67
2011-01-06,11,Thursday,Mid-Day,2,57,59,3.39
2011-01-06,12,Thursday,Mid-Day,6,78,84,7.14
2011-01-06,13,Thursday,Mid-Day,12,55,67,17.91
2011-01-06,14,Thursday,Mid-Day,11,59,70,15.71
2011-01-06,15,Thursday,Mid-Day,8,54,62,12.9
2011-01-06,16,Thursday,Evening Rush,12,74,86,13.95
2011-01-06,17,Thursday,Evening Rush,9,163,172,5.23
2011-01-06,18,Thursday,Evening Rush,5,158,163,3.07
2011-01-06,19,Thursday,Evening Rush,3,109,112,2.68
2011-01-06,20,Thursday,Night,3,66,69,4.35
2011-01-06,21,Thursday,Night,0,48,48,0.0
2011-01-06,22,Thursday,Night,1,51,52,1.92
2011-01-06,23,Thursday,Night,4,19,23,17.39
2011-01-07,0,Friday,Early Morning,4,13,17,23.53
2011-01-07,1,Friday,Early Morning,2,5,7,28.57
2011-01-07,2,Friday,Early Morning,0,1,1,0.0
2011-01-07,4,Friday,Early Morning,0,1,1,0.0
2011-01-07,5,Friday,Early Morning,0,5,5,0.0
2011-01-07,6,Friday,Morning Rush,8,26,34,23.53
2011-01-07,7,Friday,Morning Rush,8,76,84,9.52
2011-01-07,8,Friday,Morning Rush,20,190,210,9.52
2011-01-07,9,Friday,Morning Rush,9,125,134,6.72
2011-01-07,10,Friday,Mid-Day,16,47,63,25.4
2011-01-07,11,Friday,Mid-Day,19,48,67,28.36
2011-01-07,12,Friday,Mid-Day,9,50,59,15.25
2011-01-07,13,Friday,Mid-Day,9,64,73,12.33
2011-01-07,14,Friday,Mid-Day,7,43,50,14.0
2011-01-07,15,Friday,Mid-Day,9,63,72,12.5
2011-01-07,16,Friday,Evening Rush,5,82,87,5.75
2011-01-07,17,Friday,Evening Rush,9,178,187,4.81
2011-01-07,18,Friday,Evening Rush,7,116,123,5.69
2011-01-07,19,Friday,Evening Rush,3,92,95,3.16
2011-01-07,20,Friday,Night,1,50,51,1.96
2011-01-07,21,Friday,Night,0,39,39,0.0
2011-01-07,22,Friday,Night,2,34,36,5.56
2011-01-07,23,Friday,Night,1,14,15,6.67
2011-01-08,0,Saturday,Early Morning,1,24,25,4.0
2011-01-08,1,Saturday,Early Morning,1,15,16,6.25
2011-01-08,2,Saturday,Early Morning,3,13,16,18.75
2011-01-08,3,Saturday,Early Morning,0,7,7,0.0
2011-01-08,4,Saturday,Early Morning,0,1,1,0.0
2011-01-08,5,Saturday,Early Morning,0,5,5,0.0
2011-01-08,6,Saturday,Morning Rush,0,2,2,0.0
2011-01-08,7,Saturday,Morning Rush,1,8,9,11.11
2011-01-08,8,Saturday,Morning Rush,0,15,15,0.0
2011-01-08,9,Saturday,Morning Rush,0,20,20,0.0
2011-01-08,10,Saturday,Mid-Day,5,56,61,8.2
2011-01-08,11,Saturday,Mid-Day,2,60,62,3.23
2011-01-08,12,Saturday,Mid-Day,8,90,98,8.16
2011-01-08,13,Saturday,Mid-Day,7,95,102,6.86
2011-01-08,14,Saturday,Mid-Day,12,83,95,12.63
2011-01-08,15,Saturday,Mid-Day,5,69,74,6.76
2011-01-08,16,Saturday,Evening Rush,8,68,76,10.53
2011-01-08,17,Saturday,Evening Rush,5,64,69,7.25
2011-01-08,18,Saturday,Evening Rush,3,52,55,5.45
2011-01-08,19,Saturday,Evening Rush,4,26,30,13.33
2011-01-08,20,Saturday,Night,0,28,28,0.0
2011-01-08,21,Saturday,Night,2,35,37,5.41
2011-01-08,22,Saturday,Night,1,33,34,2.94
2011-01-08,23,Saturday,Night,0,22,22,0.0
2011-01-09,0,Sunday,Early Morning,1,24,25,4.0
2011-01-09,1,Sunday,Early Morning,0,12,12,0.0
2011-01-09,2,Sunday,Early Morning,0,11,11,0.0
2011-01-09,3,Sunday,Early Morning,0,4,4,0.0
2011-01-09,4,Sunday,Early Morning,0,1,1,0.0
2011-01-09,5,Sunday,Early Morning,0,1,1,0.0
2011-01-09,6,Sunday,Morning Rush,0,1,1,0.0
2011-01-09,7,Sunday,Morning Rush,1,5,6,16.67
2011-01-09,8,Sunday,Morning Rush,0,10,10,0.0
2011-01-09,9,Sunday,Morning Rush,0,19,19,0.0
2011-01-09,10,Sunday,Mid-Day,0,49,49,0.0
2011-01-09,11,Sunday,Mid-Day,2,47,49,4.08
2011-01-09,12,Sunday,Mid-Day,4,79,83,4.82
2011-01-09,13,Sunday,Mid-Day,6,69,75,8.0
2011-01-09,14,Sunday,Mid-Day,8,64,72,11.11
2011-01-09,15,Sunday,Mid-Day,5,77,82,6.1
2011-01-09,16,Sunday,Evening Rush,13,79,92,14.13
2011-01-09,17,Sunday,Evening Rush,3,59,62,4.84
2011-01-09,18,Sunday,Evening Rush,4,44,48,8.33
2011-01-09,19,Sunday,Evening Rush,1,40,41,2.44
2011-01-09,20,Sunday,Night,0,38,38,0.0
2011-01-09,21,Sunday,Night,1,19,20,5.0
2011-01-09,22,Sunday,Night,5,10,15,33.33
2011-01-09,23,Sunday,Night,0,6,6,0.0
2011-01-10,0,Monday,Early Morning,2,3,5,40.0
2011-01-10,1,Monday,Early Morning,1,0,1,100.0
2011-01-10,2,Monday,Early Morning,0,3,3,0.0
2011-01-10,3,Monday,Early Morning,0,1,1,0.0
2011-01-10,4,Monday,Early Morning,1,2,3,33.33
2011-01-10,5,Monday,Early Morning,0,3,3,0.0
2011-01-10,6,Monday,Morning Rush,0,31,31,0.0
2011-01-10,7,Monday,Morning Rush,2,75,77,2.6
2011-01-10,8,Monday,Morning Rush,4,184,188,2.13
2011-01-10,9,Monday,Morning Rush,2,92,94,2.13
2011-01-10,10,Monday,Mid-Day,0,31,31,0.0
2011-01-10,11,Monday,Mid-Day,2,28,30,6.67
2011-01-10,12,Monday,Mid-Day,5,47,52,9.62
2011-01-10,13,Monday,Mid-Day,4,50,54,7.41
2011-01-10,14,Monday,Mid-Day,0,47,47,0.0
2011-01-10,15,Monday,Mid-Day,2,43,45,4.44
2011-01-10,16,Monday,Evening Rush,4,70,74,5.41
2011-01-10,17,Monday,Evening Rush,4,174,178,2.25
2011-01-10,18,Monday,Evening Rush,1,154,155,0.65
2011-01-10,19,Monday,Evening Rush,3,92,95,3.16
2011-01-10,20,Monday,Night,1,73,74,1.35
2011-01-10,21,Monday,Night,1,37,38,2.63
2011-01-10,22,Monday,Night,2,22,24,8.33
2011-01-10,23,Monday,Night,0,18,18,0.0
2011-01-11,0,Tuesday,Early Morning,2,10,12,16.67
2011-01-11,1,Tuesday,Early Morning,0,3,3,0.0
2011-01-11,2,Tuesday,Early Morning,0,3,3,0.0
2011-01-11,5,Tuesday,Early Morning,0,6,6,0.0
2011-01-11,6,Tuesday,Morning Rush,0,27,27,0.0
2011-01-11,7,Tuesday,Morning Rush,2,97,99,2.02
2011-01-11,8,Tuesday,Morning Rush,3,214,217,1.38
2011-01-11,9,Tuesday,Morning Rush,3,127,130,2.31
2011-01-11,10,Tuesday,Mid-Day,3,51,54,5.56
2011-01-11,11,Tuesday,Mid-Day,4,31,35,11.43
2011-01-11,12,Tuesday,Mid-Day,2,55,57,3.51
2011-01-11,13,Tuesday,Mid-Day,6,46,52,11.54
2011-01-11,14,Tuesday,Mid-Day,3,60,63,4.76
2011-01-11,15,Tuesday,Mid-Day,2,45,47,4.26
2011-01-11,16,Tuesday,Evening Rush,4,72,76,5.26
2011-01-11,17,Tuesday,Evening Rush,6,130,136,4.41
2011-01-11,18,Tuesday,Evening Rush,1,94,95,1.05
2011-01-11,19,Tuesday,Evening Rush,0,51,51,0.0
2011-01-11,20,Tuesday,Night,0,32,32,0.0
2011-01-11,21,Tuesday,Night,0,20,20,0.0
2011-01-11,22,Tuesday,Night,1,28,29,3.45
2011-01-11,23,Tuesday,Night,1,18,19,5.26
2011-01-12,0,Wednesday,Early Morning,0,7,7,0.0
2011-01-12,1,Wednesday,Early Morning,0,6,6,0.0
2011-01-12,2,Wednesday,Early Morning,0,1,1,0.0
2011-01-12,5,Wednesday,Early Morning,0,5,5,0.0
2011-01-12,6,Wednesday,Morning Rush,0,16,16,0.0
2011-01-12,7,Wednesday,Morning Rush,0,54,54,0.0
2011-01-12,8,Wednesday,Morning Rush,3,125,128,2.34
2011-01-12,9,Wednesday,Morning Rush,3,78,81,3.7
2011-01-12,10,Wednesday,Mid-Day,0,39,39,0.0
2011-01-12,11,Wednesday,Mid-Day,3,32,35,8.57
2011-01-12,12,Wednesday,Mid-Day,3,52,55,5.45
2011-01-12,13,Wednesday,Mid-Day,0,49,49,0.0
2011-01-12,14,Wednesday,Mid-Day,0,44,44,0.0
2011-01-12,15,Wednesday,Mid-Day,1,48,49,2.04
2011-01-12,16,Wednesday,Evening Rush,5,63,68,7.35
2011-01-12,17,Wednesday,Evening Rush,0,139,139,0.0
2011-01-12,18,Wednesday,Evening Rush,2,135,137,1.46
2011-01-12,19,Wednesday,Evening Rush,1,82,83,1.2
2011-01-12,20,Wednesday,Night,2,54,56,3.57
2011-01-12,21,Wednesday,Night,0,57,57,0.0
2011-01-12,22,Wednesday,Night,1,32,33,3.03
2011-01-12,23,Wednesday,Night,1,19,20,5.0
2011-01-13,0,Thursday,Early Morning,1,6,7,14.29
2011-01-13,1,Thursday,Early Morning,0,2,2,0.0
2011-01-13,2,Thursday,Early Morning,0,2,2,0.0
2011-01-13,3,Thursday,Early Morning,0,3,3,0.0
2011-01-13,4,Thursday,Early Morning,0,4,4,0.0
2011-01-13,5,Thursday,Early Morning,0,3,3,0.0
2011-01-13,6,Thursday,Morning Rush,0,28,28,0.0
2011-01-13,7,Thursday,Morning Rush,0,72,72,0.0
2011-01-13,8,Thursday,Morning Rush,5,197,202,2.48
2011-01-13,9,Thursday,Morning Rush,2,137,139,1.44
2011-01-13,10,Thursday,Mid-Day,2,36,38,5.26
2011-01-13,11,Thursday,Mid-Day,4,33,37,10.81
2011-01-13,12,Thursday,Mid-Day,3,49,52,5.77
2011-01-13,13,Thursday,Mid-Day,2,81,83,2.41
2011-01-13,14,Thursday,Mid-Day,3,39,42,7.14
2011-01-13,15,Thursday,Mid-Day,5,55,60,8.33
2011-01-13,16,Thursday,Evening Rush,2,76,78,2.56
2011-01-13,17,Thursday,Evening Rush,4,158,162,2.47
2011-01-13,18,Thursday,Evening Rush,3,141,144,2.08
2011-01-13,19,Thursday,Evening Rush,1,98,99,1.01
2011-01-13,20,Thursday,Night,0,64,64,0.0
2011-01-13,21,Thursday,Night,0,40,40,0.0
2011-01-13,22,Thursday,Night,0,30,30,0.0
2011-01-13,23,Thursday,Night,1,14,15,6.67
2011-01-14,0,Friday,Early Morning,0,14,14,0.0
2011-01-14,1,Friday,Early Morning,0,5,5,0.0
2011-01-14,2,Friday,Early Morning,0,1,1,0.0
2011-01-14,3,Friday,Early Morning,0,1,1,0.0
2011-01-14,5,Friday,Early Morning,0,8,8,0.0
2011-01-14,6,Friday,Morning Rush,0,17,17,0.0
2011-01-14,7,Friday,Morning Rush,0,70,70,0.0
2011-01-14,8,Friday,Morning Rush,2,156,158,1.27
2011-01-14,9,Friday,Morning Rush,0,117,117,0.0
2011-01-14,10,Friday,Mid-Day,4,40,44,9.09
2011-01-14,11,Friday,Mid-Day,6,47,53,11.32
2011-01-14,12,Friday,Mid-Day,2,59,61,3.28
2011-01-14,13,Friday,Mid-Day,4,73,77,5.19
2011-01-14,14,Friday,Mid-Day,5,59,64,7.81
2011-01-14,15,Friday,Mid-Day,9,59,68,13.24
2011-01-14,16,Friday,Evening Rush,3,87,90,3.33
2011-01-14,17,Friday,Evening Rush,4,155,159,2.52
2011-01-14,18,Friday,Evening Rush,5,134,139,3.6
2011-01-14,19,Friday,Evening Rush,3,89,92,3.26
2011-01-14,20,Friday,Night,0,68,68,0.0
2011-01-14,21,Friday,Night,4,48,52,7.69
2011-01-14,22,Friday,Night,2,34,36,5.56
2011-01-14,23,Friday,Night,1,26,27,3.7
2011-01-15,0,Saturday,Early Morning,3,25,28,10.71
2011-01-15,1,Saturday,Early Morning,2,18,20,10.0
2011-01-15,2,Saturday,Early Morning,0,12,12,0.0
2011-01-15,3,Saturday,Early Morning,1,7,8,12.5
2011-01-15,4,Saturday,Early Morning,0,5,5,0.0
2011-01-15,5,Saturday,Early Morning,0,1,1,0.0
2011-01-15,6,Saturday,Morning Rush,1,2,3,33.33
2011-01-15,7,Saturday,Morning Rush,1,9,10,10.0
2011-01-15,8,Saturday,Morning Rush,1,22,23,4.35
2011-01-15,9,Saturday,Morning Rush,2,31,33,6.06
2011-01-15,10,Saturday,Mid-Day,2,57,59,3.39
2011-01-15,11,Saturday,Mid-Day,18,54,72,25.0
2011-01-15,12,Saturday,Mid-Day,15,74,89,16.85
2011-01-15,13,Saturday,Mid-Day,21,80,101,20.79
2011-01-15,14,Saturday,Mid-Day,26,92,118,22.03
2011-01-15,15,Saturday,Mid-Day,21,108,129,16.28
2011-01-15,16,Saturday,Evening Rush,33,95,128,25.78
2011-01-15,17,Saturday,Evening Rush,29,54,83,34.94
2011-01-15,18,Saturday,Evening Rush,15,69,84,17.86
2011-01-15,19,Saturday,Evening Rush,14,60,74,18.92
2011-01-15,20,Saturday,Night,6,35,41,14.63
2011-01-15,21,Saturday,Night,6,51,57,10.53
2011-01-15,22,Saturday,Night,0,26,26,0.0
2011-01-15,23,Saturday,Night,5,39,44,11.36
2011-01-16,0,Sunday,Early Morning,6,33,39,15.38
2011-01-16,1,Sunday,Early Morning,4,19,23,17.39
2011-01-16,2,Sunday,Early Morning,3,13,16,18.75
2011-01-16,3,Sunday,Early Morning,9,6,15,60.0
2011-01-16,4,Sunday,Early Morning,0,1,1,0.0
2011-01-16,5,Sunday,Early Morning,1,1,2,50.0
2011-01-16,6,Sunday,Morning Rush,0,1,1,0.0
2011-01-16,7,Sunday,Morning Rush,0,3,3,0.0
2011-01-16,8,Sunday,Morning Rush,0,18,18,0.0
2011-01-16,9,Sunday,Morning Rush,3,29,32,9.38
2011-01-16,10,Sunday,Mid-Day,8,71,79,10.13
2011-01-16,11,Sunday,Mid-Day,23,70,93,24.73
2011-01-16,12,Sunday,Mid-Day,29,75,104,27.88
2011-01-16,13,Sunday,Mid-Day,23,95,118,19.49
2011-01-16,14,Sunday,Mid-Day,22,69,91,24.18
2011-01-16,15,Sunday,Mid-Day,35,78,113,30.97
2011-01-16,16,Sunday,Evening Rush,22,77,99,22.22
2011-01-16,17,Sunday,Evening Rush,23,82,105,21.9
2011-01-16,18,Sunday,Evening Rush,11,56,67,16.42
2011-01-16,19,Sunday,Evening Rush,14,47,61,22.95
2011-01-16,20,Sunday,Night,7,50,57,12.28
2011-01-16,21,Sunday,Night,6,22,28,21.43
2011-01-16,22,Sunday,Night,2,19,21,9.52
2011-01-16,23,Sunday,Night,0,18,18,0.0
2011-01-17,0,Monday,Early Morning,1,16,17,5.88
2011-01-17,1,Monday,Early Morning,1,15,16,6.25
2011-01-17,2,Monday,Early Morning,0,8,8,0.0
2011-01-17,3,Monday,Early Morning,0,2,2,0.0
2011-01-17,4,Monday,Early Morning,1,2,3,33.33
2011-01-17,5,Monday,Early Morning,0,1,1,0.0
2011-01-17,6,Monday,Morning Rush,0,5,5,0.0
2011-01-17,7,Monday,Morning Rush,4,9,13,30.77
2011-01-17,8,Monday,Morning Rush,3,30,33,9.09
2011-01-17,9,Monday,Morning Rush,8,39,47,17.02
2011-01-17,10,Monday,Mid-Day,7,50,57,12.28
2011-01-17,11,Monday,Mid-Day,9,55,64,14.06
2011-01-17,12,Monday,Mid-Day,10,70,80,12.5
2011-01-17,13,Monday,Mid-Day,13,80,93,13.98
2011-01-17,14,Monday,Mid-Day,12,74,86,13.95
2011-01-17,15,Monday,Mid-Day,21,72,93,22.58
2011-01-17,16,Monday,Evening Rush,6,76,82,7.32
2011-01-17,17,Monday,Evening Rush,4,67,71,5.63
2011-01-17,18,Monday,Evening Rush,7,85,92,7.61
2011-01-17,19,Monday,Evening Rush,2,58,60,3.33
2011-01-17,20,Monday,Night,4,29,33,12.12
2011-01-17,21,Monday,Night,3,24,27,11.11
2011-01-17,22,Monday,Night,0,13,13,0.0
2011-01-17,23,Monday,Night,1,3,4,25.0
2011-01-18,12,Tuesday,Mid-Day,0,3,3,0.0
2011-01-18,13,Tuesday,Mid-Day,0,22,22,0.0
2011-01-18,14,Tuesday,Mid-Day,2,26,28,7.14
2011-01-18,15,Tuesday,Mid-Day,3,32,35,8.57
2011-01-18,16,Tuesday,Evening Rush,0,61,61,0.0
2011-01-18,17,Tuesday,Evening Rush,1,124,125,0.8
2011-01-18,18,Tuesday,Evening Rush,1,132,133,0.75
2011-01-18,19,Tuesday,Evening Rush,1,98,99,1.01
2011-01-18,20,Tuesday,Night,0,83,83,0.0
2011-01-18,21,Tuesday,Night,0,41,41,0.0
2011-01-18,22,Tuesday,Night,0,33,33,0.0
2011-01-18,23,Tuesday,Night,1,19,20,5.0
2011-01-19,0,Wednesday,Early Morning,0,3,3,0.0
2011-01-19,1,Wednesday,Early Morning,1,6,7,14.29
2011-01-19,2,Wednesday,Early Morning,0,3,3,0.0
2011-01-19,4,Wednesday,Early Morning,1,1,2,50.0
2011-01-19,5,Wednesday,Early Morning,0,7,7,0.0
2011-01-19,6,Wednesday,Morning Rush,0,32,32,0.0
2011-01-19,7,Wednesday,Morning Rush,1,89,90,1.11
2011-01-19,8,Wednesday,Morning Rush,1,196,197,0.51
2011-01-19,9,Wednesday,Morning Rush,2,107,109,1.83
2011-01-19,10,Wednesday,Mid-Day,1,46,47,2.13
2011-01-19,11,Wednesday,Mid-Day,5,47,52,9.62
2011-01-19,12,Wednesday,Mid-Day,5,65,70,7.14
2011-01-19,13,Wednesday,Mid-Day,11,67,78,14.1
2011-01-19,14,Wednesday,Mid-Day,7,68,75,9.33
2011-01-19,15,Wednesday,Mid-Day,4,78,82,4.88
2011-01-19,16,Wednesday,Evening Rush,10,94,104,9.62
2011-01-19,17,Wednesday,Evening Rush,7,190,197,3.55
2011-01-19,18,Wednesday,Evening Rush,5,156,161,3.11
2011-01-19,19,Wednesday,Evening Rush,4,108,112,3.57
2011-01-19,20,Wednesday,Night,2,74,76,2.63
2011-01-19,21,Wednesday,Night,4,55,59,6.78
2011-01-19,22,Wednesday,Night,6,53,59,10.17
2011-01-19,23,Wednesday,Night,1,27,28,3.57
2011-01-20,0,Thursday,Early Morning,5,8,13,38.46
2011-01-20,1,Thursday,Early Morning,2,3,5,40.0
2011-01-20,2,Thursday,Early Morning,0,2,2,0.0
2011-01-20,3,Thursday,Early Morning,0,1,1,0.0
2011-01-20,4,Thursday,Early Morning,0,1,1,0.0
2011-01-20,5,Thursday,Early Morning,0,6,6,0.0
2011-01-20,6,Thursday,Morning Rush,0,35,35,0.0
2011-01-20,7,Thursday,Morning Rush,1,100,101,0.99
2011-01-20,8,Thursday,Morning Rush,2,247,249,0.8
2011-01-20,9,Thursday,Morning Rush,3,140,143,2.1
2011-01-20,10,Thursday,Mid-Day,1,56,57,1.75
2011-01-20,11,Thursday,Mid-Day,5,63,68,7.35
2011-01-20,12,Thursday,Mid-Day,7,77,84,8.33
2011-01-20,13,Thursday,Mid-Day,12,86,98,12.24
2011-01-20,14,Thursday,Mid-Day,6,75,81,7.41
2011-01-20,15,Thursday,Mid-Day,8,62,70,11.43
2011-01-20,16,Thursday,Evening Rush,8,83,91,8.79
2011-01-20,17,Thursday,Evening Rush,8,207,215,3.72
2011-01-20,18,Thursday,Evening Rush,1,184,185,0.54
2011-01-20,19,Thursday,Evening Rush,6,146,152,3.95
2011-01-20,20,Thursday,Night,2,124,126,1.59
2011-01-20,21,Thursday,Night,3,54,57,5.26
2011-01-20,22,Thursday,Night,0,56,56,0.0
2011-01-20,23,Thursday,Night,3,28,31,9.68
2011-01-21,0,Friday,Early Morning,1,20,21,4.76
2011-01-21,1,Friday,Early Morning,0,6,6,0.0
2011-01-21,2,Friday,Early Morning,0,2,2,0.0
2011-01-21,3,Friday,Early Morning,0,1,1,0.0
2011-01-21,4,Friday,Early Morning,0,1,1,0.0
2011-01-21,5,Friday,Early Morning,1,4,5,20.0
2011-01-21,6,Friday,Morning Rush,0,27,27,0.0
2011-01-21,7,Friday,Morning Rush,2,66,68,2.94
2011-01-21,8,Friday,Morning Rush,7,210,217,3.23
2011-01-21,9,Friday,Morning Rush,7,159,166,4.22
2011-01-21,10,Friday,Mid-Day,6,57,63,9.52
2011-01-21,11,Friday,Mid-Day,6,53,59,10.17
2011-01-21,12,Friday,Mid-Day,11,67,78,14.1
2011-01-21,13,Friday,Mid-Day,8,65,73,10.96
2011-01-21,14,Friday,Mid-Day,6,56,62,9.68
2011-01-21,15,Friday,Mid-Day,4,61,65,6.15
2011-01-21,16,Friday,Evening Rush,0,97,97,0.0
2011-01-21,17,Friday,Evening Rush,10,151,161,6.21
2011-01-21,18,Friday,Evening Rush,1,119,120,0.83
2011-01-21,19,Friday,Evening Rush,3,93,96,3.13
2011-01-21,20,Friday,Night,1,52,53,1.89
2011-01-21,21,Friday,Night,0,41,41,0.0
2011-01-21,22,Friday,Night,1,33,34,2.94
2011-01-21,23,Friday,Night,0,27,27,0.0
2011-01-22,0,Saturday,Early Morning,0,13,13,0.0
2011-01-22,1,Saturday,Early Morning,3,9,12,25.0
2011-01-22,2,Saturday,Early Morning,0,11,11,0.0
2011-01-22,3,Saturday,Early Morning,1,6,7,14.29
2011-01-22,4,Saturday,Early Morning,0,3,3,0.0
2011-01-22,6,Saturday,Morning Rush,0,2,2,0.0
2011-01-22,7,Saturday,Morning Rush,0,8,8,0.0
2011-01-22,8,Saturday,Morning Rush,1,26,27,3.7
2011-01-22,9,Saturday,Morning Rush,3,37,40,7.5
2011-01-22,10,Saturday,Mid-Day,3,50,53,5.66
2011-01-22,11,Saturday,Mid-Day,4,59,63,6.35
2011-01-22,12,Saturday,Mid-Day,10,60,70,14.29
2011-01-22,13,Saturday,Mid-Day,12,72,84,14.29
2011-01-22,14,Saturday,Mid-Day,11,64,75,14.67
2011-01-22,15,Saturday,Mid-Day,10,93,103,9.71
2011-01-22,16,Saturday,Evening Rush,11,72,83,13.25
2011-01-22,17,Saturday,Evening Rush,8,59,67,11.94
2011-01-22,18,Saturday,Evening Rush,0,54,54,0.0
2011-01-22,19,Saturday,Evening Rush,6,53,59,10.17
2011-01-22,20,Saturday,Night,1,44,45,2.22
2011-01-22,21,Saturday,Night,0,39,39,0.0
2011-01-22,22,Saturday,Night,7,23,30,23.33
2011-01-22,23,Saturday,Night,2,31,33,6.06
2011-01-23,0,Sunday,Early Morning,2,20,22,9.09
2011-01-23,1,Sunday,Early Morning,1,12,13,7.69
2011-01-23,2,Sunday,Early Morning,3,15,18,16.67
2011-01-23,3,Sunday,Early Morning,1,4,5,20.0
2011-01-23,5,Sunday,Early Morning,0,3,3,0.0
2011-01-23,6,Sunday,Morning Rush,0,1,1,0.0
2011-01-23,7,Sunday,Morning Rush,1,1,2,50.0
2011-01-23,8,Sunday,Morning Rush,2,17,19,10.53
2011-01-23,9,Sunday,Morning Rush,3,25,28,10.71
2011-01-23,10,Sunday,Mid-Day,7,51,58,12.07
2011-01-23,11,Sunday,Mid-Day,22,77,99,22.22
2011-01-23,12,Sunday,Mid-Day,24,92,116,20.69
2011-01-23,13,Sunday,Mid-Day,12,75,87,13.79
2011-01-23,14,Sunday,Mid-Day,17,93,110,15.45
2011-01-23,15,Sunday,Mid-Day,13,64,77,16.88
2011-01-23,16,Sunday,Evening Rush,9,56,65,13.85
2011-01-23,17,Sunday,Evening Rush,5,50,55,9.09
2011-01-23,18,Sunday,Evening Rush,5,44,49,10.2
2011-01-23,19,Sunday,Evening Rush,5,45,50,10.0
2011-01-23,20,Sunday,Night,4,31,35,11.43
2011-01-23,21,Sunday,Night,5,20,25,20.0
2011-01-23,22,Sunday,Night,5,23,28,17.86
2011-01-23,23,Sunday,Night,4,17,21,19.05
2011-01-24,0,Monday,Early Morning,0,7,7,0.0
2011-01-24,1,Monday,Early Morning,0,1,1,0.0
2011-01-24,3,Monday,Early Morning,0,1,1,0.0
2011-01-24,4,Monday,Early Morning,0,1,1,0.0
2011-01-24,5,Monday,Early Morning,0,5,5,0.0
2011-01-24,6,Monday,Morning Rush,0,15,15,0.0
2011-01-24,7,Monday,Morning Rush,5,79,84,5.95
2011-01-24,8,Monday,Morning Rush,6,171,177,3.39
2011-01-24,9,Monday,Morning Rush,4,98,102,3.92
2011-01-24,10,Monday,Mid-Day,6,34,40,15.0
2011-01-24,11,Monday,Mid-Day,3,43,46,6.52
2011-01-24,12,Monday,Mid-Day,11,52,63,17.46
2011-01-24,13,Monday,Mid-Day,6,54,60,10.0
2011-01-24,14,Monday,Mid-Day,2,43,45,4.44
2011-01-24,15,Monday,Mid-Day,7,50,57,12.28
2011-01-24,16,Monday,Evening Rush,4,66,70,5.71
2011-01-24,17,Monday,Evening Rush,6,178,184,3.26
2011-01-24,18,Monday,Evening Rush,8,145,153,5.23
2011-01-24,19,Monday,Evening Rush,5,101,106,4.72
2011-01-24,20,Monday,Night,1,80,81,1.23
2011-01-24,21,Monday,Night,6,53,59,10.17
2011-01-24,22,Monday,Night,3,32,35,8.57
2011-01-24,23,Monday,Night,3,21,24,12.5
2011-01-25,0,Tuesday,Early Morning,3,6,9,33.33
2011-01-25,1,Tuesday,Early Morning,0,5,5,0.0
2011-01-25,2,Tuesday,Early Morning,0,2,2,0.0
2011-01-25,4,Tuesday,Early Morning,0,1,1,0.0
2011-01-25,5,Tuesday,Early Morning,0,9,9,0.0
2011-01-25,6,Tuesday,Morning Rush,1,35,36,2.78
2011-01-25,7,Tuesday,Morning Rush,5,103,108,4.63
2011-01-25,8,Tuesday,Morning Rush,5,233,238,2.1
2011-01-25,9,Tuesday,Morning Rush,10,134,144,6.94
2011-01-25,10,Tuesday,Mid-Day,6,49,55,10.91
2011-01-25,11,Tuesday,Mid-Day,6,55,61,9.84
2011-01-25,12,Tuesday,Mid-Day,21,85,106,19.81
2011-01-25,13,Tuesday,Mid-Day,21,72,93,22.58
2011-01-25,14,Tuesday,Mid-Day,11,57,68,16.18
2011-01-25,15,Tuesday,Mid-Day,21,63,84,25.0
2011-01-25,16,Tuesday,Evening Rush,14,102,116,12.07
2011-01-25,17,Tuesday,Evening Rush,14,208,222,6.31
2011-01-25,18,Tuesday,Evening Rush,7,218,225,3.11
2011-01-25,19,Tuesday,Evening Rush,13,133,146,8.9
2011-01-25,20,Tuesday,Night,16,103,119,13.45
2011-01-25,21,Tuesday,Night,5,40,45,11.11
2011-01-25,22,Tuesday,Night,4,49,53,7.55
2011-01-25,23,Tuesday,Night,3,37,40,7.5
2011-01-26,0,Wednesday,Early Morning,3,14,17,17.65
2011-01-26,1,Wednesday,Early Morning,0,5,5,0.0
2011-01-26,2,Wednesday,Early Morning,3,7,10,30.0
2011-01-26,5,Wednesday,Early Morning,0,1,1,0.0
2011-01-26,6,Wednesday,Morning Rush,0,8,8,0.0
2011-01-26,7,Wednesday,Morning Rush,1,29,30,3.33
2011-01-26,8,Wednesday,Morning Rush,3,69,72,4.17
2011-01-26,9,Wednesday,Morning Rush,3,55,58,5.17
2011-01-26,10,Wednesday,Mid-Day,2,26,28,7.14
2011-01-26,11,Wednesday,Mid-Day,6,35,41,14.63
2011-01-26,12,Wednesday,Mid-Day,7,41,48,14.58
2011-01-26,13,Wednesday,Mid-Day,4,43,47,8.51
2011-01-26,14,Wednesday,Mid-Day,0,36,36,0.0
2011-01-26,15,Wednesday,Mid-Day,1,42,43,2.33
2011-01-26,16,Wednesday,Evening Rush,1,35,36,2.78
2011-01-26,17,Wednesday,Evening Rush,0,26,26,0.0
2011-01-27,16,Thursday,Evening Rush,1,23,24,4.17
2011-01-27,17,Thursday,Evening Rush,2,82,84,2.38
2011-01-27,18,Thursday,Evening Rush,3,101,104,2.88
2011-01-27,19,Thursday,Evening Rush,3,76,79,3.8
2011-01-27,20,Thursday,Night,4,55,59,6.78
2011-01-27,21,Thursday,Night,2,36,38,5.26
2011-01-27,22,Thursday,Night,0,27,27,0.0
2011-01-27,23,Thursday,Night,0,16,16,0.0
2011-01-28,0,Friday,Early Morning,0,9,9,0.0
2011-01-28,1,Friday,Early Morning,1,2,3,33.33
2011-01-28,2,Friday,Early Morning,0,2,2,0.0
2011-01-28,3,Friday,Early Morning,1,0,1,100.0
2011-01-28,5,Friday,Early Morning,0,4,4,0.0
2011-01-28,6,Friday,Morning Rush,0,16,16,0.0
2011-01-28,7,Friday,Morning Rush,2,58,60,3.33
2011-01-28,8,Friday,Morning Rush,2,155,157,1.27
2011-01-28,9,Friday,Morning Rush,6,95,101,5.94
2011-01-28,10,Friday,Mid-Day,0,49,49,0.0
2011-01-28,11,Friday,Mid-Day,0,30,30,0.0
2011-01-28,12,Friday,Mid-Day,1,28,29,3.45
2011-01-28,13,Friday,Mid-Day,0,31,31,0.0
2011-01-28,14,Friday,Mid-Day,2,36,38,5.26
2011-01-28,15,Friday,Mid-Day,1,40,41,2.44
2011-01-28,16,Friday,Evening Rush,10,70,80,12.5
2011-01-28,17,Friday,Evening Rush,2,147,149,1.34
2011-01-28,18,Friday,Evening Rush,2,107,109,1.83
2011-01-28,19,Friday,Evening Rush,5,84,89,5.62
2011-01-28,20,Friday,Night,1,61,62,1.61
2011-01-28,21,Friday,Night,1,57,58,1.72
2011-01-28,22,Friday,Night,0,26,26,0.0
2011-01-28,23,Friday,Night,1,22,23,4.35
2011-01-29,0,Saturday,Early Morning,2,26,28,7.14
2011-01-29,1,Saturday,Early Morning,0,20,20,0.0
2011-01-29,2,Saturday,Early Morning,0,15,15,0.0
2011-01-29,3,Saturday,Early Morning,3,5,8,37.5
2011-01-29,4,Saturday,Early Morning,1,2,3,33.33
2011-01-29,6,Saturday,Morning Rush,0,2,2,0.0
2011-01-29,7,Saturday,Morning Rush,1,4,5,20.0
2011-01-29,8,Saturday,Morning Rush,3,31,34,8.82
2011-01-29,9,Saturday,Morning Rush,0,34,34,0.0
2011-01-29,10,Saturday,Mid-Day,4,51,55,7.27
2011-01-29,11,Saturday,Mid-Day,4,60,64,6.25
2011-01-29,12,Saturday,Mid-Day,12,66,78,15.38
2011-01-29,13,Saturday,Mid-Day,9,56,65,13.85
2011-01-29,14,Saturday,Mid-Day,10,89,99,10.1
2011-01-29,15,Saturday,Mid-Day,22,98,120,18.33
2011-01-29,16,Saturday,Evening Rush,19,88,107,17.76
2011-01-29,17,Saturday,Evening Rush,9,82,91,9.89
2011-01-29,18,Saturday,Evening Rush,9,59,68,13.24
2011-01-29,19,Saturday,Evening Rush,6,52,58,10.34
2011-01-29,20,Saturday,Night,1,42,43,2.33
2011-01-29,21,Saturday,Night,1,35,36,2.78
2011-01-29,22,Saturday,Night,4,28,32,12.5
2011-01-29,23,Saturday,Night,3,30,33,9.09
2011-01-30,0,Sunday,Early Morning,0,33,33,0.0
2011-01-30,1,Sunday,Early Morning,7,22,29,24.14
2011-01-30,2,Sunday,Early Morning,1,10,11,9.09
2011-01-30,3,Sunday,Early Morning,1,7,8,12.5
2011-01-30,4,Sunday,Early Morning,0,1,1,0.0
2011-01-30,5,Sunday,Early Morning,0,3,3,0.0
2011-01-30,7,Sunday,Morning Rush,0,3,3,0.0
2011-01-30,8,Sunday,Morning Rush,1,11,12,8.33
2011-01-30,9,Sunday,Morning Rush,4,34,38,10.53
2011-01-30,10,Sunday,Mid-Day,7,57,64,10.94
2011-01-30,11,Sunday,Mid-Day,9,50,59,15.25
2011-01-30,12,Sunday,Mid-Day,10,87,97,10.31
2011-01-30,13,Sunday,Mid-Day,13,71,84,15.48
2011-01-30,14,Sunday,Mid-Day,18,104,122,14.75
2011-01-30,15,Sunday,Mid-Day,14,95,109,12.84
2011-01-30,16,Sunday,Evening Rush,19,104,123,15.45
2011-01-30,17,Sunday,Evening Rush,6,71,77,7.79
2011-01-30,18,Sunday,Evening Rush,8,57,65,12.31
2011-01-30,19,Sunday,Evening Rush,9,46,55,16.36
2011-01-30,20,Sunday,Night,3,30,33,9.09
2011-01-30,21,Sunday,Night,3,25,28,10.71
2011-01-30,22,Sunday,Night,2,19,21,9.52
2011-01-30,23,Sunday,Night,5,16,21,23.81
2011-01-31,0,Monday,Early Morning,1,6,7,14.29
2011-01-31,1,Monday,Early Morning,2,5,7,28.57
2011-01-31,2,Monday,Early Morning,0,1,1,0.0
2011-01-31,3,Monday,Early Morning,0,2,2,0.0
2011-01-31,4,Monday,Early Morning,0,2,2,0.0
2011-01-31,5,Monday,Early Morning,0,8,8,0.0
2011-01-31,6,Monday,Morning Rush,0,37,37,0.0
2011-01-31,7,Monday,Morning Rush,1,71,72,1.39
2011-01-31,8,Monday,Morning Rush,3,182,185,1.62
2011-01-31,9,Monday,Morning Rush,0,112,112,0.0
2011-01-31,10,Monday,Mid-Day,1,68,69,1.45
2011-01-31,11,Monday,Mid-Day,2,46,48,4.17
2011-01-31,12,Monday,Mid-Day,6,62,68,8.82
2011-01-31,13,Monday,Mid-Day,2,52,54,3.7
2011-01-31,14,Monday,Mid-Day,1,85,86,1.16
2011-01-31,15,Monday,Mid-Day,3,41,44,6.82
2011-01-31,16,Monday,Evening Rush,3,83,86,3.49
2011-01-31,17,Monday,Evening Rush,6,155,161,3.73
2011-01-31,18,Monday,Evening Rush,3,153,156,1.92
2011-01-31,19,Monday,Evening Rush,3,108,111,2.7
2011-01-31,20,Monday,Night,0,78,78,0.0
2011-01-31,21,Monday,Night,3,53,56,5.36
2011-01-31,22,Monday,Night,0,34,34,0.0
2011-01-31,23,Monday,Night,2,15,17,11.76
2011-02-01,0,Tuesday,Early Morning,2,6,8,25.0
2011-02-01,1,Tuesday,Early Morning,0,3,3,0.0
2011-02-01,2,Tuesday,Early Morning,0,2,2,0.0
2011-02-01,3,Tuesday,Early Morning,0,2,2,0.0
2011-02-01,5,Tuesday,Early Morning,0,3,3,0.0
2011-02-01,6,Tuesday,Morning Rush,0,22,22,0.0
2011-02-01,7,Tuesday,Morning Rush,0,52,52,0.0
2011-02-01,8,Tuesday,Morning Rush,3,132,135,2.22
2011-02-01,9,Tuesday,Morning Rush,2,114,116,1.72
2011-02-01,10,Tuesday,Mid-Day,0,47,47,0.0
2011-02-01,11,Tuesday,Mid-Day,2,49,51,3.92
2011-02-01,12,Tuesday,Mid-Day,2,53,55,3.64
2011-02-01,13,Tuesday,Mid-Day,3,49,52,5.77
2011-02-01,14,Tuesday,Mid-Day,5,49,54,9.26
2011-02-01,15,Tuesday,Mid-Day,7,45,52,13.46
2011-02-01,16,Tuesday,Evening Rush,3,61,64,4.69
2011-02-01,17,Tuesday,Evening Rush,4,172,176,2.27
2011-02-01,18,Tuesday,Evening Rush,3,165,168,1.79
2011-02-01,19,Tuesday,Evening Rush,3,105,108,2.78
2011-02-01,20,Tuesday,Night,5,69,74,6.76
2011-02-01,21,Tuesday,Night,0,64,64,0.0
2011-02-01,22,Tuesday,Night,2,34,36,5.56
2011-02-01,23,Tuesday,Night,1,15,16,6.25
2011-02-02,0,Wednesday,Early Morning,0,2,2,0.0
2011-02-02,1,Wednesday,Early Morning,0,3,3,0.0
2011-02-02,2,Wednesday,Early Morning,4,0,4,100.0
2011-02-02,3,Wednesday,Early Morning,0,1,1,0.0
2011-02-02,4,Wednesday,Early Morning,0,1,1,0.0
2011-02-02,5,Wednesday,Early Morning,0,3,3,0.0
2011-02-02,6,Wednesday,Morning Rush,1,17,18,5.56
2011-02-02,7,Wednesday,Morning Rush,1,48,49,2.04
2011-02-02,8,Wednesday,Morning Rush,1,154,155,0.65
2011-02-02,9,Wednesday,Morning Rush,4,119,123,3.25
2011-02-02,10,Wednesday,Mid-Day,2,59,61,3.28
2011-02-02,11,Wednesday,Mid-Day,5,47,52,9.62
2011-02-02,12,Wednesday,Mid-Day,3,61,64,4.69
2011-02-02,13,Wednesday,Mid-Day,1,74,75,1.33
2011-02-02,14,Wednesday,Mid-Day,2,61,63,3.17
2011-02-02,15,Wednesday,Mid-Day,10,66,76,13.16
2011-02-02,16,Wednesday,Evening Rush,8,95,103,7.77
2011-02-02,17,Wednesday,Evening Rush,7,183,190,3.68
2011-02-02,18,Wednesday,Evening Rush,7,175,182,3.85
2011-02-02,19,Wednesday,Evening Rush,3,88,91,3.3
2011-02-02,20,Wednesday,Night,4,71,75,5.33
2011-02-02,21,Wednesday,Night,1,62,63,1.59
2011-02-02,22,Wednesday,Night,5,35,40,12.5
2011-02-02,23,Wednesday,Night,3,29,32,9.38
2011-02-03,0,Thursday,Early Morning,1,11,12,8.33
2011-02-03,1,Thursday,Early Morning,0,5,5,0.0
2011-02-03,2,Thursday,Early Morning,0,2,2,0.0
2011-02-03,3,Thursday,Early Morning,0,1,1,0.0
2011-02-03,5,Thursday,Early Morning,0,2,2,0.0
2011-02-03,6,Thursday,Morning Rush,0,39,39,0.0
2011-02-03,7,Thursday,Morning Rush,1,86,87,1.15
2011-02-03,8,Thursday,Morning Rush,4,184,188,2.13
2011-02-03,9,Thursday,Morning Rush,6,127,133,4.51
2011-02-03,10,Thursday,Mid-Day,2,50,52,3.85
2011-02-03,11,Thursday,Mid-Day,9,55,64,14.06
2011-02-03,12,Thursday,Mid-Day,2,67,69,2.9
2011-02-03,13,Thursday,Mid-Day,4,47,51,7.84
2011-02-03,14,Thursday,Mid-Day,4,43,47,8.51
2011-02-03,15,Thursday,Mid-Day,4,56,60,6.67
2011-02-03,16,Thursday,Evening Rush,5,73,78,6.41
2011-02-03,17,Thursday,Evening Rush,5,170,175,2.86
2011-02-03,18,Thursday,Evening Rush,2,145,147,1.36
2011-02-03,19,Thursday,Evening Rush,4,92,96,4.17
2011-02-03,20,Thursday,Night,1,108,109,0.92
2011-02-03,21,Thursday,Night,1,53,54,1.85
2011-02-03,22,Thursday,Night,2,39,41,4.88
2011-02-03,23,Thursday,Night,4,34,38,10.53
2011-02-04,0,Friday,Early Morning,3,10,13,23.08
2011-02-04,1,Friday,Early Morning,0,7,7,0.0
2011-02-04,2,Friday,Early Morning,0,1,1,0.0
2011-02-04,3,Friday,Early Morning,0,1,1,0.0
2011-02-04,5,Friday,Early Morning,0,7,7,0.0
2011-02-04,6,Friday,Morning Rush,2,26,28,7.14
2011-02-04,7,Friday,Morning Rush,0,87,87,0.0
2011-02-04,8,Friday,Morning Rush,3,217,220,1.36
2011-02-04,9,Friday,Morning Rush,3,124,127,2.36
2011-02-04,10,Friday,Mid-Day,5,46,51,9.8
2011-02-04,11,Friday,Mid-Day,3,61,64,4.69
2011-02-04,12,Friday,Mid-Day,8,78,86,9.3
2011-02-04,13,Friday,Mid-Day,9,73,82,10.98
2011-02-04,14,Friday,Mid-Day,15,76,91,16.48
2011-02-04,15,Friday,Mid-Day,9,81,90,10.0
2011-02-04,16,Friday,Evening Rush,8,91,99,8.08
2011-02-04,17,Friday,Evening Rush,10,195,205,4.88
2011-02-04,18,Friday,Evening Rush,3,152,155,1.94
2011-02-04,19,Friday,Evening Rush,1,102,103,0.97
2011-02-04,20,Friday,Night,2,69,71,2.82
2011-02-04,21,Friday,Night,2,41,43,4.65
2011-02-04,22,Friday,Night,1,45,46,2.17
2011-02-04,23,Friday,Night,1,30,31,3.23
2011-02-05,0,Saturday,Early Morning,3,36,39,7.69
2011-02-05,1,Saturday,Early Morning,1,17,18,5.56
2011-02-05,2,Saturday,Early Morning,5,12,17,29.41
2011-02-05,3,Saturday,Early Morning,1,10,11,9.09
2011-02-05,4,Saturday,Early Morning,0,8,8,0.0
2011-02-05,5,Saturday,Early Morning,0,9,9,0.0
2011-02-05,6,Saturday,Morning Rush,0,4,4,0.0
2011-02-05,7,Saturday,Morning Rush,0,4,4,0.0
2011-02-05,8,Saturday,Morning Rush,0,10,10,0.0
2011-02-05,9,Saturday,Morning Rush,3,17,20,15.0
2011-02-05,10,Saturday,Mid-Day,3,31,34,8.82
2011-02-05,11,Saturday,Mid-Day,1,46,47,2.13
2011-02-05,12,Saturday,Mid-Day,10,42,52,19.23
2011-02-05,13,Saturday,Mid-Day,10,62,72,13.89
2011-02-05,14,Saturday,Mid-Day,5,50,55,9.09
2011-02-05,15,Saturday,Mid-Day,11,49,60,18.33
2011-02-05,16,Saturday,Evening Rush,8,63,71,11.27
2011-02-05,17,Saturday,Evening Rush,14,64,78,17.95
2011-02-05,18,Saturday,Evening Rush,2,81,83,2.41
2011-02-05,19,Saturday,Evening Rush,6,78,84,7.14
2011-02-05,20,Saturday,Night,5,64,69,7.25
2011-02-05,21,Saturday,Night,3,53,56,5.36
2011-02-05,22,Saturday,Night,2,43,45,4.44
2011-02-05,23,Saturday,Night,7,52,59,11.86
2011-02-06,0,Sunday,Early Morning,2,37,39,5.13
2011-02-06,1,Sunday,Early Morning,4,40,44,9.09
2011-02-06,2,Sunday,Early Morning,0,20,20,0.0
2011-02-06,3,Sunday,Early Morning,3,10,13,23.08
2011-02-06,4,Sunday,Early Morning,0,2,2,0.0
2011-02-06,5,Sunday,Early Morning,0,1,1,0.0
2011-02-06,6,Sunday,Morning Rush,0,1,1,0.0
2011-02-06,7,Sunday,Morning Rush,0,8,8,0.0
2011-02-06,8,Sunday,Morning Rush,2,21,23,8.7
2011-02-06,9,Sunday,Morning Rush,7,38,45,15.56
2011-02-06,10,Sunday,Mid-Day,15,74,89,16.85
2011-02-06,11,Sunday,Mid-Day,28,89,117,23.93
2011-02-06,12,Sunday,Mid-Day,48,126,174,27.59
2011-02-06,13,Sunday,Mid-Day,47,135,182,25.82
2011-02-06,14,Sunday,Mid-Day,47,114,161,29.19
2011-02-06,15,Sunday,Mid-Day,52,130,182,28.57
2011-02-06,16,Sunday,Evening Rush,42,115,157,26.75
2011-02-06,17,Sunday,Evening Rush,24,97,121,19.83
2011-02-06,18,Sunday,Evening Rush,13,65,78,16.67
2011-02-06,19,Sunday,Evening Rush,1,20,21,4.76
2011-02-06,20,Sunday,Night,5,21,26,19.23
2011-02-06,21,Sunday,Night,5,22,27,18.52
2011-02-06,22,Sunday,Night,5,57,62,8.06
2011-02-06,23,Sunday,Night,4,26,30,13.33
2011-02-07,0,Monday,Early Morning,1,14,15,6.67
2011-02-07,1,Monday,Early Morning,1,4,5,20.0
2011-02-07,2,Monday,Early Morning,0,3,3,0.0
2011-02-07,3,Monday,Early Morning,0,1,1,0.0
2011-02-07,4,Monday,Early Morning,1,1,2,50.0
2011-02-07,5,Monday,Early Morning,1,9,10,10.0
2011-02-07,6,Monday,Morning Rush,1,29,30,3.33
2011-02-07,7,Monday,Morning Rush,6,89,95,6.32
2011-02-07,8,Monday,Morning Rush,7,223,230,3.04
2011-02-07,9,Monday,Morning Rush,3,115,118,2.54
2011-02-07,10,Monday,Mid-Day,6,49,55,10.91
2011-02-07,11,Monday,Mid-Day,11,36,47,23.4
2011-02-07,12,Monday,Mid-Day,7,59,66,10.61
2011-02-07,13,Monday,Mid-Day,10,54,64,15.63
2011-02-07,14,Monday,Mid-Day,8,52,60,13.33
2011-02-07,15,Monday,Mid-Day,4,46,50,8.0
2011-02-07,16,Monday,Evening Rush,16,98,114,14.04
2011-02-07,17,Monday,Evening Rush,9,207,216,4.17
2011-02-07,18,Monday,Evening Rush,5,170,175,2.86
2011-02-07,19,Monday,Evening Rush,5,123,128,3.91
2011-02-07,20,Monday,Night,6,82,88,6.82
2011-02-07,21,Monday,Night,3,75,78,3.85
2011-02-07,22,Monday,Night,3,34,37,8.11
2011-02-07,23,Monday,Night,6,19,25,24.0
2011-02-08,0,Tuesday,Early Morning,4,6,10,40.0
2011-02-08,1,Tuesday,Early Morning,0,4,4,0.0
2011-02-08,2,Tuesday,Early Morning,1,1,2,50.0
2011-02-08,3,Tuesday,Early Morning,0,1,1,0.0
2011-02-08,4,Tuesday,Early Morning,0,3,3,0.0
2011-02-08,5,Tuesday,Early Morning,0,2,2,0.0
2011-02-08,6,Tuesday,Morning Rush,0,39,39,0.0
2011-02-08,7,Tuesday,Morning Rush,3,97,100,3.0
2011-02-08,8,Tuesday,Morning Rush,7,236,243,2.88
2011-02-08,9,Tuesday,Morning Rush,7,128,135,5.19
2011-02-08,10,Tuesday,Mid-Day,4,44,48,8.33
2011-02-08,11,Tuesday,Mid-Day,1,49,50,2.0
2011-02-08,12,Tuesday,Mid-Day,2,63,65,3.08
2011-02-08,13,Tuesday,Mid-Day,2,48,50,4.0
2011-02-08,14,Tuesday,Mid-Day,3,61,64,4.69
2011-02-08,15,Tuesday,Mid-Day,6,45,51,11.76
2011-02-08,16,Tuesday,Evening Rush,4,79,83,4.82
2011-02-08,17,Tuesday,Evening Rush,4,172,176,2.27
2011-02-08,18,Tuesday,Evening Rush,1,151,152,0.66
2011-02-08,19,Tuesday,Evening Rush,1,100,101,0.99
2011-02-08,20,Tuesday,Night,3,53,56,5.36
2011-02-08,21,Tuesday,Night,8,46,54,14.81
2011-02-08,22,Tuesday,Night,0,29,29,0.0
2011-02-08,23,Tuesday,Night,3,9,12,25.0
2011-02-09,0,Wednesday,Early Morning,0,17,17,0.0
2011-02-09,1,Wednesday,Early Morning,0,7,7,0.0
2011-02-09,2,Wednesday,Early Morning,1,2,3,33.33
2011-02-09,3,Wednesday,Early Morning,0,2,2,0.0
2011-02-09,5,Wednesday,Early Morning,0,7,7,0.0
2011-02-09,6,Wednesday,Morning Rush,0,43,43,0.0
2011-02-09,7,Wednesday,Morning Rush,4,95,99,4.04
2011-02-09,8,Wednesday,Morning Rush,1,198,199,0.5
2011-02-09,9,Wednesday,Morning Rush,4,119,123,3.25
2011-02-09,10,Wednesday,Mid-Day,8,51,59,13.56
2011-02-09,11,Wednesday,Mid-Day,1,40,41,2.44
2011-02-09,12,Wednesday,Mid-Day,4,57,61,6.56
2011-02-09,13,Wednesday,Mid-Day,2,67,69,2.9
2011-02-09,14,Wednesday,Mid-Day,2,56,58,3.45
2011-02-09,15,Wednesday,Mid-Day,3,61,64,4.69
2011-02-09,16,Wednesday,Evening Rush,7,72,79,8.86
2011-02-09,17,Wednesday,Evening Rush,9,157,166,5.42
2011-02-09,18,Wednesday,Evening Rush,2,168,170,1.18
2011-02-09,19,Wednesday,Evening Rush,1,87,88,1.14
2011-02-09,20,Wednesday,Night,0,84,84,0.0
2011-02-09,21,Wednesday,Night,0,83,83,0.0
2011-02-09,22,Wednesday,Night,4,42,46,8.7
2011-02-09,23,Wednesday,Night,0,37,37,0.0
2011-02-10,0,Thursday,Early Morning,0,16,16,0.0
2011-02-10,1,Thursday,Early Morning,0,7,7,0.0
2011-02-10,2,Thursday,Early Morning,0,3,3,0.0
2011-02-10,4,Thursday,Early Morning,0,1,1,0.0
2011-02-10,5,Thursday,Early Morning,0,6,6,0.0
2011-02-10,6,Thursday,Morning Rush,0,26,26,0.0
2011-02-10,7,Thursday,Morning Rush,0,99,99,0.0
2011-02-10,8,Thursday,Morning Rush,5,173,178,2.81
2011-02-10,9,Thursday,Morning Rush,1,121,122,0.82
2011-02-10,10,Thursday,Mid-Day,1,34,35,2.86
2011-02-10,11,Thursday,Mid-Day,1,44,45,2.22
2011-02-10,12,Thursday,Mid-Day,4,65,69,5.8
2011-02-10,13,Thursday,Mid-Day,3,59,62,4.84
2011-02-10,14,Thursday,Mid-Day,6,42,48,12.5
2011-02-10,15,Thursday,Mid-Day,0,50,50,0.0
2011-02-10,16,Thursday,Evening Rush,4,76,80,5.0
2011-02-10,17,Thursday,Evening Rush,6,159,165,3.64
2011-02-10,18,Thursday,Evening Rush,3,157,160,1.88
2011-02-10,19,Thursday,Evening Rush,2,110,112,1.79
2011-02-10,20,Thursday,Night,4,93,97,4.12
2011-02-10,21,Thursday,Night,2,70,72,2.78
2011-02-10,22,Thursday,Night,4,47,51,7.84
2011-02-10,23,Thursday,Night,1,33,34,2.94
2011-02-11,0,Friday,Early Morning,2,12,14,14.29
2011-02-11,1,Friday,Early Morning,1,6,7,14.29
2011-02-11,2,Friday,Early Morning,0,3,3,0.0
2011-02-11,5,Friday,Early Morning,0,4,4,0.0
2011-02-11,6,Friday,Morning Rush,1,23,24,4.17
2011-02-11,7,Friday,Morning Rush,1,73,74,1.35
2011-02-11,8,Friday,Morning Rush,4,212,216,1.85
2011-02-11,9,Friday,Morning Rush,8,132,140,5.71
2011-02-11,10,Friday,Mid-Day,5,39,44,11.36
2011-02-11,11,Friday,Mid-Day,12,52,64,18.75
2011-02-11,12,Friday,Mid-Day,7,64,71,9.86
2011-02-11,13,Friday,Mid-Day,21,89,110,19.09
2011-02-11,14,Friday,Mid-Day,17,67,84,20.24
2011-02-11,15,Friday,Mid-Day,12,62,74,16.22
2011-02-11,16,Friday,Evening Rush,14,111,125,11.2
2011-02-11,17,Friday,Evening Rush,18,193,211,8.53
2011-02-11,18,Friday,Evening Rush,9,165,174,5.17
2011-02-11,19,Friday,Evening Rush,7,94,101,6.93
2011-02-11,20,Friday,Night,2,61,63,3.17
2011-02-11,21,Friday,Night,1,46,47,2.13
2011-02-11,22,Friday,Night,2,41,43,4.65
2011-02-11,23,Friday,Night,5,48,53,9.43
2011-02-12,0,Saturday,Early Morning,3,27,30,10.0
2011-02-12,1,Saturday,Early Morning,2,22,24,8.33
2011-02-12,2,Saturday,Early Morning,2,13,15,13.33
2011-02-12,3,Saturday,Early Morning,3,7,10,30.0
2011-02-12,4,Saturday,Early Morning,0,4,4,0.0
2011-02-12,5,Saturday,Early Morning,0,1,1,0.0
2011-02-12,6,Saturday,Morning Rush,1,1,2,50.0
2011-02-12,7,Saturday,Morning Rush,2,9,11,18.18
2011-02-12,8,Saturday,Morning Rush,2,28,30,6.67
2011-02-12,9,Saturday,Morning Rush,5,38,43,11.63
2011-02-12,10,Saturday,Mid-Day,13,71,84,15.48
2011-02-12,11,Saturday,Mid-Day,30,84,114,26.32
2011-02-12,12,Saturday,Mid-Day,27,93,120,22.5
2011-02-12,13,Saturday,Mid-Day,32,103,135,23.7
2011-02-12,14,Saturday,Mid-Day,30,90,120,25.0
2011-02-12,15,Saturday,Mid-Day,47,127,174,27.01
2011-02-12,16,Saturday,Evening Rush,42,103,145,28.97
2011-02-12,17,Saturday,Evening Rush,24,113,137,17.52
2011-02-12,18,Saturday,Evening Rush,4,60,64,6.25
2011-02-12,19,Saturday,Evening Rush,2,39,41,4.88
2011-02-12,20,Saturday,Night,1,39,40,2.5
2011-02-12,21,Saturday,Night,9,42,51,17.65
2011-02-12,22,Saturday,Night,6,39,45,13.33
2011-02-12,23,Saturday,Night,1,31,32,3.13
2011-02-13,0,Sunday,Early Morning,5,34,39,12.82
2011-02-13,1,Sunday,Early Morning,1,23,24,4.17
2011-02-13,2,Sunday,Early Morning,1,19,20,5.0
2011-02-13,3,Sunday,Early Morning,4,8,12,33.33
2011-02-13,4,Sunday,Early Morning,0,2,2,0.0
2011-02-13,6,Sunday,Morning Rush,2,3,5,40.0
2011-02-13,7,Sunday,Morning Rush,0,3,3,0.0
2011-02-13,8,Sunday,Morning Rush,1,11,12,8.33
2011-02-13,9,Sunday,Morning Rush,12,35,47,25.53
2011-02-13,10,Sunday,Mid-Day,19,86,105,18.1
2011-02-13,11,Sunday,Mid-Day,26,86,112,23.21
2011-02-13,12,Sunday,Mid-Day,58,94,152,38.16
2011-02-13,13,Sunday,Mid-Day,62,92,154,40.26
2011-02-13,14,Sunday,Mid-Day,51,110,161,31.68
2011-02-13,15,Sunday,Mid-Day,40,122,162,24.69
2011-02-13,16,Sunday,Evening Rush,28,106,134,20.9
2011-02-13,17,Sunday,Evening Rush,30,95,125,24.0
2011-02-13,18,Sunday,Evening Rush,17,78,95,17.89
2011-02-13,19,Sunday,Evening Rush,11,50,61,18.03
2011-02-13,20,Sunday,Night,15,32,47,31.91
2011-02-13,21,Sunday,Night,6,45,51,11.76
2011-02-13,22,Sunday,Night,5,31,36,13.89
2011-02-13,23,Sunday,Night,3,27,30,10.0
2011-02-14,0,Monday,Early Morning,3,8,11,27.27
2011-02-14,1,Monday,Early Morning,1,6,7,14.29
2011-02-14,2,Monday,Early Morning,0,2,2,0.0
2011-02-14,3,Monday,Early Morning,1,1,2,50.0
2011-02-14,4,Monday,Early Morning,0,2,2,0.0
2011-02-14,5,Monday,Early Morning,0,3,3,0.0
2011-02-14,6,Monday,Morning Rush,1,25,26,3.85
2011-02-14,7,Monday,Morning Rush,2,96,98,2.04
2011-02-14,8,Monday,Morning Rush,7,249,256,2.73
2011-02-14,9,Monday,Morning Rush,8,122,130,6.15
2011-02-14,10,Monday,Mid-Day,9,46,55,16.36
2011-02-14,11,Monday,Mid-Day,10,43,53,18.87
2011-02-14,12,Monday,Mid-Day,27,99,126,21.43
2011-02-14,13,Monday,Mid-Day,27,93,120,22.5
2011-02-14,14,Monday,Mid-Day,14,76,90,15.56
2011-02-14,15,Monday,Mid-Day,19,71,90,21.11
2011-02-14,16,Monday,Evening Rush,16,102,118,13.56
2011-02-14,17,Monday,Evening Rush,25,218,243,10.29
2011-02-14,18,Monday,Evening Rush,11,194,205,5.37
2011-02-14,19,Monday,Evening Rush,12,86,98,12.24
2011-02-14,20,Monday,Night,5,65,70,7.14
2011-02-14,21,Monday,Night,8,35,43,18.6
2011-02-14,22,Monday,Night,1,44,45,2.22
2011-02-14,23,Monday,Night,1,19,20,5.0
2011-02-15,0,Tuesday,Early Morning,7,12,19,36.84
2011-02-15,1,Tuesday,Early Morning,0,5,5,0.0
2011-02-15,2,Tuesday,Early Morning,1,2,3,33.33
2011-02-15,4,Tuesday,Early Morning,0,1,1,0.0
2011-02-15,5,Tuesday,Early Morning,0,4,4,0.0
2011-02-15,6,Tuesday,Morning Rush,0,30,30,0.0
2011-02-15,7,Tuesday,Morning Rush,2,103,105,1.9
2011-02-15,8,Tuesday,Morning Rush,10,213,223,4.48
2011-02-15,9,Tuesday,Morning Rush,2,108,110,1.82
2011-02-15,10,Tuesday,Mid-Day,5,47,52,9.62
2011-02-15,11,Tuesday,Mid-Day,11,46,57,19.3
2011-02-15,12,Tuesday,Mid-Day,6,65,71,8.45
2011-02-15,13,Tuesday,Mid-Day,14,68,82,17.07
2011-02-15,14,Tuesday,Mid-Day,10,69,79,12.66
2011-02-15,15,Tuesday,Mid-Day,11,74,85,12.94
2011-02-15,16,Tuesday,Evening Rush,21,77,98,21.43
2011-02-15,17,Tuesday,Evening Rush,15,191,206,7.28
2011-02-15,18,Tuesday,Evening Rush,14,198,212,6.6
2011-02-15,19,Tuesday,Evening Rush,3,142,145,2.07
2011-02-15,20,Tuesday,Night,3,98,101,2.97
2011-02-15,21,Tuesday,Night,5,61,66,7.58
2011-02-15,22,Tuesday,Night,0,41,41,0.0
2011-02-15,23,Tuesday,Night,0,20,20,0.0
2011-02-16,0,Wednesday,Early Morning,0,15,15,0.0
2011-02-16,1,Wednesday,Early Morning,0,9,9,0.0
2011-02-16,3,Wednesday,Early Morning,0,1,1,0.0
2011-02-16,4,Wednesday,Early Morning,0,1,1,0.0
2011-02-16,5,Wednesday,Early Morning,0,5,5,0.0
2011-02-16,6,Wednesday,Morning Rush,1,32,33,3.03
2011-02-16,7,Wednesday,Morning Rush,5,103,108,4.63
2011-02-16,8,Wednesday,Morning Rush,6,224,230,2.61
2011-02-16,9,Wednesday,Morning Rush,2,122,124,1.61
2011-02-16,10,Wednesday,Mid-Day,14,55,69,20.29
2011-02-16,11,Wednesday,Mid-Day,7,59,66,10.61
2011-02-16,12,Wednesday,Mid-Day,14,72,86,16.28
2011-02-16,13,Wednesday,Mid-Day,13,80,93,13.98
2011-02-16,14,Wednesday,Mid-Day,17,65,82,20.73
2011-02-16,15,Wednesday,Mid-Day,35,82,117,29.91
2011-02-16,16,Wednesday,Evening Rush,26,96,122,21.31
2011-02-16,17,Wednesday,Evening Rush,11,244,255,4.31
2011-02-16,18,Wednesday,Evening Rush,20,202,222,9.01
2011-02-16,19,Wednesday,Evening Rush,18,143,161,11.18
2011-02-16,20,Wednesday,Night,10,108,118,8.47
2011-02-16,21,Wednesday,Night,5,87,92,5.43
2011-02-16,22,Wednesday,Night,12,61,73,16.44
2011-02-16,23,Wednesday,Night,2,31,33,6.06
2011-02-17,0,Thursday,Early Morning,1,16,17,5.88
2011-02-17,1,Thursday,Early Morning,0,6,6,0.0
2011-02-17,2,Thursday,Early Morning,2,4,6,33.33
2011-02-17,3,Thursday,Early Morning,3,1,4,75.0
2011-02-17,4,Thursday,Early Morning,3,1,4,75.0
2011-02-17,5,Thursday,Early Morning,1,11,12,8.33
2011-02-17,6,Thursday,Morning Rush,3,44,47,6.38
2011-02-17,7,Thursday,Morning Rush,7,119,126,5.56
2011-02-17,8,Thursday,Morning Rush,18,267,285,6.32
2011-02-17,9,Thursday,Morning Rush,16,163,179,8.94
2011-02-17,10,Thursday,Mid-Day,18,70,88,20.45
2011-02-17,11,Thursday,Mid-Day,19,71,90,21.11
2011-02-17,12,Thursday,Mid-Day,15,86,101,14.85
2011-02-17,13,Thursday,Mid-Day,15,108,123,12.2
2011-02-17,14,Thursday,Mid-Day,26,55,81,32.1
2011-02-17,15,Thursday,Mid-Day,15,91,106,14.15
2011-02-17,16,Thursday,Evening Rush,29,117,146,19.86
2011-02-17,17,Thursday,Evening Rush,18,256,274,6.57
2011-02-17,18,Thursday,Evening Rush,11,211,222,4.95
2011-02-17,19,Thursday,Evening Rush,14,161,175,8.0
2011-02-17,20,Thursday,Night,8,131,139,5.76
2011-02-17,21,Thursday,Night,5,119,124,4.03
2011-02-17,22,Thursday,Night,8,68,76,10.53
2011-02-17,23,Thursday,Night,4,40,44,9.09
2011-02-18,0,Friday,Early Morning,12,20,32,37.5
2011-02-18,1,Friday,Early Morning,1,7,8,12.5
2011-02-18,2,Friday,Early Morning,2,5,7,28.57
2011-02-18,3,Friday,Early Morning,2,6,8,25.0
2011-02-18,4,Friday,Early Morning,0,1,1,0.0
2011-02-18,5,Friday,Early Morning,1,6,7,14.29
2011-02-18,6,Friday,Morning Rush,2,48,50,4.0
2011-02-18,7,Friday,Morning Rush,8,108,116,6.9
2011-02-18,8,Friday,Morning Rush,26,246,272,9.56
2011-02-18,9,Friday,Morning Rush,15,154,169,8.88
2011-02-18,10,Friday,Mid-Day,17,78,95,17.89
2011-02-18,11,Friday,Mid-Day,31,82,113,27.43
2011-02-18,12,Friday,Mid-Day,59,126,185,31.89
2011-02-18,13,Friday,Mid-Day,45,131,176,25.57
2011-02-18,14,Friday,Mid-Day,73,118,191,38.22
2011-02-18,15,Friday,Mid-Day,55,117,172,31.98
2011-02-18,16,Friday,Evening Rush,68,164,232,29.31
2011-02-18,17,Friday,Evening Rush,52,275,327,15.9
2011-02-18,18,Friday,Evening Rush,29,195,224,12.95
2011-02-18,19,Friday,Evening Rush,16,146,162,9.88
2011-02-18,20,Friday,Night,19,105,124,15.32
2011-02-18,21,Friday,Night,11,61,72,15.28
2011-02-18,22,Friday,Night,19,88,107,17.76
2011-02-18,23,Friday,Night,16,61,77,20.78
2011-02-19,0,Saturday,Early Morning,6,23,29,20.69
2011-02-19,1,Saturday,Early Morning,10,21,31,32.26
2011-02-19,2,Saturday,Early Morning,3,14,17,17.65
2011-02-19,3,Saturday,Early Morning,0,7,7,0.0
2011-02-19,4,Saturday,Early Morning,0,3,3,0.0
2011-02-19,5,Saturday,Early Morning,0,3,3,0.0
2011-02-19,6,Saturday,Morning Rush,3,3,6,50.0
2011-02-19,7,Saturday,Morning Rush,6,16,22,27.27
2011-02-19,8,Saturday,Morning Rush,9,36,45,20.0
2011-02-19,9,Saturday,Morning Rush,18,37,55,32.73
2011-02-19,10,Saturday,Mid-Day,34,72,106,32.08
2011-02-19,11,Saturday,Mid-Day,47,76,123,38.21
2011-02-19,12,Saturday,Mid-Day,38,81,119,31.93
2011-02-19,13,Saturday,Mid-Day,52,103,155,33.55
2011-02-19,14,Saturday,Mid-Day,102,94,196,52.04
2011-02-19,15,Saturday,Mid-Day,84,87,171,49.12
2011-02-19,16,Saturday,Evening Rush,39,81,120,32.5
2011-02-19,17,Saturday,Evening Rush,36,91,127,28.35
2011-02-19,18,Saturday,Evening Rush,21,67,88,23.86
2011-02-19,19,Saturday,Evening Rush,5,54,59,8.47
2011-02-19,20,Saturday,Night,9,38,47,19.15
2011-02-19,21,Saturday,Night,4,29,33,12.12
2011-02-19,22,Saturday,Night,2,42,44,4.55
2011-02-19,23,Saturday,Night,4,25,29,13.79
2011-02-20,0,Sunday,Early Morning,3,14,17,17.65
2011-02-20,1,Sunday,Early Morning,5,11,16,31.25
2011-02-20,2,Sunday,Early Morning,0,17,17,0.0
2011-02-20,3,Sunday,Early Morning,9,9,18,50.0
2011-02-20,4,Sunday,Early Morning,0,1,1,0.0
2011-02-20,6,Sunday,Morning Rush,1,1,2,50.0
2011-02-20,7,Sunday,Morning Rush,0,2,2,0.0
2011-02-20,8,Sunday,Morning Rush,2,22,24,8.33
2011-02-20,9,Sunday,Morning Rush,7,48,55,12.73
2011-02-20,10,Sunday,Mid-Day,34,70,104,32.69
2011-02-20,11,Sunday,Mid-Day,72,89,161,44.72
2011-02-20,12,Sunday,Mid-Day,62,120,182,34.07
2011-02-20,13,Sunday,Mid-Day,76,122,198,38.38
2011-02-20,14,Sunday,Mid-Day,108,104,212,50.94
2011-02-20,15,Sunday,Mid-Day,66,102,168,39.29
2011-02-20,16,Sunday,Evening Rush,59,88,147,40.14
2011-02-20,17,Sunday,Evening Rush,60,86,146,41.1
2011-02-20,18,Sunday,Evening Rush,30,71,101,29.7
2011-02-20,19,Sunday,Evening Rush,3,39,42,7.14
2011-02-20,20,Sunday,Night,12,30,42,28.57
2011-02-20,21,Sunday,Night,17,39,56,30.36
2011-02-20,22,Sunday,Night,4,43,47,8.51
2011-02-20,23,Sunday,Night,9,45,54,16.67
2011-02-21,0,Monday,Early Morning,7,30,37,18.92
2011-02-21,1,Monday,Early Morning,2,11,13,15.38
2011-02-21,2,Monday,Early Morning,1,3,4,25.0
2011-02-21,3,Monday,Early Morning,2,3,5,40.0
2011-02-21,4,Monday,Early Morning,1,0,1,100.0
2011-02-21,5,Monday,Early Morning,1,2,3,33.33
2011-02-21,6,Monday,Morning Rush,2,6,8,25.0
2011-02-21,7,Monday,Morning Rush,3,16,19,15.79
2011-02-21,8,Monday,Morning Rush,7,56,63,11.11
2011-02-21,9,Monday,Morning Rush,11,46,57,19.3
2011-02-21,10,Monday,Mid-Day,29,52,81,35.8
2011-02-21,11,Monday,Mid-Day,20,70,90,22.22
2011-02-21,12,Monday,Mid-Day,26,67,93,27.96
2011-02-21,13,Monday,Mid-Day,28,75,103,27.18
2011-02-21,14,Monday,Mid-Day,15,101,116,12.93
2011-02-21,15,Monday,Mid-Day,11,76,87,12.64
2011-02-21,16,Monday,Evening Rush,8,48,56,14.29
2011-02-21,17,Monday,Evening Rush,18,62,80,22.5
2011-02-21,18,Monday,Evening Rush,2,64,66,3.03
2011-02-21,19,Monday,Evening Rush,0,49,49,0.0
2011-02-21,20,Monday,Night,0,29,29,0.0
2011-02-21,21,Monday,Night,1,33,34,2.94
2011-02-21,22,Monday,Night,0,11,11,0.0
2011-02-21,23,Monday,Night,0,2,2,0.0
2011-02-22,6,Tuesday,Morning Rush,0,7,7,0.0
2011-02-22,7,Tuesday,Morning Rush,0,40,40,0.0
2011-02-22,8,Tuesday,Morning Rush,7,107,114,6.14
2011-02-22,9,Tuesday,Morning Rush,5,101,106,4.72
2011-02-22,10,Tuesday,Mid-Day,0,44,44,0.0
2011-02-22,11,Tuesday,Mid-Day,7,43,50,14.0
2011-02-22,12,Tuesday,Mid-Day,7,48,55,12.73
2011-02-22,13,Tuesday,Mid-Day,3,52,55,5.45
2011-02-22,14,Tuesday,Mid-Day,9,49,58,15.52
2011-02-22,15,Tuesday,Mid-Day,2,67,69,2.9
2011-02-22,16,Tuesday,Evening Rush,7,79,86,8.14
2011-02-22,17,Tuesday,Evening Rush,8,188,196,4.08
2011-02-22,18,Tuesday,Evening Rush,6,161,167,3.59
2011-02-22,19,Tuesday,Evening Rush,4,114,118,3.39
2011-02-22,20,Tuesday,Night,3,102,105,2.86
2011-02-22,21,Tuesday,Night,2,80,82,2.44
2011-02-22,22,Tuesday,Night,1,76,77,1.3
2011-02-22,23,Tuesday,Night,3,18,21,14.29
2011-02-23,0,Wednesday,Early Morning,0,6,6,0.0
2011-02-23,1,Wednesday,Early Morning,0,4,4,0.0
2011-02-23,2,Wednesday,Early Morning,0,1,1,0.0
2011-02-23,3,Wednesday,Early Morning,0,2,2,0.0
2011-02-23,5,Wednesday,Early Morning,0,8,8,0.0
2011-02-23,6,Wednesday,Morning Rush,0,36,36,0.0
2011-02-23,7,Wednesday,Morning Rush,2,94,96,2.08
2011-02-23,8,Wednesday,Morning Rush,8,227,235,3.4
2011-02-23,9,Wednesday,Morning Rush,9,130,139,6.47
2011-02-23,10,Wednesday,Mid-Day,4,47,51,7.84
2011-02-23,11,Wednesday,Mid-Day,16,53,69,23.19
2011-02-23,12,Wednesday,Mid-Day,11,56,67,16.42
2011-02-23,13,Wednesday,Mid-Day,9,78,87,10.34
2011-02-23,14,Wednesday,Mid-Day,17,61,78,21.79
2011-02-23,15,Wednesday,Mid-Day,18,54,72,25.0
2011-02-23,16,Wednesday,Evening Rush,15,79,94,15.96
2011-02-23,17,Wednesday,Evening Rush,15,207,222,6.76
2011-02-23,18,Wednesday,Evening Rush,3,206,209,1.44
2011-02-23,19,Wednesday,Evening Rush,6,135,141,4.26
2011-02-23,20,Wednesday,Night,2,107,109,1.83
2011-02-23,21,Wednesday,Night,2,89,91,2.2
2011-02-23,22,Wednesday,Night,1,60,61,1.64
2011-02-23,23,Wednesday,Night,1,38,39,2.56
2011-02-24,0,Thursday,Early Morning,0,11,11,0.0
2011-02-24,1,Thursday,Early Morning,0,7,7,0.0
2011-02-24,2,Thursday,Early Morning,0,4,4,0.0
2011-02-24,3,Thursday,Early Morning,0,2,2,0.0
2011-02-24,5,Thursday,Early Morning,1,3,4,25.0
2011-02-24,6,Thursday,Morning Rush,0,58,58,0.0
2011-02-24,7,Thursday,Morning Rush,0,104,104,0.0
2011-02-24,8,Thursday,Morning Rush,8,244,252,3.17
2011-02-24,9,Thursday,Morning Rush,4,133,137,2.92
2011-02-24,10,Thursday,Mid-Day,8,49,57,14.04
2011-02-24,11,Thursday,Mid-Day,8,71,79,10.13
2011-02-24,12,Thursday,Mid-Day,10,85,95,10.53
2011-02-24,13,Thursday,Mid-Day,16,72,88,18.18
2011-02-24,14,Thursday,Mid-Day,2,67,69,2.9
2011-02-24,15,Thursday,Mid-Day,5,58,63,7.94
2011-02-24,16,Thursday,Evening Rush,4,67,71,5.63
2011-02-24,17,Thursday,Evening Rush,9,168,177,5.08
2011-02-24,18,Thursday,Evening Rush,5,132,137,3.65
2011-02-24,19,Thursday,Evening Rush,3,112,115,2.61
2011-02-24,20,Thursday,Night,2,87,89,2.25
2011-02-24,21,Thursday,Night,7,76,83,8.43
2011-02-24,22,Thursday,Night,5,50,55,9.09
2011-02-24,23,Thursday,Night,3,47,50,6.0
2011-02-25,0,Friday,Early Morning,1,8,9,11.11
2011-02-25,1,Friday,Early Morning,1,9,10,10.0
2011-02-25,2,Friday,Early Morning,0,3,3,0.0
2011-02-25,3,Friday,Early Morning,1,1,2,50.0
2011-02-25,5,Friday,Early Morning,1,5,6,16.67
2011-02-25,6,Friday,Morning Rush,0,11,11,0.0
2011-02-25,7,Friday,Morning Rush,1,34,35,2.86
2011-02-25,8,Friday,Morning Rush,3,70,73,4.11
2011-02-25,9,Friday,Morning Rush,3,111,114,2.63
2011-02-25,10,Friday,Mid-Day,7,42,49,14.29
2011-02-25,11,Friday,Mid-Day,9,50,59,15.25
2011-02-25,12,Friday,Mid-Day,20,95,115,17.39
2011-02-25,13,Friday,Mid-Day,6,77,83,7.23
2011-02-25,14,Friday,Mid-Day,14,71,85,16.47
2011-02-25,15,Friday,Mid-Day,5,50,55,9.09
2011-02-25,16,Friday,Evening Rush,11,91,102,10.78
2011-02-25,17,Friday,Evening Rush,8,181,189,4.23
2011-02-25,18,Friday,Evening Rush,7,150,157,4.46
2011-02-25,19,Friday,Evening Rush,4,86,90,4.44
2011-02-25,20,Friday,Night,2,60,62,3.23
2011-02-25,21,Friday,Night,7,56,63,11.11
2011-02-25,22,Friday,Night,7,43,50,14.0
2011-02-25,23,Friday,Night,2,37,39,5.13
2011-02-26,0,Saturday,Early Morning,3,25,28,10.71
2011-02-26,1,Saturday,Early Morning,2,25,27,7.41
2011-02-26,2,Saturday,Early Morning,3,9,12,25.0
2011-02-26,3,Saturday,Early Morning,1,7,8,12.5
2011-02-26,4,Saturday,Early Morning,1,1,2,50.0
2011-02-26,5,Saturday,Early Morning,1,9,10,10.0
2011-02-26,6,Saturday,Morning Rush,1,6,7,14.29
2011-02-26,7,Saturday,Morning Rush,1,21,22,4.55
2011-02-26,8,Saturday,Morning Rush,2,55,57,3.51
2011-02-26,9,Saturday,Morning Rush,9,65,74,12.16
2011-02-26,10,Saturday,Mid-Day,14,71,85,16.47
2011-02-26,11,Saturday,Mid-Day,26,100,126,20.63
2011-02-26,12,Saturday,Mid-Day,45,115,160,28.13
2011-02-26,13,Saturday,Mid-Day,38,136,174,21.84
2011-02-26,14,Saturday,Mid-Day,57,154,211,27.01
2011-02-26,15,Saturday,Mid-Day,40,125,165,24.24
2011-02-26,16,Saturday,Evening Rush,41,130,171,23.98
2011-02-26,17,Saturday,Evening Rush,53,130,183,28.96
2011-02-26,18,Saturday,Evening Rush,26,111,137,18.98
2011-02-26,19,Saturday,Evening Rush,30,64,94,31.91
2011-02-26,20,Saturday,Night,8,60,68,11.76
2011-02-26,21,Saturday,Night,9,59,68,13.24
2011-02-26,22,Saturday,Night,8,38,46,17.39
2011-02-26,23,Saturday,Night,5,29,34,14.71
2011-02-27,0,Sunday,Early Morning,8,26,34,23.53
2011-02-27,1,Sunday,Early Morning,7,30,37,18.92
2011-02-27,2,Sunday,Early Morning,2,20,22,9.09
2011-02-27,3,Sunday,Early Morning,3,8,11,27.27
2011-02-27,4,Sunday,Early Morning,0,2,2,0.0
2011-02-27,6,Sunday,Morning Rush,2,1,3,66.67
2011-02-27,7,Sunday,Morning Rush,6,8,14,42.86
2011-02-27,8,Sunday,Morning Rush,9,26,35,25.71
2011-02-27,9,Sunday,Morning Rush,17,42,59,28.81
2011-02-27,10,Sunday,Mid-Day,24,79,103,23.3
2011-02-27,11,Sunday,Mid-Day,33,92,125,26.4
2011-02-27,12,Sunday,Mid-Day,61,132,193,31.61
2011-02-27,13,Sunday,Mid-Day,90,169,259,34.75
2011-02-27,14,Sunday,Mid-Day,105,177,282,37.23
2011-02-27,15,Sunday,Mid-Day,98,163,261,37.55
2011-02-27,16,Sunday,Evening Rush,98,170,268,36.57
2011-02-27,17,Sunday,Evening Rush,66,121,187,35.29
2011-02-27,18,Sunday,Evening Rush,24,103,127,18.9
2011-02-27,19,Sunday,Evening Rush,16,86,102,15.69
2011-02-27,20,Sunday,Night,9,72,81,11.11
2011-02-27,21,Sunday,Night,8,61,69,11.59
2011-02-27,22,Sunday,Night,2,67,69,2.9
2011-02-27,23,Sunday,Night,6,53,59,10.17
2011-02-28,0,Monday,Early Morning,5,25,30,16.67
2011-02-28,1,Monday,Early Morning,1,7,8,12.5
2011-02-28,3,Monday,Early Morning,0,1,1,0.0
2011-02-28,5,Monday,Early Morning,1,4,5,20.0
2011-02-28,6,Monday,Morning Rush,1,27,28,3.57
2011-02-28,7,Monday,Morning Rush,2,90,92,2.17
2011-02-28,8,Monday,Morning Rush,13,242,255,5.1
2011-02-28,9,Monday,Morning Rush,15,127,142,10.56
2011-02-28,10,Monday,Mid-Day,13,79,92,14.13
2011-02-28,11,Monday,Mid-Day,13,74,87,14.94
2011-02-28,12,Monday,Mid-Day,0,36,36,0.0
2011-02-28,13,Monday,Mid-Day,1,31,32,3.13
2011-02-28,14,Monday,Mid-Day,1,24,25,4.0
2011-02-28,15,Monday,Mid-Day,0,35,35,0.0
2011-02-28,16,Monday,Evening Rush,2,40,42,4.76
2011-02-28,17,Monday,Evening Rush,2,77,79,2.53
2011-02-28,18,Monday,Evening Rush,4,127,131,3.05
2011-02-28,19,Monday,Evening Rush,1,79,80,1.25
2011-02-28,20,Monday,Night,0,45,45,0.0
2011-02-28,21,Monday,Night,2,78,80,2.5
2011-02-28,22,Monday,Night,4,72,76,5.26
2011-02-28,23,Monday,Night,0,45,45,0.0
2011-03-01,0,Tuesday,Early Morning,0,7,7,0.0
2011-03-01,1,Tuesday,Early Morning,0,3,3,0.0
2011-03-01,2,Tuesday,Early Morning,0,4,4,0.0
2011-03-01,3,Tuesday,Early Morning,0,2,2,0.0
2011-03-01,4,Tuesday,Early Morning,0,1,1,0.0
2011-03-01,5,Tuesday,Early Morning,1,1,2,50.0
2011-03-01,6,Tuesday,Morning Rush,0,46,46,0.0
2011-03-01,7,Tuesday,Morning Rush,2,105,107,1.87
2011-03-01,8,Tuesday,Morning Rush,10,204,214,4.67
2011-03-01,9,Tuesday,Morning Rush,8,116,124,6.45
2011-03-01,10,Tuesday,Mid-Day,13,55,68,19.12
2011-03-01,11,Tuesday,Mid-Day,8,48,56,14.29
2011-03-01,12,Tuesday,Mid-Day,6,80,86,6.98
2011-03-01,13,Tuesday,Mid-Day,13,65,78,16.67
2011-03-01,14,Tuesday,Mid-Day,18,61,79,22.78
2011-03-01,15,Tuesday,Mid-Day,7,57,64,10.94
2011-03-01,16,Tuesday,Evening Rush,10,92,102,9.8
2011-03-01,17,Tuesday,Evening Rush,12,230,242,4.96
2011-03-01,18,Tuesday,Evening Rush,10,214,224,4.46
2011-03-01,19,Tuesday,Evening Rush,4,115,119,3.36
2011-03-01,20,Tuesday,Night,2,86,88,2.27
2011-03-01,21,Tuesday,Night,8,55,63,12.7
2011-03-01,22,Tuesday,Night,3,44,47,6.38
2011-03-01,23,Tuesday,Night,2,23,25,8.0
2011-03-02,0,Wednesday,Early Morning,3,5,8,37.5
2011-03-02,1,Wednesday,Early Morning,0,4,4,0.0
2011-03-02,2,Wednesday,Early Morning,0,2,2,0.0
2011-03-02,3,Wednesday,Early Morning,3,1,4,75.0
2011-03-02,4,Wednesday,Early Morning,1,0,1,100.0
2011-03-02,5,Wednesday,Early Morning,0,5,5,0.0
2011-03-02,6,Wednesday,Morning Rush,1,39,40,2.5
2011-03-02,7,Wednesday,Morning Rush,2,108,110,1.82
2011-03-02,8,Wednesday,Morning Rush,13,243,256,5.08
2011-03-02,9,Wednesday,Morning Rush,7,141,148,4.73
2011-03-02,10,Wednesday,Mid-Day,11,65,76,14.47
2011-03-02,11,Wednesday,Mid-Day,8,65,73,10.96
2011-03-02,12,Wednesday,Mid-Day,20,62,82,24.39
2011-03-02,13,Wednesday,Mid-Day,35,90,125,28.0
2011-03-02,14,Wednesday,Mid-Day,21,75,96,21.88
2011-03-02,15,Wednesday,Mid-Day,19,91,110,17.27
2011-03-02,16,Wednesday,Evening Rush,27,112,139,19.42
2011-03-02,17,Wednesday,Evening Rush,30,238,268,11.19
2011-03-02,18,Wednesday,Evening Rush,8,193,201,3.98
2011-03-02,19,Wednesday,Evening Rush,6,144,150,4.0
2011-03-02,20,Wednesday,Night,9,86,95,9.47
2011-03-02,21,Wednesday,Night,3,68,71,4.23
2011-03-02,22,Wednesday,Night,4,44,48,8.33
2011-03-02,23,Wednesday,Night,0,22,22,0.0
2011-03-03,0,Thursday,Early Morning,3,10,13,23.08
2011-03-03,1,Thursday,Early Morning,0,1,1,0.0
2011-03-03,2,Thursday,Early Morning,1,2,3,33.33
2011-03-03,3,Thursday,Early Morning,0,1,1,0.0
2011-03-03,4,Thursday,Early Morning,0,1,1,0.0
2011-03-03,5,Thursday,Early Morning,1,7,8,12.5
2011-03-03,6,Thursday,Morning Rush,1,34,35,2.86
2011-03-03,7,Thursday,Morning Rush,1,110,111,0.9
2011-03-03,8,Thursday,Morning Rush,4,216,220,1.82
2011-03-03,9,Thursday,Morning Rush,10,135,145,6.9
2011-03-03,10,Thursday,Mid-Day,7,49,56,12.5
2011-03-03,11,Thursday,Mid-Day,10,40,50,20.0
2011-03-03,12,Thursday,Mid-Day,7,65,72,9.72
2011-03-03,13,Thursday,Mid-Day,13,67,80,16.25
2011-03-03,14,Thursday,Mid-Day,18,60,78,23.08
2011-03-03,15,Thursday,Mid-Day,6,62,68,8.82
2011-03-03,16,Thursday,Evening Rush,6,65,71,8.45
2011-03-03,17,Thursday,Evening Rush,17,185,202,8.42
2011-03-03,18,Thursday,Evening Rush,6,161,167,3.59
2011-03-03,19,Thursday,Evening Rush,5,101,106,4.72
2011-03-03,20,Thursday,Night,1,69,70,1.43
2011-03-03,21,Thursday,Night,3,48,51,5.88
2011-03-03,22,Thursday,Night,3,50,53,5.66
2011-03-03,23,Thursday,Night,0,23,23,0.0
2011-03-04,0,Friday,Early Morning,0,12,12,0.0
2011-03-04,1,Friday,Early Morning,0,4,4,0.0
2011-03-04,2,Friday,Early Morning,0,2,2,0.0
2011-03-04,3,Friday,Early Morning,0,1,1,0.0
2011-03-04,4,Friday,Early Morning,1,0,1,100.0
2011-03-04,5,Friday,Early Morning,0,7,7,0.0
2011-03-04,6,Friday,Morning Rush,1,28,29,3.45
2011-03-04,7,Friday,Morning Rush,0,83,83,0.0
2011-03-04,8,Friday,Morning Rush,6,222,228,2.63
2011-03-04,9,Friday,Morning Rush,12,138,150,8.0
2011-03-04,10,Friday,Mid-Day,10,56,66,15.15
2011-03-04,11,Friday,Mid-Day,16,73,89,17.98
2011-03-04,12,Friday,Mid-Day,10,87,97,10.31
2011-03-04,13,Friday,Mid-Day,13,74,87,14.94
2011-03-04,14,Friday,Mid-Day,30,65,95,31.58
2011-03-04,15,Friday,Mid-Day,31,75,106,29.25
2011-03-04,16,Friday,Evening Rush,17,101,118,14.41
2011-03-04,17,Friday,Evening Rush,22,206,228,9.65
2011-03-04,18,Friday,Evening Rush,15,172,187,8.02
2011-03-04,19,Friday,Evening Rush,5,102,107,4.67
2011-03-04,20,Friday,Night,9,78,87,10.34
2011-03-04,21,Friday,Night,6,64,70,8.57
2011-03-04,22,Friday,Night,4,40,44,9.09
2011-03-04,23,Friday,Night,6,40,46,13.04
2011-03-05,0,Saturday,Early Morning,4,15,19,21.05
2011-03-05,1,Saturday,Early Morning,5,20,25,20.0
2011-03-05,2,Saturday,Early Morning,5,15,20,25.0
2011-03-05,3,Saturday,Early Morning,0,2,2,0.0
2011-03-05,4,Saturday,Early Morning,0,1,1,0.0
2011-03-05,5,Saturday,Early Morning,0,3,3,0.0
2011-03-05,6,Saturday,Morning Rush,1,3,4,25.0
2011-03-05,7,Saturday,Morning Rush,5,10,15,33.33
2011-03-05,8,Saturday,Morning Rush,11,34,45,24.44
2011-03-05,9,Saturday,Morning Rush,15,48,63,23.81
2011-03-05,10,Saturday,Mid-Day,34,69,103,33.01
2011-03-05,11,Saturday,Mid-Day,43,116,159,27.04
2011-03-05,12,Saturday,Mid-Day,46,121,167,27.54
2011-03-05,13,Saturday,Mid-Day,60,130,190,31.58
2011-03-05,14,Saturday,Mid-Day,80,118,198,40.4
2011-03-05,15,Saturday,Mid-Day,83,122,205,40.49
2011-03-05,16,Saturday,Evening Rush,74,130,204,36.27
2011-03-05,17,Saturday,Evening Rush,60,104,164,36.59
2011-03-05,18,Saturday,Evening Rush,37,115,152,24.34
2011-03-05,19,Saturday,Evening Rush,27,62,89,30.34
2011-03-05,20,Saturday,Night,12,58,70,17.14
2011-03-05,21,Saturday,Night,12,60,72,16.67
2011-03-05,22,Saturday,Night,16,47,63,25.4
2011-03-05,23,Saturday,Night,10,34,44,22.73
2011-03-06,0,Sunday,Early Morning,11,41,52,21.15
2011-03-06,1,Sunday,Early Morning,12,27,39,30.77
2011-03-06,2,Sunday,Early Morning,5,27,32,15.63
2011-03-06,3,Sunday,Early Morning,2,9,11,18.18
2011-03-06,4,Sunday,Early Morning,0,3,3,0.0
2011-03-06,6,Sunday,Morning Rush,1,1,2,50.0
2011-03-06,7,Sunday,Morning Rush,0,5,5,0.0
2011-03-06,8,Sunday,Morning Rush,1,8,9,11.11
2011-03-06,9,Sunday,Morning Rush,4,18,22,18.18
2011-03-06,10,Sunday,Mid-Day,4,27,31,12.9
2011-03-06,11,Sunday,Mid-Day,18,44,62,29.03
2011-03-06,12,Sunday,Mid-Day,10,69,79,12.66
2011-03-06,13,Sunday,Mid-Day,22,83,105,20.95
2011-03-06,14,Sunday,Mid-Day,12,27,39,30.77
2011-03-06,15,Sunday,Mid-Day,3,4,7,42.86
2011-03-06,16,Sunday,Evening Rush,3,8,11,27.27
2011-03-06,17,Sunday,Evening Rush,2,23,25,8.0
2011-03-06,18,Sunday,Evening Rush,0,23,23,0.0
2011-03-06,19,Sunday,Evening Rush,0,11,11,0.0
2011-03-06,20,Sunday,Night,3,8,11,27.27
2011-03-06,21,Sunday,Night,1,6,7,14.29
2011-03-06,22,Sunday,Night,0,10,10,0.0
2011-03-06,23,Sunday,Night,0,9,9,0.0
2011-03-07,0,Monday,Early Morning,0,4,4,0.0
2011-03-07,1,Monday,Early Morning,0,2,2,0.0
2011-03-07,3,Monday,Early Morning,0,1,1,0.0
2011-03-07,4,Monday,Early Morning,1,0,1,100.0
2011-03-07,5,Monday,Early Morning,0,1,1,0.0
2011-03-07,6,Monday,Morning Rush,3,31,34,8.82
2011-03-07,7,Monday,Morning Rush,3,88,91,3.3
2011-03-07,8,Monday,Morning Rush,11,200,211,5.21
2011-03-07,9,Monday,Morning Rush,5,129,134,3.73
2011-03-07,10,Monday,Mid-Day,15,43,58,25.86
2011-03-07,11,Monday,Mid-Day,19,41,60,31.67
2011-03-07,12,Monday,Mid-Day,28,68,96,29.17
2011-03-07,13,Monday,Mid-Day,16,54,70,22.86
2011-03-07,14,Monday,Mid-Day,21,56,77,27.27
2011-03-07,15,Monday,Mid-Day,32,64,96,33.33
2011-03-07,16,Monday,Evening Rush,26,96,122,21.31
2011-03-07,17,Monday,Evening Rush,27,206,233,11.59
2011-03-07,18,Monday,Evening Rush,19,214,233,8.15
2011-03-07,19,Monday,Evening Rush,11,134,145,7.59
2011-03-07,20,Monday,Night,5,87,92,5.43
2011-03-07,21,Monday,Night,1,53,54,1.85
2011-03-07,22,Monday,Night,1,34,35,2.86
2011-03-07,23,Monday,Night,0,22,22,0.0
2011-03-08,0,Tuesday,Early Morning,1,9,10,10.0
2011-03-08,1,Tuesday,Early Morning,0,4,4,0.0
2011-03-08,2,Tuesday,Early Morning,1,0,1,100.0
2011-03-08,3,Tuesday,Early Morning,5,2,7,71.43
2011-03-08,4,Tuesday,Early Morning,0,2,2,0.0
2011-03-08,5,Tuesday,Early Morning,2,8,10,20.0
2011-03-08,6,Tuesday,Morning Rush,3,42,45,6.67
2011-03-08,7,Tuesday,Morning Rush,9,119,128,7.03
2011-03-08,8,Tuesday,Morning Rush,10,247,257,3.89
2011-03-08,9,Tuesday,Morning Rush,11,140,151,7.28
2011-03-08,10,Tuesday,Mid-Day,25,46,71,35.21
2011-03-08,11,Tuesday,Mid-Day,26,52,78,33.33
2011-03-08,12,Tuesday,Mid-Day,29,70,99,29.29
2011-03-08,13,Tuesday,Mid-Day,25,73,98,25.51
2011-03-08,14,Tuesday,Mid-Day,16,56,72,22.22
2011-03-08,15,Tuesday,Mid-Day,35,77,112,31.25
2011-03-08,16,Tuesday,Evening Rush,26,82,108,24.07
2011-03-08,17,Tuesday,Evening Rush,39,209,248,15.73
2011-03-08,18,Tuesday,Evening Rush,21,214,235,8.94
2011-03-08,19,Tuesday,Evening Rush,9,141,150,6.0
2011-03-08,20,Tuesday,Night,2,74,76,2.63
2011-03-08,21,Tuesday,Night,7,68,75,9.33
2011-03-08,22,Tuesday,Night,11,44,55,20.0
2011-03-08,23,Tuesday,Night,3,38,41,7.32
2011-03-09,0,Wednesday,Early Morning,0,9,9,0.0
2011-03-09,1,Wednesday,Early Morning,0,4,4,0.0
2011-03-09,2,Wednesday,Early Morning,1,1,2,50.0
2011-03-09,3,Wednesday,Early Morning,1,2,3,33.33
2011-03-09,4,Wednesday,Early Morning,0,2,2,0.0
2011-03-09,5,Wednesday,Early Morning,1,7,8,12.5
2011-03-09,6,Wednesday,Morning Rush,5,44,49,10.2
2011-03-09,7,Wednesday,Morning Rush,18,123,141,12.77
2011-03-09,8,Wednesday,Morning Rush,11,238,249,4.42
2011-03-09,9,Wednesday,Morning Rush,5,136,141,3.55
2011-03-09,10,Wednesday,Mid-Day,8,49,57,14.04
2011-03-09,11,Wednesday,Mid-Day,15,44,59,25.42
2011-03-09,12,Wednesday,Mid-Day,14,84,98,14.29
2011-03-09,13,Wednesday,Mid-Day,17,82,99,17.17
2011-03-09,14,Wednesday,Mid-Day,10,61,71,14.08
2011-03-09,15,Wednesday,Mid-Day,15,64,79,18.99
2011-03-09,16,Wednesday,Evening Rush,10,102,112,8.93
2011-03-09,17,Wednesday,Evening Rush,18,176,194,9.28
2011-03-09,18,Wednesday,Evening Rush,12,176,188,6.38
2011-03-09,19,Wednesday,Evening Rush,11,123,134,8.21
2011-03-09,20,Wednesday,Night,4,87,91,4.4
2011-03-09,21,Wednesday,Night,10,52,62,16.13
2011-03-09,22,Wednesday,Night,4,17,21,19.05
2011-03-09,23,Wednesday,Night,1,17,18,5.56
2011-03-10,0,Thursday,Early Morning,3,0,3,100.0
2011-03-10,1,Thursday,Early Morning,0,2,2,0.0
2011-03-10,2,Thursday,Early Morning,0,1,1,0.0
2011-03-10,5,Thursday,Early Morning,1,2,3,33.33
2011-03-10,6,Thursday,Morning Rush,0,12,12,0.0
2011-03-10,7,Thursday,Morning Rush,1,36,37,2.7
2011-03-10,8,Thursday,Morning Rush,1,43,44,2.27
2011-03-10,9,Thursday,Morning Rush,1,23,24,4.17
2011-03-10,10,Thursday,Mid-Day,0,17,17,0.0
2011-03-10,11,Thursday,Mid-Day,6,5,11,54.55
2011-03-10,12,Thursday,Mid-Day,4,30,34,11.76
2011-03-10,13,Thursday,Mid-Day,1,11,12,8.33
2011-03-10,14,Thursday,Mid-Day,0,12,12,0.0
2011-03-10,15,Thursday,Mid-Day,3,11,14,21.43
2011-03-10,16,Thursday,Evening Rush,1,20,21,4.76
2011-03-10,17,Thursday,Evening Rush,2,109,111,1.8
2011-03-10,18,Thursday,Evening Rush,2,80,82,2.44
2011-03-10,19,Thursday,Evening Rush,5,51,56,8.93
2011-03-10,20,Thursday,Night,9,29,38,23.68
2011-03-10,21,Thursday,Night,1,27,28,3.57
2011-03-10,22,Thursday,Night,4,30,34,11.76
2011-03-10,23,Thursday,Night,1,26,27,3.7
2011-03-11,0,Friday,Early Morning,0,6,6,0.0
2011-03-11,1,Friday,Early Morning,0,8,8,0.0
2011-03-11,2,Friday,Early Morning,2,3,5,40.0
2011-03-11,3,Friday,Early Morning,0,2,2,0.0
2011-03-11,5,Friday,Early Morning,1,6,7,14.29
2011-03-11,6,Friday,Morning Rush,1,31,32,3.13
2011-03-11,7,Friday,Morning Rush,10,104,114,8.77
2011-03-11,8,Friday,Morning Rush,15,244,259,5.79
2011-03-11,9,Friday,Morning Rush,13,143,156,8.33
2011-03-11,10,Friday,Mid-Day,18,60,78,23.08
2011-03-11,11,Friday,Mid-Day,14,67,81,17.28
2011-03-11,12,Friday,Mid-Day,15,96,111,13.51
2011-03-11,13,Friday,Mid-Day,15,92,107,14.02
2011-03-11,14,Friday,Mid-Day,25,64,89,28.09
2011-03-11,15,Friday,Mid-Day,21,64,85,24.71
2011-03-11,16,Friday,Evening Rush,18,95,113,15.93
2011-03-11,17,Friday,Evening Rush,23,200,223,10.31
2011-03-11,18,Friday,Evening Rush,19,134,153,12.42
2011-03-11,19,Friday,Evening Rush,7,111,118,5.93
2011-03-11,20,Friday,Night,6,70,76,7.89
2011-03-11,21,Friday,Night,10,43,53,18.87
2011-03-11,22,Friday,Night,11,53,64,17.19
2011-03-11,23,Friday,Night,3,34,37,8.11
2011-03-12,0,Saturday,Early Morning,4,30,34,11.76
2011-03-12,1,Saturday,Early Morning,3,15,18,16.67
2011-03-12,2,Saturday,Early Morning,0,14,14,0.0
2011-03-12,3,Saturday,Early Morning,1,6,7,14.29
2011-03-12,4,Saturday,Early Morning,0,1,1,0.0
2011-03-12,5,Saturday,Early Morning,0,2,2,0.0
2011-03-12,6,Saturday,Morning Rush,2,2,4,50.0
2011-03-12,7,Saturday,Morning Rush,4,19,23,17.39
2011-03-12,8,Saturday,Morning Rush,9,44,53,16.98
2011-03-12,9,Saturday,Morning Rush,25,76,101,24.75
2011-03-12,10,Saturday,Mid-Day,21,78,99,21.21
2011-03-12,11,Saturday,Mid-Day,36,83,119,30.25
2011-03-12,12,Saturday,Mid-Day,51,107,158,32.28
2011-03-12,13,Saturday,Mid-Day,62,95,157,39.49
2011-03-12,14,Saturday,Mid-Day,70,96,166,42.17
2011-03-12,15,Saturday,Mid-Day,81,101,182,44.51
2011-03-12,16,Saturday,Evening Rush,100,144,244,40.98
2011-03-12,17,Saturday,Evening Rush,99,114,213,46.48
2011-03-12,18,Saturday,Evening Rush,54,91,145,37.24
2011-03-12,19,Saturday,Evening Rush,26,86,112,23.21
2011-03-12,20,Saturday,Night,22,64,86,25.58
2011-03-12,21,Saturday,Night,36,46,82,43.9
2011-03-12,22,Saturday,Night,7,56,63,11.11
2011-03-12,23,Saturday,Night,11,38,49,22.45
2011-03-13,0,Sunday,Early Morning,3,35,38,7.89
2011-03-13,1,Sunday,Early Morning,10,23,33,30.3
2011-03-13,3,Sunday,Early Morning,6,17,23,26.09
2011-03-13,4,Sunday,Early Morning,4,9,13,30.77
2011-03-13,5,Sunday,Early Morning,0,3,3,0.0
2011-03-13,6,Sunday,Morning Rush,0,2,2,0.0
2011-03-13,7,Sunday,Morning Rush,2,8,10,20.0
2011-03-13,8,Sunday,Morning Rush,11,23,34,32.35
2011-03-13,9,Sunday,Morning Rush,8,36,44,18.18
2011-03-13,10,Sunday,Mid-Day,36,86,122,29.51
2011-03-13,11,Sunday,Mid-Day,88,93,181,48.62
2011-03-13,12,Sunday,Mid-Day,74,120,194,38.14
2011-03-13,13,Sunday,Mid-Day,97,124,221,43.89
2011-03-13,14,Sunday,Mid-Day,144,106,250,57.6
2011-03-13,15,Sunday,Mid-Day,149,155,304,49.01
2011-03-13,16,Sunday,Evening Rush,124,132,256,48.44
2011-03-13,17,Sunday,Evening Rush,98,143,241,40.66
2011-03-13,18,Sunday,Evening Rush,55,92,147,37.41
2011-03-13,19,Sunday,Evening Rush,28,73,101,27.72
2011-03-13,20,Sunday,Night,23,54,77,29.87
2011-03-13,21,Sunday,Night,9,49,58,15.52
2011-03-13,22,Sunday,Night,8,29,37,21.62
2011-03-13,23,Sunday,Night,5,23,28,17.86
2011-03-14,0,Monday,Early Morning,4,7,11,36.36
2011-03-14,1,Monday,Early Morning,0,1,1,0.0
2011-03-14,2,Monday,Early Morning,0,1,1,0.0
2011-03-14,3,Monday,Early Morning,0,3,3,0.0
2011-03-14,5,Monday,Early Morning,0,8,8,0.0
2011-03-14,6,Monday,Morning Rush,1,27,28,3.57
2011-03-14,7,Monday,Morning Rush,4,84,88,4.55
2011-03-14,8,Monday,Morning Rush,24,217,241,9.96
2011-03-14,9,Monday,Morning Rush,13,127,140,9.29
2011-03-14,10,Monday,Mid-Day,27,57,84,32.14
2011-03-14,11,Monday,Mid-Day,26,45,71,36.62
2011-03-14,12,Monday,Mid-Day,40,54,94,42.55
2011-03-14,13,Monday,Mid-Day,24,51,75,32.0
2011-03-14,14,Monday,Mid-Day,27,52,79,34.18
2011-03-14,15,Monday,Mid-Day,24,77,101,23.76
2011-03-14,16,Monday,Evening Rush,27,80,107,25.23
2011-03-14,17,Monday,Evening Rush,42,229,271,15.5
2011-03-14,18,Monday,Evening Rush,25,210,235,10.64
2011-03-14,19,Monday,Evening Rush,17,133,150,11.33
2011-03-14,20,Monday,Night,23,106,129,17.83
2011-03-14,21,Monday,Night,5,58,63,7.94
2011-03-14,22,Monday,Night,4,43,47,8.51
2011-03-14,23,Monday,Night,2,17,19,10.53
2011-03-15,0,Tuesday,Early Morning,7,7,14,50.0
2011-03-15,1,Tuesday,Early Morning,4,6,10,40.0
2011-03-15,2,Tuesday,Early Morning,1,2,3,33.33
2011-03-15,4,Tuesday,Early Morning,1,1,2,50.0
2011-03-15,5,Tuesday,Early Morning,0,11,11,0.0
2011-03-15,6,Tuesday,Morning Rush,3,32,35,8.57
2011-03-15,7,Tuesday,Morning Rush,10,109,119,8.4
2011-03-15,8,Tuesday,Morning Rush,23,259,282,8.16
2011-03-15,9,Tuesday,Morning Rush,10,147,157,6.37
2011-03-15,10,Tuesday,Mid-Day,22,56,78,28.21
2011-03-15,11,Tuesday,Mid-Day,27,51,78,34.62
2011-03-15,12,Tuesday,Mid-Day,32,70,102,31.37
2011-03-15,13,Tuesday,Mid-Day,23,74,97,23.71
2011-03-15,14,Tuesday,Mid-Day,14,74,88,15.91
2011-03-15,15,Tuesday,Mid-Day,24,66,90,26.67
2011-03-15,16,Tuesday,Evening Rush,21,93,114,18.42
2011-03-15,17,Tuesday,Evening Rush,22,195,217,10.14
2011-03-15,18,Tuesday,Evening Rush,18,207,225,8.0
2011-03-15,19,Tuesday,Evening Rush,14,138,152,9.21
2011-03-15,20,Tuesday,Night,9,79,88,10.23
2011-03-15,21,Tuesday,Night,2,53,55,3.64
2011-03-15,22,Tuesday,Night,1,20,21,4.76
2011-03-15,23,Tuesday,Night,1,17,18,5.56
2011-03-16,0,Wednesday,Early Morning,0,8,8,0.0
2011-03-16,1,Wednesday,Early Morning,1,2,3,33.33
2011-03-16,3,Wednesday,Early Morning,1,2,3,33.33
2011-03-16,4,Wednesday,Early Morning,0,1,1,0.0
2011-03-16,5,Wednesday,Early Morning,0,3,3,0.0
2011-03-16,6,Wednesday,Morning Rush,1,30,31,3.23
2011-03-16,7,Wednesday,Morning Rush,10,101,111,9.01
2011-03-16,8,Wednesday,Morning Rush,26,227,253,10.28
2011-03-16,9,Wednesday,Morning Rush,10,144,154,6.49
2011-03-16,10,Wednesday,Mid-Day,19,49,68,27.94
2011-03-16,11,Wednesday,Mid-Day,13,62,75,17.33
2011-03-16,12,Wednesday,Mid-Day,23,65,88,26.14
2011-03-16,13,Wednesday,Mid-Day,18,81,99,18.18
2011-03-16,14,Wednesday,Mid-Day,33,67,100,33.0
2011-03-16,15,Wednesday,Mid-Day,22,79,101,21.78
2011-03-16,16,Wednesday,Evening Rush,30,121,151,19.87
2011-03-16,17,Wednesday,Evening Rush,37,216,253,14.62
2011-03-16,18,Wednesday,Evening Rush,26,211,237,10.97
2011-03-16,19,Wednesday,Evening Rush,18,150,168,10.71
2011-03-16,20,Wednesday,Night,10,111,121,8.26
2011-03-16,21,Wednesday,Night,3,75,78,3.85
2011-03-16,22,Wednesday,Night,11,48,59,18.64
2011-03-16,23,Wednesday,Night,9,18,27,33.33
2011-03-17,0,Thursday,Early Morning,4,19,23,17.39
2011-03-17,1,Thursday,Early Morning,1,11,12,8.33
2011-03-17,2,Thursday,Early Morning,3,5,8,37.5
2011-03-17,3,Thursday,Early Morning,1,1,2,50.0
2011-03-17,4,Thursday,Early Morning,0,3,3,0.0
2011-03-17,5,Thursday,Early Morning,0,13,13,0.0
2011-03-17,6,Thursday,Morning Rush,4,47,51,7.84
2011-03-17,7,Thursday,Morning Rush,12,128,140,8.57
2011-03-17,8,Thursday,Morning Rush,17,282,299,5.69
2011-03-17,9,Thursday,Morning Rush,23,162,185,12.43
2011-03-17,10,Thursday,Mid-Day,9,69,78,11.54
2011-03-17,11,Thursday,Mid-Day,20,66,86,23.26
2011-03-17,12,Thursday,Mid-Day,24,81,105,22.86
2011-03-17,13,Thursday,Mid-Day,26,85,111,23.42
2011-03-17,14,Thursday,Mid-Day,32,87,119,26.89
2011-03-17,15,Thursday,Mid-Day,30,95,125,24.0
2011-03-17,16,Thursday,Evening Rush,34,108,142,23.94
2011-03-17,17,Thursday,Evening Rush,48,265,313,15.34
2011-03-17,18,Thursday,Evening Rush,50,260,310,16.13
2011-03-17,19,Thursday,Evening Rush,18,189,207,8.7
2011-03-17,20,Thursday,Night,25,112,137,18.25
2011-03-17,21,Thursday,Night,19,119,138,13.77
2011-03-17,22,Thursday,Night,17,70,87,19.54
2011-03-17,23,Thursday,Night,7,43,50,14.0
2011-03-18,0,Friday,Early Morning,5,24,29,17.24
2011-03-18,1,Friday,Early Morning,4,12,16,25.0
2011-03-18,2,Friday,Early Morning,5,9,14,35.71
2011-03-18,3,Friday,Early Morning,1,4,5,20.0
2011-03-18,5,Friday,Early Morning,2,8,10,20.0
2011-03-18,6,Friday,Morning Rush,1,35,36,2.78
2011-03-18,7,Friday,Morning Rush,11,112,123,8.94
2011-03-18,8,Friday,Morning Rush,24,256,280,8.57
2011-03-18,9,Friday,Morning Rush,18,192,210,8.57
2011-03-18,10,Friday,Mid-Day,43,74,117,36.75
2011-03-18,11,Friday,Mid-Day,55,104,159,34.59
2011-03-18,12,Friday,Mid-Day,72,123,195,36.92
2011-03-18,13,Friday,Mid-Day,57,118,175,32.57
2011-03-18,14,Friday,Mid-Day,71,103,174,40.8
2011-03-18,15,Friday,Mid-Day,62,111,173,35.84
2011-03-18,16,Friday,Evening Rush,67,137,204,32.84
2011-03-18,17,Friday,Evening Rush,95,237,332,28.61
2011-03-18,18,Friday,Evening Rush,84,247,331,25.38
2011-03-18,19,Friday,Evening Rush,58,132,190,30.53
2011-03-18,20,Friday,Night,46,103,149,30.87
2011-03-18,21,Friday,Night,22,91,113,19.47
2011-03-18,22,Friday,Night,55,63,118,46.61
2011-03-18,23,Friday,Night,26,60,86,30.23
2011-03-19,0,Saturday,Early Morning,26,50,76,34.21
2011-03-19,1,Saturday,Early Morning,16,35,51,31.37
2011-03-19,2,Saturday,Early Morning,5,20,25,20.0
2011-03-19,3,Saturday,Early Morning,1,7,8,12.5
2011-03-19,4,Saturday,Early Morning,1,2,3,33.33
2011-03-19,5,Saturday,Early Morning,0,2,2,0.0
2011-03-19,6,Saturday,Morning Rush,0,10,10,0.0
2011-03-19,7,Saturday,Morning Rush,4,9,13,30.77
2011-03-19,8,Saturday,Morning Rush,11,37,48,22.92
2011-03-19,9,Saturday,Morning Rush,35,41,76,46.05
2011-03-19,10,Saturday,Mid-Day,55,85,140,39.29
2011-03-19,11,Saturday,Mid-Day,90,106,196,45.92
2011-03-19,12,Saturday,Mid-Day,126,141,267,47.19
2011-03-19,13,Saturday,Mid-Day,174,127,301,57.81
2011-03-19,14,Saturday,Mid-Day,168,144,312,53.85
2011-03-19,15,Saturday,Mid-Day,170,143,313,54.31
2011-03-19,16,Saturday,Evening Rush,175,129,304,57.57
2011-03-19,17,Saturday,Evening Rush,138,140,278,49.64
2011-03-19,18,Saturday,Evening Rush,92,125,217,42.4
2011-03-19,19,Saturday,Evening Rush,38,116,154,24.68
2011-03-19,20,Saturday,Night,39,69,108,36.11
2011-03-19,21,Saturday,Night,20,73,93,21.51
2011-03-19,22,Saturday,Night,27,45,72,37.5
2011-03-19,23,Saturday,Night,13,37,50,26.0
2011-03-20,0,Sunday,Early Morning,7,33,40,17.5
2011-03-20,1,Sunday,Early Morning,2,22,24,8.33
2011-03-20,2,Sunday,Early Morning,6,24,30,20.0
2011-03-20,3,Sunday,Early Morning,1,11,12,8.33
2011-03-20,4,Sunday,Early Morning,2,1,3,66.67
2011-03-20,5,Sunday,Early Morning,3,6,9,33.33
2011-03-20,6,Sunday,Morning Rush,1,3,4,25.0
2011-03-20,7,Sunday,Morning Rush,5,9,14,35.71
2011-03-20,8,Sunday,Morning Rush,7,30,37,18.92
2011-03-20,9,Sunday,Morning Rush,35,43,78,44.87
2011-03-20,10,Sunday,Mid-Day,55,81,136,40.44
2011-03-20,11,Sunday,Mid-Day,92,111,203,45.32
2011-03-20,12,Sunday,Mid-Day,120,108,228,52.63
2011-03-20,13,Sunday,Mid-Day,88,115,203,43.35
2011-03-20,14,Sunday,Mid-Day,145,134,279,51.97
2011-03-20,15,Sunday,Mid-Day,172,136,308,55.84
2011-03-20,16,Sunday,Evening Rush,92,132,224,41.07
2011-03-20,17,Sunday,Evening Rush,83,143,226,36.73
2011-03-20,18,Sunday,Evening Rush,58,98,156,37.18
2011-03-20,19,Sunday,Evening Rush,21,58,79,26.58
2011-03-20,20,Sunday,Night,21,46,67,31.34
2011-03-20,21,Sunday,Night,10,39,49,20.41
2011-03-20,22,Sunday,Night,8,30,38,21.05
2011-03-20,23,Sunday,Night,13,11,24,54.17
2011-03-21,0,Monday,Early Morning,2,11,13,15.38
2011-03-21,1,Monday,Early Morning,1,6,7,14.29
2011-03-21,2,Monday,Early Morning,1,5,6,16.67
2011-03-21,3,Monday,Early Morning,0,1,1,0.0
2011-03-21,5,Monday,Early Morning,1,1,2,50.0
2011-03-21,6,Monday,Morning Rush,2,30,32,6.25
2011-03-21,7,Monday,Morning Rush,3,15,18,16.67
2011-03-21,8,Monday,Morning Rush,3,95,98,3.06
2011-03-21,9,Monday,Morning Rush,12,115,127,9.45
2011-03-21,10,Monday,Mid-Day,17,45,62,27.42
2011-03-21,11,Monday,Mid-Day,32,47,79,40.51
2011-03-21,12,Monday,Mid-Day,25,56,81,30.86
2011-03-21,13,Monday,Mid-Day,35,77,112,31.25
2011-03-21,14,Monday,Mid-Day,36,65,101,35.64
2011-03-21,15,Monday,Mid-Day,41,66,107,38.32
2011-03-21,16,Monday,Evening Rush,29,112,141,20.57
2011-03-21,17,Monday,Evening Rush,41,231,272,15.07
2011-03-21,18,Monday,Evening Rush,44,232,276,15.94
2011-03-21,19,Monday,Evening Rush,22,199,221,9.95
2011-03-21,20,Monday,Night,16,106,122,13.11
2011-03-21,21,Monday,Night,12,79,91,13.19
2011-03-21,22,Monday,Night,18,60,78,23.08
2011-03-21,23,Monday,Night,8,22,30,26.67
2011-03-22,0,Tuesday,Early Morning,4,7,11,36.36
2011-03-22,1,Tuesday,Early Morning,6,13,19,31.58
2011-03-22,2,Tuesday,Early Morning,0,1,1,0.0
2011-03-22,3,Tuesday,Early Morning,3,2,5,60.0
2011-03-22,4,Tuesday,Early Morning,0,1,1,0.0
2011-03-22,5,Tuesday,Early Morning,1,11,12,8.33
2011-03-22,6,Tuesday,Morning Rush,2,58,60,3.33
2011-03-22,7,Tuesday,Morning Rush,4,132,136,2.94
2011-03-22,8,Tuesday,Morning Rush,24,312,336,7.14
2011-03-22,9,Tuesday,Morning Rush,19,159,178,10.67
2011-03-22,10,Tuesday,Mid-Day,29,95,124,23.39
2011-03-22,11,Tuesday,Mid-Day,22,64,86,25.58
2011-03-22,12,Tuesday,Mid-Day,35,86,121,28.93
2011-03-22,13,Tuesday,Mid-Day,21,85,106,19.81
2011-03-22,14,Tuesday,Mid-Day,30,71,101,29.7
2011-03-22,15,Tuesday,Mid-Day,55,79,134,41.04
2011-03-22,16,Tuesday,Evening Rush,40,125,165,24.24
2011-03-22,17,Tuesday,Evening Rush,42,265,307,13.68
2011-03-22,18,Tuesday,Evening Rush,41,271,312,13.14
2011-03-22,19,Tuesday,Evening Rush,22,142,164,13.41
2011-03-22,20,Tuesday,Night,19,116,135,14.07
2011-03-22,21,Tuesday,Night,24,63,87,27.59
2011-03-22,22,Tuesday,Night,13,57,70,18.57
2011-03-22,23,Tuesday,Night,4,28,32,12.5
2011-03-23,0,Wednesday,Early Morning,3,8,11,27.27
2011-03-23,1,Wednesday,Early Morning,0,7,7,0.0
2011-03-23,2,Wednesday,Early Morning,1,1,2,50.0
2011-03-23,3,Wednesday,Early Morning,0,3,3,0.0
2011-03-23,5,Wednesday,Early Morning,0,10,10,0.0
2011-03-23,6,Wednesday,Morning Rush,1,43,44,2.27
2011-03-23,7,Wednesday,Morning Rush,7,111,118,5.93
2011-03-23,8,Wednesday,Morning Rush,14,247,261,5.36
2011-03-23,9,Wednesday,Morning Rush,8,174,182,4.4
2011-03-23,10,Wednesday,Mid-Day,15,60,75,20.0
2011-03-23,11,Wednesday,Mid-Day,18,53,71,25.35
2011-03-23,12,Wednesday,Mid-Day,14,73,87,16.09
2011-03-23,13,Wednesday,Mid-Day,14,94,108,12.96
2011-03-23,14,Wednesday,Mid-Day,13,71,84,15.48
2011-03-23,15,Wednesday,Mid-Day,11,74,85,12.94
2011-03-23,16,Wednesday,Evening Rush,13,123,136,9.56
2011-03-23,17,Wednesday,Evening Rush,28,245,273,10.26
2011-03-23,18,Wednesday,Evening Rush,20,218,238,8.4
2011-03-23,19,Wednesday,Evening Rush,12,147,159,7.55
2011-03-23,20,Wednesday,Night,3,72,75,4.0
2011-03-23,21,Wednesday,Night,0,22,22,0.0
2011-03-23,22,Wednesday,Night,6,38,44,13.64
2011-03-23,23,Wednesday,Night,2,24,26,7.69
2011-03-24,0,Thursday,Early Morning,0,11,11,0.0
2011-03-24,1,Thursday,Early Morning,0,3,3,0.0
2011-03-24,2,Thursday,Early Morning,0,6,6,0.0
2011-03-24,3,Thursday,Early Morning,1,0,1,100.0
2011-03-24,4,Thursday,Early Morning,0,1,1,0.0
2011-03-24,5,Thursday,Early Morning,1,8,9,11.11
2011-03-24,6,Thursday,Morning Rush,0,41,41,0.0
2011-03-24,7,Thursday,Morning Rush,2,106,108,1.85
2011-03-24,8,Thursday,Morning Rush,4,120,124,3.23
2011-03-24,9,Thursday,Morning Rush,3,94,97,3.09
2011-03-24,10,Thursday,Mid-Day,10,55,65,15.38
2011-03-24,11,Thursday,Mid-Day,10,61,71,14.08
2011-03-24,12,Thursday,Mid-Day,12,82,94,12.77
2011-03-24,13,Thursday,Mid-Day,11,90,101,10.89
2011-03-24,14,Thursday,Mid-Day,17,66,83,20.48
2011-03-24,15,Thursday,Mid-Day,13,77,90,14.44
2011-03-24,16,Thursday,Evening Rush,6,78,84,7.14
2011-03-24,17,Thursday,Evening Rush,12,221,233,5.15
2011-03-24,18,Thursday,Evening Rush,17,197,214,7.94
2011-03-24,19,Thursday,Evening Rush,16,122,138,11.59
2011-03-24,20,Thursday,Night,8,110,118,6.78
2011-03-24,21,Thursday,Night,11,67,78,14.1
2011-03-24,22,Thursday,Night,3,59,62,4.84
2011-03-24,23,Thursday,Night,9,24,33,27.27
2011-03-25,0,Friday,Early Morning,1,17,18,5.56
2011-03-25,1,Friday,Early Morning,0,5,5,0.0
2011-03-25,2,Friday,Early Morning,0,5,5,0.0
2011-03-25,3,Friday,Early Morning,0,2,2,0.0
2011-03-25,4,Friday,Early Morning,3,2,5,60.0
2011-03-25,5,Friday,Early Morning,0,9,9,0.0
2011-03-25,6,Friday,Morning Rush,0,32,32,0.0
2011-03-25,7,Friday,Morning Rush,4,100,104,3.85
2011-03-25,8,Friday,Morning Rush,9,228,237,3.8
2011-03-25,9,Friday,Morning Rush,16,150,166,9.64
2011-03-25,10,Friday,Mid-Day,15,53,68,22.06
2011-03-25,11,Friday,Mid-Day,17,58,75,22.67
2011-03-25,12,Friday,Mid-Day,37,108,145,25.52
2011-03-25,13,Friday,Mid-Day,34,104,138,24.64
2011-03-25,14,Friday,Mid-Day,30,103,133,22.56
2011-03-25,15,Friday,Mid-Day,43,79,122,35.25
2011-03-25,16,Friday,Evening Rush,23,127,150,15.33
2011-03-25,17,Friday,Evening Rush,23,202,225,10.22
2011-03-25,18,Friday,Evening Rush,8,190,198,4.04
2011-03-25,19,Friday,Evening Rush,9,126,135,6.67
2011-03-25,20,Friday,Night,6,75,81,7.41
2011-03-25,21,Friday,Night,11,64,75,14.67
2011-03-25,22,Friday,Night,3,40,43,6.98
2011-03-25,23,Friday,Night,8,31,39,20.51
2011-03-26,0,Saturday,Early Morning,3,25,28,10.71
2011-03-26,1,Saturday,Early Morning,3,24,27,11.11
2011-03-26,2,Saturday,Early Morning,4,21,25,16.0
2011-03-26,3,Saturday,Early Morning,2,7,9,22.22
2011-03-26,4,Saturday,Early Morning,2,4,6,33.33
2011-03-26,5,Saturday,Early Morning,0,8,8,0.0
2011-03-26,6,Saturday,Morning Rush,2,8,10,20.0
2011-03-26,7,Saturday,Morning Rush,18,23,41,43.9
2011-03-26,8,Saturday,Morning Rush,24,42,66,36.36
2011-03-26,9,Saturday,Morning Rush,32,68,100,32.0
2011-03-26,10,Saturday,Mid-Day,32,93,125,25.6
2011-03-26,11,Saturday,Mid-Day,75,93,168,44.64
2011-03-26,12,Saturday,Mid-Day,98,129,227,43.17
2011-03-26,13,Saturday,Mid-Day,94,145,239,39.33
2011-03-26,14,Saturday,Mid-Day,93,123,216,43.06
2011-03-26,15,Saturday,Mid-Day,110,109,219,50.23
2011-03-26,16,Saturday,Evening Rush,118,130,248,47.58
2011-03-26,17,Saturday,Evening Rush,102,101,203,50.25
2011-03-26,18,Saturday,Evening Rush,64,89,153,41.83
2011-03-26,19,Saturday,Evening Rush,45,93,138,32.61
2011-03-26,20,Saturday,Night,18,67,85,21.18
2011-03-26,21,Saturday,Night,15,36,51,29.41
2011-03-26,22,Saturday,Night,17,46,63,26.98
2011-03-26,23,Saturday,Night,10,31,41,24.39
2011-03-27,0,Sunday,Early Morning,5,26,31,16.13
2011-03-27,1,Sunday,Early Morning,3,17,20,15.0
2011-03-27,2,Sunday,Early Morning,6,15,21,28.57
2011-03-27,3,Sunday,Early Morning,0,14,14,0.0
2011-03-27,4,Sunday,Early Morning,1,5,6,16.67
2011-03-27,6,Sunday,Morning Rush,0,2,2,0.0
2011-03-27,7,Sunday,Morning Rush,0,7,7,0.0
2011-03-27,8,Sunday,Morning Rush,6,8,14,42.86
2011-03-27,9,Sunday,Morning Rush,17,37,54,31.48
2011-03-27,10,Sunday,Mid-Day,27,59,86,31.4
2011-03-27,11,Sunday,Mid-Day,23,85,108,21.3
2011-03-27,12,Sunday,Mid-Day,43,120,163,26.38
2011-03-27,13,Sunday,Mid-Day,47,100,147,31.97
2011-03-27,14,Sunday,Mid-Day,61,103,164,37.2
2011-03-27,15,Sunday,Mid-Day,61,111,172,35.47
2011-03-27,16,Sunday,Evening Rush,45,98,143,31.47
2011-03-27,17,Sunday,Evening Rush,50,109,159,31.45
2011-03-27,18,Sunday,Evening Rush,32,105,137,23.36
2011-03-27,19,Sunday,Evening Rush,23,80,103,22.33
2011-03-27,20,Sunday,Night,7,50,57,12.28
2011-03-27,21,Sunday,Night,7,29,36,19.44
2011-03-27,22,Sunday,Night,5,25,30,16.67
2011-03-27,23,Sunday,Night,3,16,19,15.79
2011-03-28,0,Monday,Early Morning,1,11,12,8.33
2011-03-28,1,Monday,Early Morning,2,4,6,33.33
2011-03-28,2,Monday,Early Morning,0,5,5,0.0
2011-03-28,3,Monday,Early Morning,0,2,2,0.0
2011-03-28,5,Monday,Early Morning,0,8,8,0.0
2011-03-28,6,Monday,Morning Rush,0,40,40,0.0
2011-03-28,7,Monday,Morning Rush,6,104,110,5.45
2011-03-28,8,Monday,Morning Rush,15,239,254,5.91
2011-03-28,9,Monday,Morning Rush,12,109,121,9.92
2011-03-28,10,Monday,Mid-Day,22,47,69,31.88
2011-03-28,11,Monday,Mid-Day,18,39,57,31.58
2011-03-28,12,Monday,Mid-Day,8,71,79,10.13
2011-03-28,13,Monday,Mid-Day,14,69,83,16.87
2011-03-28,14,Monday,Mid-Day,15,65,80,18.75
2011-03-28,15,Monday,Mid-Day,19,53,72,26.39
2011-03-28,16,Monday,Evening Rush,15,117,132,11.36
2011-03-28,17,Monday,Evening Rush,25,227,252,9.92
2011-03-28,18,Monday,Evening Rush,21,220,241,8.71
2011-03-28,19,Monday,Evening Rush,17,156,173,9.83
2011-03-28,20,Monday,Night,5,107,112,4.46
2011-03-28,21,Monday,Night,6,55,61,9.84
2011-03-28,22,Monday,Night,0,40,40,0.0
2011-03-28,23,Monday,Night,1,18,19,5.26
2011-03-29,0,Tuesday,Early Morning,1,15,16,6.25
2011-03-29,1,Tuesday,Early Morning,0,4,4,0.0
2011-03-29,2,Tuesday,Early Morning,0,3,3,0.0
2011-03-29,3,Tuesday,Early Morning,2,1,3,66.67
2011-03-29,4,Tuesday,Early Morning,1,1,2,50.0
2011-03-29,5,Tuesday,Early Morning,0,8,8,0.0
2011-03-29,6,Tuesday,Morning Rush,4,46,50,8.0
2011-03-29,7,Tuesday,Morning Rush,5,128,133,3.76
2011-03-29,8,Tuesday,Morning Rush,19,268,287,6.62
2011-03-29,9,Tuesday,Morning Rush,16,156,172,9.3
2011-03-29,10,Tuesday,Mid-Day,13,46,59,22.03
2011-03-29,11,Tuesday,Mid-Day,18,63,81,22.22
2011-03-29,12,Tuesday,Mid-Day,29,77,106,27.36
2011-03-29,13,Tuesday,Mid-Day,24,80,104,23.08
2011-03-29,14,Tuesday,Mid-Day,20,66,86,23.26
2011-03-29,15,Tuesday,Mid-Day,22,65,87,25.29
2011-03-29,16,Tuesday,Evening Rush,12,124,136,8.82
2011-03-29,17,Tuesday,Evening Rush,34,265,299,11.37
2011-03-29,18,Tuesday,Evening Rush,42,252,294,14.29
2011-03-29,19,Tuesday,Evening Rush,20,170,190,10.53
2011-03-29,20,Tuesday,Night,13,119,132,9.85
2011-03-29,21,Tuesday,Night,8,75,83,9.64
2011-03-29,22,Tuesday,Night,6,49,55,10.91
2011-03-29,23,Tuesday,Night,8,27,35,22.86
2011-03-30,0,Wednesday,Early Morning,3,8,11,27.27
2011-03-30,1,Wednesday,Early Morning,1,9,10,10.0
2011-03-30,2,Wednesday,Early Morning,0,4,4,0.0
2011-03-30,3,Wednesday,Early Morning,0,4,4,0.0
2011-03-30,4,Wednesday,Early Morning,1,0,1,100.0
2011-03-30,5,Wednesday,Early Morning,0,7,7,0.0
2011-03-30,6,Wednesday,Morning Rush,4,44,48,8.33
2011-03-30,7,Wednesday,Morning Rush,8,128,136,5.88
2011-03-30,8,Wednesday,Morning Rush,16,247,263,6.08
2011-03-30,9,Wednesday,Morning Rush,7,147,154,4.55
2011-03-30,10,Wednesday,Mid-Day,13,51,64,20.31
2011-03-30,11,Wednesday,Mid-Day,26,64,90,28.89
2011-03-30,12,Wednesday,Mid-Day,15,65,80,18.75
2011-03-30,13,Wednesday,Mid-Day,14,84,98,14.29
2011-03-30,14,Wednesday,Mid-Day,16,64,80,20.0
2011-03-30,15,Wednesday,Mid-Day,14,56,70,20.0
2011-03-30,16,Wednesday,Evening Rush,0,36,36,0.0
2011-03-30,17,Wednesday,Evening Rush,11,105,116,9.48
2011-03-30,18,Wednesday,Evening Rush,6,79,85,7.06
2011-03-30,19,Wednesday,Evening Rush,5,67,72,6.94
2011-03-30,20,Wednesday,Night,4,40,44,9.09
2011-03-30,21,Wednesday,Night,0,27,27,0.0
2011-03-30,22,Wednesday,Night,3,21,24,12.5
2011-03-30,23,Wednesday,Night,1,11,12,8.33
2011-03-31,0,Thursday,Early Morning,0,3,3,0.0
2011-03-31,1,Thursday,Early Morning,1,4,5,20.0
2011-03-31,2,Thursday,Early Morning,0,5,5,0.0
2011-03-31,3,Thursday,Early Morning,0,1,1,0.0
2011-03-31,4,Thursday,Early Morning,0,2,2,0.0
2011-03-31,5,Thursday,Early Morning,0,8,8,0.0
2011-03-31,6,Thursday,Morning Rush,2,34,36,5.56
2011-03-31,7,Thursday,Morning Rush,5,87,92,5.43
2011-03-31,8,Thursday,Morning Rush,7,185,192,3.65
2011-03-31,9,Thursday,Morning Rush,6,126,132,4.55
2011-03-31,10,Thursday,Mid-Day,15,54,69,21.74
2011-03-31,11,Thursday,Mid-Day,6,52,58,10.34
2011-03-31,12,Thursday,Mid-Day,17,73,90,18.89
2011-03-31,13,Thursday,Mid-Day,13,55,68,19.12
2011-03-31,14,Thursday,Mid-Day,27,49,76,35.53
2011-03-31,15,Thursday,Mid-Day,4,61,65,6.15
2011-03-31,16,Thursday,Evening Rush,13,72,85,15.29
2011-03-31,17,Thursday,Evening Rush,15,153,168,8.93
2011-03-31,18,Thursday,Evening Rush,12,165,177,6.78
2011-03-31,19,Thursday,Evening Rush,12,118,130,9.23
2011-03-31,20,Thursday,Night,6,79,85,7.06
2011-03-31,21,Thursday,Night,7,53,60,11.67
2011-03-31,22,Thursday,Night,7,44,51,13.73
2011-03-31,23,Thursday,Night,4,23,27,14.81
2011-04-01,0,Friday,Early Morning,0,6,6,0.0
2011-04-01,1,Friday,Early Morning,0,4,4,0.0
2011-04-01,2,Friday,Early Morning,0,7,7,0.0
2011-04-01,3,Friday,Early Morning,0,4,4,0.0
2011-04-01,4,Friday,Early Morning,0,3,3,0.0
2011-04-01,5,Friday,Early Morning,1,11,12,8.33
2011-04-01,6,Friday,Morning Rush,2,26,28,7.14
2011-04-01,7,Friday,Morning Rush,4,91,95,4.21
2011-04-01,8,Friday,Morning Rush,8,198,206,3.88
2011-04-01,9,Friday,Morning Rush,11,162,173,6.36
2011-04-01,10,Friday,Mid-Day,12,63,75,16.0
2011-04-01,11,Friday,Mid-Day,17,72,89,19.1
2011-04-01,12,Friday,Mid-Day,15,80,95,15.79
2011-04-01,13,Friday,Mid-Day,18,92,110,16.36
2011-04-01,14,Friday,Mid-Day,26,61,87,29.89
2011-04-01,15,Friday,Mid-Day,30,81,111,27.03
2011-04-01,16,Friday,Evening Rush,42,125,167,25.15
2011-04-01,17,Friday,Evening Rush,36,245,281,12.81
2011-04-01,18,Friday,Evening Rush,36,205,241,14.94
2011-04-01,19,Friday,Evening Rush,16,120,136,11.76
2011-04-01,20,Friday,Night,2,75,77,2.6
2011-04-01,21,Friday,Night,9,84,93,9.68
2011-04-01,22,Friday,Night,10,64,74,13.51
2011-04-01,23,Friday,Night,12,41,53,22.64
2011-04-02,0,Saturday,Early Morning,3,29,32,9.38
2011-04-02,1,Saturday,Early Morning,4,28,32,12.5
2011-04-02,2,Saturday,Early Morning,1,20,21,4.76
2011-04-02,3,Saturday,Early Morning,1,8,9,11.11
2011-04-02,4,Saturday,Early Morning,0,5,5,0.0
2011-04-02,5,Saturday,Early Morning,1,4,5,20.0
2011-04-02,6,Saturday,Morning Rush,5,7,12,41.67
2011-04-02,7,Saturday,Morning Rush,2,16,18,11.11
2011-04-02,8,Saturday,Morning Rush,10,45,55,18.18
2011-04-02,9,Saturday,Morning Rush,22,65,87,25.29
2011-04-02,10,Saturday,Mid-Day,41,113,154,26.62
2011-04-02,11,Saturday,Mid-Day,72,126,198,36.36
2011-04-02,12,Saturday,Mid-Day,84,100,184,45.65
2011-04-02,13,Saturday,Mid-Day,56,81,137,40.88
2011-04-02,14,Saturday,Mid-Day,97,93,190,51.05
2011-04-02,15,Saturday,Mid-Day,72,64,136,52.94
2011-04-02,16,Saturday,Evening Rush,111,85,196,56.63
2011-04-02,17,Saturday,Evening Rush,89,95,184,48.37
2011-04-02,18,Saturday,Evening Rush,69,110,179,38.55
2011-04-02,19,Saturday,Evening Rush,71,77,148,47.97
2011-04-02,20,Saturday,Night,29,56,85,34.12
2011-04-02,21,Saturday,Night,24,53,77,31.17
2011-04-02,22,Saturday,Night,14,41,55,25.45
2011-04-02,23,Saturday,Night,20,33,53,37.74
2011-04-03,0,Sunday,Early Morning,8,31,39,20.51
2011-04-03,1,Sunday,Early Morning,8,26,34,23.53
2011-04-03,2,Sunday,Early Morning,5,19,24,20.83
2011-04-03,3,Sunday,Early Morning,3,8,11,27.27
2011-04-03,4,Sunday,Early Morning,3,0,3,100.0
2011-04-03,5,Sunday,Early Morning,1,4,5,20.0
2011-04-03,6,Sunday,Morning Rush,10,23,33,30.3
2011-04-03,7,Sunday,Morning Rush,13,20,33,39.39
2011-04-03,8,Sunday,Morning Rush,18,44,62,29.03
2011-04-03,9,Sunday,Morning Rush,68,74,142,47.89
2011-04-03,10,Sunday,Mid-Day,111,104,215,51.63
2011-04-03,11,Sunday,Mid-Day,139,104,243,57.2
2011-04-03,12,Sunday,Mid-Day,166,147,313,53.04
2011-04-03,13,Sunday,Mid-Day,219,148,367,59.67
2011-04-03,14,Sunday,Mid-Day,240,109,349,68.77
2011-04-03,15,Sunday,Mid-Day,174,118,292,59.59
2011-04-03,16,Sunday,Evening Rush,147,156,303,48.51
2011-04-03,17,Sunday,Evening Rush,148,126,274,54.01
2011-04-03,18,Sunday,Evening Rush,71,101,172,41.28
2011-04-03,19,Sunday,Evening Rush,51,93,144,35.42
2011-04-03,20,Sunday,Night,24,55,79,30.38
2011-04-03,21,Sunday,Night,8,37,45,17.78
2011-04-03,22,Sunday,Night,7,29,36,19.44
2011-04-03,23,Sunday,Night,9,22,31,29.03
2011-04-04,0,Monday,Early Morning,1,5,6,16.67
2011-04-04,1,Monday,Early Morning,7,4,11,63.64
2011-04-04,2,Monday,Early Morning,1,1,2,50.0
2011-04-04,3,Monday,Early Morning,1,0,1,100.0
2011-04-04,4,Monday,Early Morning,1,1,2,50.0
2011-04-04,5,Monday,Early Morning,0,7,7,0.0
2011-04-04,6,Monday,Morning Rush,3,43,46,6.52
2011-04-04,7,Monday,Morning Rush,7,150,157,4.46
2011-04-04,8,Monday,Morning Rush,31,308,339,9.14
2011-04-04,9,Monday,Morning Rush,24,134,158,15.19
2011-04-04,10,Monday,Mid-Day,35,55,90,38.89
2011-04-04,11,Monday,Mid-Day,58,66,124,46.77
2011-04-04,12,Monday,Mid-Day,59,98,157,37.58
2011-04-04,13,Monday,Mid-Day,47,92,139,33.81
2011-04-04,14,Monday,Mid-Day,47,76,123,38.21
2011-04-04,15,Monday,Mid-Day,47,96,143,32.87
2011-04-04,16,Monday,Evening Rush,59,130,189,31.22
2011-04-04,17,Monday,Evening Rush,83,283,366,22.68
2011-04-04,18,Monday,Evening Rush,78,308,386,20.21
2011-04-04,19,Monday,Evening Rush,51,227,278,18.35
2011-04-04,20,Monday,Night,40,133,173,23.12
2011-04-04,21,Monday,Night,19,76,95,20.0
2011-04-04,22,Monday,Night,17,58,75,22.67
2011-04-04,23,Monday,Night,18,30,48,37.5
2011-04-05,0,Tuesday,Early Morning,10,12,22,45.45
2011-04-05,1,Tuesday,Early Morning,10,5,15,66.67
2011-04-05,2,Tuesday,Early Morning,0,5,5,0.0
2011-04-05,3,Tuesday,Early Morning,1,3,4,25.0
2011-04-05,4,Tuesday,Early Morning,0,2,2,0.0
2011-04-05,5,Tuesday,Early Morning,0,5,5,0.0
2011-04-05,6,Tuesday,Morning Rush,2,36,38,5.26
2011-04-05,7,Tuesday,Morning Rush,10,124,134,7.46
2011-04-05,8,Tuesday,Morning Rush,9,148,157,5.73
2011-04-05,9,Tuesday,Morning Rush,2,44,46,4.35
2011-04-05,10,Tuesday,Mid-Day,3,25,28,10.71
2011-04-05,11,Tuesday,Mid-Day,1,18,19,5.26
2011-04-05,12,Tuesday,Mid-Day,6,32,38,15.79
2011-04-05,13,Tuesday,Mid-Day,5,51,56,8.93
2011-04-05,14,Tuesday,Mid-Day,9,67,76,11.84
2011-04-05,15,Tuesday,Mid-Day,6,62,68,8.82
2011-04-05,16,Tuesday,Evening Rush,17,113,130,13.08
2011-04-05,17,Tuesday,Evening Rush,27,246,273,9.89
2011-04-05,18,Tuesday,Evening Rush,19,248,267,7.12
2011-04-05,19,Tuesday,Evening Rush,12,148,160,7.5
2011-04-05,20,Tuesday,Night,4,87,91,4.4
2011-04-05,21,Tuesday,Night,8,81,89,8.99
2011-04-05,22,Tuesday,Night,3,43,46,6.52
2011-04-05,23,Tuesday,Night,3,23,26,11.54
2011-04-06,0,Wednesday,Early Morning,0,15,15,0.0
2011-04-06,1,Wednesday,Early Morning,0,2,2,0.0
2011-04-06,2,Wednesday,Early Morning,0,5,5,0.0
2011-04-06,3,Wednesday,Early Morning,0,4,4,0.0
2011-04-06,4,Wednesday,Early Morning,0,1,1,0.0
2011-04-06,5,Wednesday,Early Morning,1,12,13,7.69
2011-04-06,6,Wednesday,Morning Rush,4,52,56,7.14
2011-04-06,7,Wednesday,Morning Rush,3,130,133,2.26
2011-04-06,8,Wednesday,Morning Rush,17,308,325,5.23
2011-04-06,9,Wednesday,Morning Rush,8,157,165,4.85
2011-04-06,10,Wednesday,Mid-Day,21,48,69,30.43
2011-04-06,11,Wednesday,Mid-Day,23,70,93,24.73
2011-04-06,12,Wednesday,Mid-Day,22,112,134,16.42
2011-04-06,13,Wednesday,Mid-Day,29,83,112,25.89
2011-04-06,14,Wednesday,Mid-Day,35,80,115,30.43
2011-04-06,15,Wednesday,Mid-Day,34,83,117,29.06
2011-04-06,16,Wednesday,Evening Rush,27,142,169,15.98
2011-04-06,17,Wednesday,Evening Rush,53,303,356,14.89
2011-04-06,18,Wednesday,Evening Rush,43,282,325,13.23
2011-04-06,19,Wednesday,Evening Rush,36,196,232,15.52
2011-04-06,20,Wednesday,Night,15,126,141,10.64
2011-04-06,21,Wednesday,Night,18,84,102,17.65
2011-04-06,22,Wednesday,Night,13,71,84,15.48
2011-04-06,23,Wednesday,Night,11,29,40,27.5
2011-04-07,0,Thursday,Early Morning,5,15,20,25.0
2011-04-07,1,Thursday,Early Morning,2,11,13,15.38
2011-04-07,2,Thursday,Early Morning,0,7,7,0.0
2011-04-07,3,Thursday,Early Morning,0,3,3,0.0
2011-04-07,4,Thursday,Early Morning,0,1,1,0.0
2011-04-07,5,Thursday,Early Morning,0,6,6,0.0
2011-04-07,6,Thursday,Morning Rush,5,59,64,7.81
2011-04-07,7,Thursday,Morning Rush,8,152,160,5.0
2011-04-07,8,Thursday,Morning Rush,23,291,314,7.32
2011-04-07,9,Thursday,Morning Rush,15,155,170,8.82
2011-04-07,10,Thursday,Mid-Day,29,66,95,30.53
2011-04-07,11,Thursday,Mid-Day,36,86,122,29.51
2011-04-07,12,Thursday,Mid-Day,39,114,153,25.49
2011-04-07,13,Thursday,Mid-Day,36,99,135,26.67
2011-04-07,14,Thursday,Mid-Day,46,111,157,29.3
2011-04-07,15,Thursday,Mid-Day,27,133,160,16.88
2011-04-07,16,Thursday,Evening Rush,52,161,213,24.41
2011-04-07,17,Thursday,Evening Rush,63,280,343,18.37
2011-04-07,18,Thursday,Evening Rush,68,265,333,20.42
2011-04-07,19,Thursday,Evening Rush,34,192,226,15.04
2011-04-07,20,Thursday,Night,37,166,203,18.23
2011-04-07,21,Thursday,Night,19,89,108,17.59
2011-04-07,22,Thursday,Night,18,63,81,22.22
2011-04-07,23,Thursday,Night,9,45,54,16.67
2011-04-08,0,Friday,Early Morning,4,21,25,16.0
2011-04-08,1,Friday,Early Morning,3,6,9,33.33
2011-04-08,2,Friday,Early Morning,3,10,13,23.08
2011-04-08,3,Friday,Early Morning,0,1,1,0.0
2011-04-08,4,Friday,Early Morning,0,1,1,0.0
2011-04-08,5,Friday,Early Morning,1,8,9,11.11
2011-04-08,6,Friday,Morning Rush,2,33,35,5.71
2011-04-08,7,Friday,Morning Rush,4,109,113,3.54
2011-04-08,8,Friday,Morning Rush,13,208,221,5.88
2011-04-08,9,Friday,Morning Rush,17,168,185,9.19
2011-04-08,10,Friday,Mid-Day,10,63,73,13.7
2011-04-08,11,Friday,Mid-Day,19,79,98,19.39
2011-04-08,12,Friday,Mid-Day,29,51,80,36.25
2011-04-08,13,Friday,Mid-Day,7,35,42,16.67
2011-04-08,14,Friday,Mid-Day,2,13,15,13.33
2011-04-08,15,Friday,Mid-Day,1,24,25,4.0
2011-04-08,16,Friday,Evening Rush,2,58,60,3.33
2011-04-08,17,Friday,Evening Rush,10,138,148,6.76
2011-04-08,18,Friday,Evening Rush,8,54,62,12.9
2011-04-08,19,Friday,Evening Rush,1,52,53,1.89
2011-04-08,20,Friday,Night,12,51,63,19.05
2011-04-08,21,Friday,Night,11,43,54,20.37
2011-04-08,22,Friday,Night,9,42,51,17.65
2011-04-08,23,Friday,Night,4,31,35,11.43
2011-04-09,0,Saturday,Early Morning,5,26,31,16.13
2011-04-09,1,Saturday,Early Morning,3,17,20,15.0
2011-04-09,2,Saturday,Early Morning,2,15,17,11.76
2011-04-09,3,Saturday,Early Morning,3,11,14,21.43
2011-04-09,4,Saturday,Early Morning,0,3,3,0.0
2011-04-09,5,Saturday,Early Morning,0,5,5,0.0
2011-04-09,6,Saturday,Morning Rush,0,13,13,0.0
2011-04-09,7,Saturday,Morning Rush,8,13,21,38.1
2011-04-09,8,Saturday,Morning Rush,7,47,54,12.96
2011-04-09,9,Saturday,Morning Rush,27,71,98,27.55
2011-04-09,10,Saturday,Mid-Day,43,90,133,32.33
2011-04-09,11,Saturday,Mid-Day,51,91,142,35.92
2011-04-09,12,Saturday,Mid-Day,79,123,202,39.11
2011-04-09,13,Saturday,Mid-Day,114,108,222,51.35
2011-04-09,14,Saturday,Mid-Day,94,118,212,44.34
2011-04-09,15,Saturday,Mid-Day,85,116,201,42.29
2011-04-09,16,Saturday,Evening Rush,73,118,191,38.22
2011-04-09,17,Saturday,Evening Rush,128,129,257,49.81
2011-04-09,18,Saturday,Evening Rush,48,129,177,27.12
2011-04-09,19,Saturday,Evening Rush,47,83,130,36.15
2011-04-09,20,Saturday,Night,19,74,93,20.43
2011-04-09,21,Saturday,Night,10,65,75,13.33
2011-04-09,22,Saturday,Night,21,66,87,24.14
2011-04-09,23,Saturday,Night,12,45,57,21.05
2011-04-10,0,Sunday,Early Morning,5,48,53,9.43
2011-04-10,1,Sunday,Early Morning,6,31,37,16.22
2011-04-10,2,Sunday,Early Morning,12,24,36,33.33
2011-04-10,3,Sunday,Early Morning,5,11,16,31.25
2011-04-10,4,Sunday,Early Morning,3,2,5,60.0
2011-04-10,5,Sunday,Early Morning,0,4,4,0.0
2011-04-10,6,Sunday,Morning Rush,0,4,4,0.0
2011-04-10,7,Sunday,Morning Rush,3,7,10,30.0
2011-04-10,8,Sunday,Morning Rush,17,38,55,30.91
2011-04-10,9,Sunday,Morning Rush,31,50,81,38.27
2011-04-10,10,Sunday,Mid-Day,69,81,150,46.0
2011-04-10,11,Sunday,Mid-Day,93,109,202,46.04
2011-04-10,12,Sunday,Mid-Day,94,136,230,40.87
2011-04-10,13,Sunday,Mid-Day,121,142,263,46.01
2011-04-10,14,Sunday,Mid-Day,148,133,281,52.67
2011-04-10,15,Sunday,Mid-Day,156,141,297,52.53
2011-04-10,16,Sunday,Evening Rush,135,153,288,46.88
2011-04-10,17,Sunday,Evening Rush,84,152,236,35.59
2011-04-10,18,Sunday,Evening Rush,103,137,240,42.92
2011-04-10,19,Sunday,Evening Rush,47,84,131,35.88
2011-04-10,20,Sunday,Night,21,71,92,22.83
2011-04-10,21,Sunday,Night,18,77,95,18.95
2011-04-10,22,Sunday,Night,12,45,57,21.05
2011-04-10,23,Sunday,Night,5,27,32,15.63
2011-04-11,0,Monday,Early Morning,7,16,23,30.43
2011-04-11,1,Monday,Early Morning,1,3,4,25.0
2011-04-11,2,Monday,Early Morning,7,2,9,77.78
2011-04-11,4,Monday,Early Morning,0,1,1,0.0
2011-04-11,5,Monday,Early Morning,1,12,13,7.69
2011-04-11,6,Monday,Morning Rush,2,59,61,3.28
2011-04-11,7,Monday,Morning Rush,12,164,176,6.82
2011-04-11,8,Monday,Morning Rush,28,286,314,8.92
2011-04-11,9,Monday,Morning Rush,33,132,165,20.0
2011-04-11,10,Monday,Mid-Day,41,55,96,42.71
2011-04-11,11,Monday,Mid-Day,45,59,104,43.27
2011-04-11,12,Monday,Mid-Day,37,97,134,27.61
2011-04-11,13,Monday,Mid-Day,62,77,139,44.6
2011-04-11,14,Monday,Mid-Day,60,85,145,41.38
2011-04-11,15,Monday,Mid-Day,56,85,141,39.72
2011-04-11,16,Monday,Evening Rush,73,162,235,31.06
2011-04-11,17,Monday,Evening Rush,100,352,452,22.12
2011-04-11,18,Monday,Evening Rush,93,290,383,24.28
2011-04-11,19,Monday,Evening Rush,73,211,284,25.7
2011-04-11,20,Monday,Night,44,122,166,26.51
2011-04-11,21,Monday,Night,39,119,158,24.68
2011-04-11,22,Monday,Night,25,66,91,27.47
2011-04-11,23,Monday,Night,16,38,54,29.63
2011-04-12,0,Tuesday,Early Morning,11,13,24,45.83
2011-04-12,1,Tuesday,Early Morning,6,7,13,46.15
2011-04-12,2,Tuesday,Early Morning,7,7,14,50.0
2011-04-12,3,Tuesday,Early Morning,0,1,1,0.0
2011-04-12,4,Tuesday,Early Morning,4,2,6,66.67
2011-04-12,5,Tuesday,Early Morning,1,15,16,6.25
2011-04-12,6,Tuesday,Morning Rush,3,55,58,5.17
2011-04-12,7,Tuesday,Morning Rush,12,177,189,6.35
2011-04-12,8,Tuesday,Morning Rush,15,211,226,6.64
2011-04-12,9,Tuesday,Morning Rush,4,50,54,7.41
2011-04-12,10,Tuesday,Mid-Day,6,34,40,15.0
2011-04-12,11,Tuesday,Mid-Day,11,38,49,22.45
2011-04-12,12,Tuesday,Mid-Day,9,83,92,9.78
2011-04-12,13,Tuesday,Mid-Day,22,84,106,20.75
2011-04-12,14,Tuesday,Mid-Day,16,28,44,36.36
2011-04-12,15,Tuesday,Mid-Day,24,54,78,30.77
2011-04-12,16,Tuesday,Evening Rush,19,80,99,19.19
2011-04-12,17,Tuesday,Evening Rush,29,262,291,9.97
2011-04-12,18,Tuesday,Evening Rush,21,203,224,9.38
2011-04-12,19,Tuesday,Evening Rush,3,127,130,2.31
2011-04-12,20,Tuesday,Night,9,94,103,8.74
2011-04-12,21,Tuesday,Night,10,74,84,11.9
2011-04-12,22,Tuesday,Night,7,47,54,12.96
2011-04-12,23,Tuesday,Night,8,31,39,20.51
2011-04-13,0,Wednesday,Early Morning,3,12,15,20.0
2011-04-13,1,Wednesday,Early Morning,0,1,1,0.0
2011-04-13,2,Wednesday,Early Morning,0,2,2,0.0
2011-04-13,3,Wednesday,Early Morning,0,2,2,0.0
2011-04-13,4,Wednesday,Early Morning,1,2,3,33.33
2011-04-13,5,Wednesday,Early Morning,1,4,5,20.0
2011-04-13,6,Wednesday,Morning Rush,1,33,34,2.94
2011-04-13,7,Wednesday,Morning Rush,3,67,70,4.29
2011-04-13,8,Wednesday,Morning Rush,6,158,164,3.66
2011-04-13,9,Wednesday,Morning Rush,2,63,65,3.08
2011-04-13,10,Wednesday,Mid-Day,4,42,46,8.7
2011-04-13,11,Wednesday,Mid-Day,4,57,61,6.56
2011-04-13,12,Wednesday,Mid-Day,12,83,95,12.63
2011-04-13,13,Wednesday,Mid-Day,6,55,61,9.84
2011-04-13,14,Wednesday,Mid-Day,24,82,106,22.64
2011-04-13,15,Wednesday,Mid-Day,12,69,81,14.81
2011-04-13,16,Wednesday,Evening Rush,23,119,142,16.2
2011-04-13,17,Wednesday,Evening Rush,25,284,309,8.09
2011-04-13,18,Wednesday,Evening Rush,28,293,321,8.72
2011-04-13,19,Wednesday,Evening Rush,15,160,175,8.57
2011-04-13,20,Wednesday,Night,7,119,126,5.56
2011-04-13,21,Wednesday,Night,17,100,117,14.53
2011-04-13,22,Wednesday,Night,10,89,99,10.1
2011-04-13,23,Wednesday,Night,5,57,62,8.06
2011-04-14,0,Thursday,Early Morning,3,18,21,14.29
2011-04-14,1,Thursday,Early Morning,1,9,10,10.0
2011-04-14,2,Thursday,Early Morning,0,3,3,0.0
2011-04-14,3,Thursday,Early Morning,0,2,2,0.0
2011-04-14,4,Thursday,Early Morning,1,8,9,11.11
2011-04-14,5,Thursday,Early Morning,2,12,14,14.29
2011-04-14,6,Thursday,Morning Rush,4,66,70,5.71
2011-04-14,7,Thursday,Morning Rush,11,182,193,5.7
2011-04-14,8,Thursday,Morning Rush,21,316,337,6.23
2011-04-14,9,Thursday,Morning Rush,18,152,170,10.59
2011-04-14,10,Thursday,Mid-Day,21,68,89,23.6
2011-04-14,11,Thursday,Mid-Day,28,87,115,24.35
2011-04-14,12,Thursday,Mid-Day,35,110,145,24.14
2011-04-14,13,Thursday,Mid-Day,38,121,159,23.9
2011-04-14,14,Thursday,Mid-Day,36,101,137,26.28
2011-04-14,15,Thursday,Mid-Day,57,85,142,40.14
2011-04-14,16,Thursday,Evening Rush,49,153,202,24.26
2011-04-14,17,Thursday,Evening Rush,50,338,388,12.89
2011-04-14,18,Thursday,Evening Rush,47,290,337,13.95
2011-04-14,19,Thursday,Evening Rush,37,222,259,14.29
2011-04-14,20,Thursday,Night,22,147,169,13.02
2011-04-14,21,Thursday,Night,19,126,145,13.1
2011-04-14,22,Thursday,Night,22,82,104,21.15
2011-04-14,23,Thursday,Night,7,40,47,14.89
2011-04-15,0,Friday,Early Morning,6,21,27,22.22
2011-04-15,1,Friday,Early Morning,6,9,15,40.0
2011-04-15,2,Friday,Early Morning,8,10,18,44.44
2011-04-15,3,Friday,Early Morning,0,3,3,0.0
2011-04-15,4,Friday,Early Morning,0,3,3,0.0
2011-04-15,5,Friday,Early Morning,2,11,13,15.38
2011-04-15,6,Friday,Morning Rush,5,42,47,10.64
2011-04-15,7,Friday,Morning Rush,10,139,149,6.71
2011-04-15,8,Friday,Morning Rush,21,279,300,7.0
2011-04-15,9,Friday,Morning Rush,16,162,178,8.99
2011-04-15,10,Friday,Mid-Day,31,91,122,25.41
2011-04-15,11,Friday,Mid-Day,41,95,136,30.15
2011-04-15,12,Friday,Mid-Day,45,155,200,22.5
2011-04-15,13,Friday,Mid-Day,47,133,180,26.11
2011-04-15,14,Friday,Mid-Day,57,106,163,34.97
2011-04-15,15,Friday,Mid-Day,50,112,162,30.86
2011-04-15,16,Friday,Evening Rush,70,173,243,28.81
2011-04-15,17,Friday,Evening Rush,64,267,331,19.34
2011-04-15,18,Friday,Evening Rush,47,216,263,17.87
2011-04-15,19,Friday,Evening Rush,41,168,209,19.62
2011-04-15,20,Friday,Night,26,92,118,22.03
2011-04-15,21,Friday,Night,25,77,102,24.51
2011-04-15,22,Friday,Night,16,64,80,20.0
2011-04-15,23,Friday,Night,8,56,64,12.5
2011-04-16,0,Saturday,Early Morning,7,36,43,16.28
2011-04-16,1,Saturday,Early Morning,5,28,33,15.15
2011-04-16,2,Saturday,Early Morning,5,19,24,20.83
2011-04-16,3,Saturday,Early Morning,5,9,14,35.71
2011-04-16,4,Saturday,Early Morning,1,4,5,20.0
2011-04-16,5,Saturday,Early Morning,1,3,4,25.0
2011-04-16,6,Saturday,Morning Rush,1,9,10,10.0
2011-04-16,7,Saturday,Morning Rush,3,18,21,14.29
2011-04-16,8,Saturday,Morning Rush,7,38,45,15.56
2011-04-16,9,Saturday,Morning Rush,2,27,29,6.9
2011-04-16,10,Saturday,Mid-Day,1,21,22,4.55
2011-04-16,11,Saturday,Mid-Day,4,27,31,12.9
2011-04-16,12,Saturday,Mid-Day,6,26,32,18.75
2011-04-16,13,Saturday,Mid-Day,9,49,58,15.52
2011-04-16,14,Saturday,Mid-Day,14,49,63,22.22
2011-04-16,15,Saturday,Mid-Day,16,62,78,20.51
2011-04-16,16,Saturday,Evening Rush,6,27,33,18.18
2011-04-16,17,Saturday,Evening Rush,1,14,15,6.67
2011-04-16,18,Saturday,Evening Rush,6,32,38,15.79
2011-04-16,19,Saturday,Evening Rush,9,62,71,12.68
2011-04-16,20,Saturday,Night,4,49,53,7.55
2011-04-16,21,Saturday,Night,1,13,14,7.14
2011-04-16,22,Saturday,Night,2,22,24,8.33
2011-04-16,23,Saturday,Night,5,30,35,14.29
2011-04-17,0,Sunday,Early Morning,4,29,33,12.12
2011-04-17,1,Sunday,Early Morning,6,25,31,19.35
2011-04-17,2,Sunday,Early Morning,4,25,29,13.79
2011-04-17,3,Sunday,Early Morning,12,13,25,48.0
2011-04-17,4,Sunday,Early Morning,2,5,7,28.57
2011-04-17,5,Sunday,Early Morning,2,1,3,66.67
2011-04-17,6,Sunday,Morning Rush,3,5,8,37.5
2011-04-17,7,Sunday,Morning Rush,2,14,16,12.5
2011-04-17,8,Sunday,Morning Rush,7,36,43,16.28
2011-04-17,9,Sunday,Morning Rush,31,71,102,30.39
2011-04-17,10,Sunday,Mid-Day,91,120,211,43.13
2011-04-17,11,Sunday,Mid-Day,119,185,304,39.14
2011-04-17,12,Sunday,Mid-Day,167,187,354,47.18
2011-04-17,13,Sunday,Mid-Day,181,162,343,52.77
2011-04-17,14,Sunday,Mid-Day,170,191,361,47.09
2011-04-17,15,Sunday,Mid-Day,179,209,388,46.13
2011-04-17,16,Sunday,Evening Rush,161,182,343,46.94
2011-04-17,17,Sunday,Evening Rush,143,163,306,46.73
2011-04-17,18,Sunday,Evening Rush,102,175,277,36.82
2011-04-17,19,Sunday,Evening Rush,75,135,210,35.71
2011-04-17,20,Sunday,Night,44,97,141,31.21
2011-04-17,21,Sunday,Night,13,70,83,15.66
2011-04-17,22,Sunday,Night,21,49,70,30.0
2011-04-17,23,Sunday,Night,19,37,56,33.93
2011-04-18,0,Monday,Early Morning,15,24,39,38.46
2011-04-18,1,Monday,Early Morning,11,8,19,57.89
2011-04-18,2,Monday,Early Morning,14,2,16,87.5
2011-04-18,3,Monday,Early Morning,6,1,7,85.71
2011-04-18,4,Monday,Early Morning,2,4,6,33.33
2011-04-18,5,Monday,Early Morning,0,16,16,0.0
2011-04-18,6,Monday,Morning Rush,3,51,54,5.56
2011-04-18,7,Monday,Morning Rush,12,156,168,7.14
2011-04-18,8,Monday,Morning Rush,20,277,297,6.73
2011-04-18,9,Monday,Morning Rush,37,132,169,21.89
2011-04-18,10,Monday,Mid-Day,41,68,109,37.61
2011-04-18,11,Monday,Mid-Day,36,87,123,29.27
2011-04-18,12,Monday,Mid-Day,60,124,184,32.61
2011-04-18,13,Monday,Mid-Day,41,128,169,24.26
2011-04-18,14,Monday,Mid-Day,49,95,144,34.03
2011-04-18,15,Monday,Mid-Day,64,112,176,36.36
2011-04-18,16,Monday,Evening Rush,40,165,205,19.51
2011-04-18,17,Monday,Evening Rush,66,362,428,15.42
2011-04-18,18,Monday,Evening Rush,41,321,362,11.33
2011-04-18,19,Monday,Evening Rush,42,244,286,14.69
2011-04-18,20,Monday,Night,29,136,165,17.58
2011-04-18,21,Monday,Night,20,131,151,13.25
2011-04-18,22,Monday,Night,9,81,90,10.0
2011-04-18,23,Monday,Night,11,35,46,23.91
2011-04-19,0,Tuesday,Early Morning,2,23,25,8.0
2011-04-19,1,Tuesday,Early Morning,5,2,7,71.43
2011-04-19,2,Tuesday,Early Morning,8,5,13,61.54
2011-04-19,3,Tuesday,Early Morning,0,3,3,0.0
2011-04-19,4,Tuesday,Early Morning,1,4,5,20.0
2011-04-19,5,Tuesday,Early Morning,1,17,18,5.56
2011-04-19,6,Tuesday,Morning Rush,2,63,65,3.08
2011-04-19,7,Tuesday,Morning Rush,22,166,188,11.7
2011-04-19,8,Tuesday,Morning Rush,20,331,351,5.7
2011-04-19,9,Tuesday,Morning Rush,23,139,162,14.2
2011-04-19,10,Tuesday,Mid-Day,15,60,75,20.0
2011-04-19,11,Tuesday,Mid-Day,19,53,72,26.39
2011-04-19,12,Tuesday,Mid-Day,19,84,103,18.45
2011-04-19,13,Tuesday,Mid-Day,26,103,129,20.16
2011-04-19,14,Tuesday,Mid-Day,19,88,107,17.76
2011-04-19,15,Tuesday,Mid-Day,44,83,127,34.65
2011-04-19,16,Tuesday,Evening Rush,30,162,192,15.63
2011-04-19,17,Tuesday,Evening Rush,39,372,411,9.49
2011-04-19,18,Tuesday,Evening Rush,44,377,421,10.45
2011-04-19,19,Tuesday,Evening Rush,28,248,276,10.14
2011-04-19,20,Tuesday,Night,20,148,168,11.9
2011-04-19,21,Tuesday,Night,8,114,122,6.56
2011-04-19,22,Tuesday,Night,3,109,112,2.68
2011-04-19,23,Tuesday,Night,11,41,52,21.15
2011-04-20,0,Wednesday,Early Morning,4,29,33,12.12
2011-04-20,1,Wednesday,Early Morning,2,5,7,28.57
2011-04-20,2,Wednesday,Early Morning,0,2,2,0.0
2011-04-20,3,Wednesday,Early Morning,0,2,2,0.0
2011-04-20,4,Wednesday,Early Morning,5,4,9,55.56
2011-04-20,5,Wednesday,Early Morning,1,14,15,6.67
2011-04-20,6,Wednesday,Morning Rush,2,62,64,3.13
2011-04-20,7,Wednesday,Morning Rush,26,211,237,10.97
2011-04-20,8,Wednesday,Morning Rush,22,374,396,5.56
2011-04-20,9,Wednesday,Morning Rush,27,170,197,13.71
2011-04-20,10,Wednesday,Mid-Day,45,86,131,34.35
2011-04-20,11,Wednesday,Mid-Day,31,87,118,26.27
2011-04-20,12,Wednesday,Mid-Day,28,117,145,19.31
2011-04-20,13,Wednesday,Mid-Day,42,135,177,23.73
2011-04-20,14,Wednesday,Mid-Day,33,115,148,22.3
2011-04-20,15,Wednesday,Mid-Day,32,113,145,22.07
2011-04-20,16,Wednesday,Evening Rush,54,201,255,21.18
2011-04-20,17,Wednesday,Evening Rush,34,398,432,7.87
2011-04-20,18,Wednesday,Evening Rush,56,385,441,12.7
2011-04-20,19,Wednesday,Evening Rush,74,309,383,19.32
2011-04-20,20,Wednesday,Night,31,194,225,13.78
2011-04-20,21,Wednesday,Night,38,134,172,22.09
2011-04-20,22,Wednesday,Night,12,105,117,10.26
2011-04-20,23,Wednesday,Night,14,79,93,15.05
2011-04-21,0,Thursday,Early Morning,11,33,44,25.0
2011-04-21,1,Thursday,Early Morning,6,20,26,23.08
2011-04-21,2,Thursday,Early Morning,3,10,13,23.08
2011-04-21,3,Thursday,Early Morning,4,3,7,57.14
2011-04-21,4,Thursday,Early Morning,2,4,6,33.33
2011-04-21,5,Thursday,Early Morning,0,14,14,0.0
2011-04-21,6,Thursday,Morning Rush,2,73,75,2.67
2011-04-21,7,Thursday,Morning Rush,15,183,198,7.58
2011-04-21,8,Thursday,Morning Rush,19,346,365,5.21
2011-04-21,9,Thursday,Morning Rush,18,178,196,9.18
2011-04-21,10,Thursday,Mid-Day,25,73,98,25.51
2011-04-21,11,Thursday,Mid-Day,34,99,133,25.56
2011-04-21,12,Thursday,Mid-Day,49,150,199,24.62
2011-04-21,13,Thursday,Mid-Day,55,122,177,31.07
2011-04-21,14,Thursday,Mid-Day,68,160,228,29.82
2011-04-21,15,Thursday,Mid-Day,69,166,235,29.36
2011-04-21,16,Thursday,Evening Rush,66,228,294,22.45
2011-04-21,17,Thursday,Evening Rush,79,402,481,16.42
2011-04-21,18,Thursday,Evening Rush,71,381,452,15.71
2011-04-21,19,Thursday,Evening Rush,52,272,324,16.05
2011-04-21,20,Thursday,Night,28,176,204,13.73
2011-04-21,21,Thursday,Night,25,159,184,13.59
2011-04-21,22,Thursday,Night,31,106,137,22.63
2011-04-21,23,Thursday,Night,13,86,99,13.13
2011-04-22,0,Friday,Early Morning,3,30,33,9.09
2011-04-22,1,Friday,Early Morning,2,22,24,8.33
2011-04-22,2,Friday,Early Morning,2,7,9,22.22
2011-04-22,3,Friday,Early Morning,0,2,2,0.0
2011-04-22,4,Friday,Early Morning,1,2,3,33.33
2011-04-22,5,Friday,Early Morning,0,16,16,0.0
2011-04-22,6,Friday,Morning Rush,2,47,49,4.08
2011-04-22,7,Friday,Morning Rush,5,175,180,2.78
2011-04-22,8,Friday,Morning Rush,15,331,346,4.34
2011-04-22,9,Friday,Morning Rush,17,178,195,8.72
2011-04-22,10,Friday,Mid-Day,32,104,136,23.53
2011-04-22,11,Friday,Mid-Day,23,83,106,21.7
2011-04-22,12,Friday,Mid-Day,19,61,80,23.75
2011-04-22,13,Friday,Mid-Day,3,37,40,7.5
2011-04-22,14,Friday,Mid-Day,3,33,36,8.33
2011-04-22,15,Friday,Mid-Day,13,62,75,17.33
2011-04-22,16,Friday,Evening Rush,4,58,62,6.45
2011-04-22,17,Friday,Evening Rush,6,63,69,8.7
2011-04-22,18,Friday,Evening Rush,4,47,51,7.84
2011-04-22,19,Friday,Evening Rush,7,48,55,12.73
2011-04-22,20,Friday,Night,8,39,47,17.02
2011-04-22,21,Friday,Night,5,23,28,17.86
2011-04-22,22,Friday,Night,3,21,24,12.5
2011-04-22,23,Friday,Night,0,17,17,0.0
2011-04-23,0,Saturday,Early Morning,0,18,18,0.0
2011-04-23,1,Saturday,Early Morning,5,11,16,31.25
2011-04-23,2,Saturday,Early Morning,3,14,17,17.65
2011-04-23,3,Saturday,Early Morning,0,4,4,0.0
2011-04-23,4,Saturday,Early Morning,2,3,5,40.0
2011-04-23,5,Saturday,Early Morning,1,6,7,14.29
2011-04-23,6,Saturday,Morning Rush,0,11,11,0.0
2011-04-23,7,Saturday,Morning Rush,2,17,19,10.53
2011-04-23,8,Saturday,Morning Rush,15,32,47,31.91
2011-04-23,9,Saturday,Morning Rush,13,55,68,19.12
2011-04-23,10,Saturday,Mid-Day,36,93,129,27.91
2011-04-23,11,Saturday,Mid-Day,68,164,232,29.31
2011-04-23,12,Saturday,Mid-Day,94,197,291,32.3
2011-04-23,13,Saturday,Mid-Day,126,186,312,40.38
2011-04-23,14,Saturday,Mid-Day,182,209,391,46.55
2011-04-23,15,Saturday,Mid-Day,171,226,397,43.07
2011-04-23,16,Saturday,Evening Rush,180,246,426,42.25
2011-04-23,17,Saturday,Evening Rush,168,215,383,43.86
2011-04-23,18,Saturday,Evening Rush,149,227,376,39.63
2011-04-23,19,Saturday,Evening Rush,84,199,283,29.68
2011-04-23,20,Saturday,Night,45,138,183,24.59
2011-04-23,21,Saturday,Night,32,103,135,23.7
2011-04-23,22,Saturday,Night,55,114,169,32.54
2011-04-23,23,Saturday,Night,31,86,117,26.5
2011-04-24,0,Sunday,Early Morning,30,66,96,31.25
2011-04-24,1,Sunday,Early Morning,14,40,54,25.93
2011-04-24,2,Sunday,Early Morning,27,45,72,37.5
2011-04-24,3,Sunday,Early Morning,4,20,24,16.67
2011-04-24,4,Sunday,Early Morning,0,5,5,0.0
2011-04-24,5,Sunday,Early Morning,5,7,12,41.67
2011-04-24,6,Sunday,Morning Rush,10,3,13,76.92
2011-04-24,7,Sunday,Morning Rush,16,11,27,59.26
2011-04-24,8,Sunday,Morning Rush,38,42,80,47.5
2011-04-24,9,Sunday,Morning Rush,73,104,177,41.24
2011-04-24,10,Sunday,Mid-Day,118,171,289,40.83
2011-04-24,11,Sunday,Mid-Day,124,193,317,39.12
2011-04-24,12,Sunday,Mid-Day,168,220,388,43.3
2011-04-24,13,Sunday,Mid-Day,205,236,441,46.49
2011-04-24,14,Sunday,Mid-Day,197,223,420,46.9
2011-04-24,15,Sunday,Mid-Day,167,202,369,45.26
2011-04-24,16,Sunday,Evening Rush,162,197,359,45.13
2011-04-24,17,Sunday,Evening Rush,142,189,331,42.9
2011-04-24,18,Sunday,Evening Rush,96,174,270,35.56
2011-04-24,19,Sunday,Evening Rush,62,132,194,31.96
2011-04-24,20,Sunday,Night,34,71,105,32.38
2011-04-24,21,Sunday,Night,8,53,61,13.11
2011-04-24,22,Sunday,Night,5,40,45,11.11
2011-04-24,23,Sunday,Night,5,37,42,11.9
2011-04-25,0,Monday,Early Morning,2,10,12,16.67
2011-04-25,1,Monday,Early Morning,2,8,10,20.0
2011-04-25,2,Monday,Early Morning,1,9,10,10.0
2011-04-25,3,Monday,Early Morning,2,8,10,20.0
2011-04-25,4,Monday,Early Morning,1,4,5,20.0
2011-04-25,5,Monday,Early Morning,3,14,17,17.65
2011-04-25,6,Monday,Morning Rush,7,59,66,10.61
2011-04-25,7,Monday,Morning Rush,13,183,196,6.63
2011-04-25,8,Monday,Morning Rush,27,326,353,7.65
2011-04-25,9,Monday,Morning Rush,27,147,174,15.52
2011-04-25,10,Monday,Mid-Day,61,64,125,48.8
2011-04-25,11,Monday,Mid-Day,53,94,147,36.05
2011-04-25,12,Monday,Mid-Day,48,140,188,25.53
2011-04-25,13,Monday,Mid-Day,57,146,203,28.08
2011-04-25,14,Monday,Mid-Day,47,99,146,32.19
2011-04-25,15,Monday,Mid-Day,50,125,175,28.57
2011-04-25,16,Monday,Evening Rush,41,198,239,17.15
2011-04-25,17,Monday,Evening Rush,80,441,521,15.36
2011-04-25,18,Monday,Evening Rush,74,425,499,14.83
2011-04-25,19,Monday,Evening Rush,62,320,382,16.23
2011-04-25,20,Monday,Night,42,195,237,17.72
2011-04-25,21,Monday,Night,41,149,190,21.58
2011-04-25,22,Monday,Night,23,83,106,21.7
2011-04-25,23,Monday,Night,9,53,62,14.52
2011-04-26,0,Tuesday,Early Morning,10,17,27,37.04
2011-04-26,1,Tuesday,Early Morning,16,5,21,76.19
2011-04-26,2,Tuesday,Early Morning,17,9,26,65.38
2011-04-26,3,Tuesday,Early Morning,17,4,21,80.95
2011-04-26,4,Tuesday,Early Morning,2,4,6,33.33
2011-04-26,5,Tuesday,Early Morning,0,16,16,0.0
2011-04-26,6,Tuesday,Morning Rush,0,80,80,0.0
2011-04-26,7,Tuesday,Morning Rush,16,254,270,5.93
2011-04-26,8,Tuesday,Morning Rush,32,417,449,7.13
2011-04-26,9,Tuesday,Morning Rush,35,164,199,17.59
2011-04-26,10,Tuesday,Mid-Day,22,98,120,18.33
2011-04-26,11,Tuesday,Mid-Day,40,132,172,23.26
2011-04-26,12,Tuesday,Mid-Day,40,146,186,21.51
2011-04-26,13,Tuesday,Mid-Day,37,139,176,21.02
2011-04-26,14,Tuesday,Mid-Day,40,115,155,25.81
2011-04-26,15,Tuesday,Mid-Day,34,119,153,22.22
2011-04-26,16,Tuesday,Evening Rush,40,251,291,13.75
2011-04-26,17,Tuesday,Evening Rush,66,455,521,12.67
2011-04-26,18,Tuesday,Evening Rush,65,463,528,12.31
2011-04-26,19,Tuesday,Evening Rush,42,286,328,12.8
2011-04-26,20,Tuesday,Night,35,199,234,14.96
2011-04-26,21,Tuesday,Night,33,162,195,16.92
2011-04-26,22,Tuesday,Night,32,116,148,21.62
2011-04-26,23,Tuesday,Night,7,71,78,8.97
2011-04-27,0,Wednesday,Early Morning,3,24,27,11.11
2011-04-27,1,Wednesday,Early Morning,2,15,17,11.76
2011-04-27,2,Wednesday,Early Morning,0,5,5,0.0
2011-04-27,3,Wednesday,Early Morning,3,4,7,42.86
2011-04-27,4,Wednesday,Early Morning,0,6,6,0.0
2011-04-27,5,Wednesday,Early Morning,1,16,17,5.88
2011-04-27,6,Wednesday,Morning Rush,5,79,84,5.95
2011-04-27,7,Wednesday,Morning Rush,17,229,246,6.91
2011-04-27,8,Wednesday,Morning Rush,31,413,444,6.98
2011-04-27,9,Wednesday,Morning Rush,20,161,181,11.05
2011-04-27,10,Wednesday,Mid-Day,26,66,92,28.26
2011-04-27,11,Wednesday,Mid-Day,53,103,156,33.97
2011-04-27,12,Wednesday,Mid-Day,38,135,173,21.97
2011-04-27,13,Wednesday,Mid-Day,31,119,150,20.67
2011-04-27,14,Wednesday,Mid-Day,29,119,148,19.59
2011-04-27,15,Wednesday,Mid-Day,18,120,138,13.04
2011-04-27,16,Wednesday,Evening Rush,29,189,218,13.3
2011-04-27,17,Wednesday,Evening Rush,63,458,521,12.09
2011-04-27,18,Wednesday,Evening Rush,46,366,412,11.17
2011-04-27,19,Wednesday,Evening Rush,40,220,260,15.38
2011-04-27,20,Wednesday,Night,30,188,218,13.76
2011-04-27,21,Wednesday,Night,19,126,145,13.1
2011-04-27,22,Wednesday,Night,18,111,129,13.95
2011-04-27,23,Wednesday,Night,25,53,78,32.05
2011-04-28,0,Thursday,Early Morning,13,41,54,24.07
2011-04-28,1,Thursday,Early Morning,8,12,20,40.0
2011-04-28,2,Thursday,Early Morning,14,7,21,66.67
2011-04-28,3,Thursday,Early Morning,2,1,3,66.67
2011-04-28,4,Thursday,Early Morning,4,5,9,44.44
2011-04-28,5,Thursday,Early Morning,0,13,13,0.0
2011-04-28,6,Thursday,Morning Rush,7,79,86,8.14
2011-04-28,7,Thursday,Morning Rush,14,201,215,6.51
2011-04-28,8,Thursday,Morning Rush,31,367,398,7.79
2011-04-28,9,Thursday,Morning Rush,18,165,183,9.84
2011-04-28,10,Thursday,Mid-Day,9,45,54,16.67
2011-04-28,11,Thursday,Mid-Day,10,74,84,11.9
2011-04-28,12,Thursday,Mid-Day,23,84,107,21.5
2011-04-28,13,Thursday,Mid-Day,18,103,121,14.88
2011-04-28,14,Thursday,Mid-Day,21,121,142,14.79
2011-04-28,15,Thursday,Mid-Day,46,117,163,28.22
2011-04-28,16,Thursday,Evening Rush,42,228,270,15.56
2011-04-28,17,Thursday,Evening Rush,49,406,455,10.77
2011-04-28,18,Thursday,Evening Rush,44,486,530,8.3
2011-04-28,19,Thursday,Evening Rush,57,347,404,14.11
2011-04-28,20,Thursday,Night,49,220,269,18.22
2011-04-28,21,Thursday,Night,27,167,194,13.92
2011-04-28,22,Thursday,Night,34,119,153,22.22
2011-04-28,23,Thursday,Night,29,81,110,26.36
2011-04-29,0,Friday,Early Morning,11,37,48,22.92
2011-04-29,1,Friday,Early Morning,10,21,31,32.26
2011-04-29,2,Friday,Early Morning,2,8,10,20.0
2011-04-29,3,Friday,Early Morning,1,4,5,20.0
2011-04-29,4,Friday,Early Morning,0,6,6,0.0
2011-04-29,5,Friday,Early Morning,0,25,25,0.0
2011-04-29,6,Friday,Morning Rush,4,67,71,5.63
2011-04-29,7,Friday,Morning Rush,18,222,240,7.5
2011-04-29,8,Friday,Morning Rush,35,386,421,8.31
2011-04-29,9,Friday,Morning Rush,45,185,230,19.57
2011-04-29,10,Friday,Mid-Day,57,99,156,36.54
2011-04-29,11,Friday,Mid-Day,49,108,157,31.21
2011-04-29,12,Friday,Mid-Day,63,160,223,28.25
2011-04-29,13,Friday,Mid-Day,74,234,308,24.03
2011-04-29,14,Friday,Mid-Day,58,190,248,23.39
2011-04-29,15,Friday,Mid-Day,77,175,252,30.56
2011-04-29,16,Friday,Evening Rush,59,240,299,19.73
2011-04-29,17,Friday,Evening Rush,75,433,508,14.76
2011-04-29,18,Friday,Evening Rush,55,384,439,12.53
2011-04-29,19,Friday,Evening Rush,40,230,270,14.81
2011-04-29,20,Friday,Night,34,160,194,17.53
2011-04-29,21,Friday,Night,50,145,195,25.64
2011-04-29,22,Friday,Night,36,110,146,24.66
2011-04-29,23,Friday,Night,25,88,113,22.12
2011-04-30,0,Saturday,Early Morning,33,73,106,31.13
2011-04-30,1,Saturday,Early Morning,15,59,74,20.27
2011-04-30,2,Saturday,Early Morning,12,53,65,18.46
2011-04-30,3,Saturday,Early Morning,4,13,17,23.53
2011-04-30,4,Saturday,Early Morning,2,5,7,28.57
2011-04-30,5,Saturday,Early Morning,3,4,7,42.86
2011-04-30,6,Saturday,Morning Rush,10,11,21,47.62
2011-04-30,7,Saturday,Morning Rush,21,27,48,43.75
2011-04-30,8,Saturday,Morning Rush,21,70,91,23.08
2011-04-30,9,Saturday,Morning Rush,35,121,156,22.44
2011-04-30,10,Saturday,Mid-Day,94,185,279,33.69
2011-04-30,11,Saturday,Mid-Day,120,201,321,37.38
2011-04-30,12,Saturday,Mid-Day,178,238,416,42.79
2011-04-30,13,Saturday,Mid-Day,185,270,455,40.66
2011-04-30,14,Saturday,Mid-Day,184,268,452,40.71
2011-04-30,15,Saturday,Mid-Day,217,282,499,43.49
2011-04-30,16,Saturday,Evening Rush,191,273,464,41.16
2011-04-30,17,Saturday,Evening Rush,162,245,407,39.8
2011-04-30,18,Saturday,Evening Rush,134,237,371,36.12
2011-04-30,19,Saturday,Evening Rush,150,237,387,38.76
2011-04-30,20,Saturday,Night,65,159,224,29.02
2011-04-30,21,Saturday,Night,58,119,177,32.77
2011-04-30,22,Saturday,Night,37,106,143,25.87
2011-04-30,23,Saturday,Night,34,91,125,27.2
2011-05-01,0,Sunday,Early Morning,19,77,96,19.79
2011-05-01,1,Sunday,Early Morning,9,50,59,15.25
2011-05-01,2,Sunday,Early Morning,7,43,50,14.0
2011-05-01,3,Sunday,Early Morning,8,15,23,34.78
2011-05-01,4,Sunday,Early Morning,6,11,17,35.29
2011-05-01,5,Sunday,Early Morning,0,10,10,0.0
2011-05-01,6,Sunday,Morning Rush,4,9,13,30.77
2011-05-01,7,Sunday,Morning Rush,7,26,33,21.21
2011-05-01,8,Sunday,Morning Rush,16,43,59,27.12
2011-05-01,9,Sunday,Morning Rush,45,96,141,31.91
2011-05-01,10,Sunday,Mid-Day,109,155,264,41.29
2011-05-01,11,Sunday,Mid-Day,109,141,250,43.6
2011-05-01,12,Sunday,Mid-Day,109,172,281,38.79
2011-05-01,13,Sunday,Mid-Day,123,209,332,37.05
2011-05-01,14,Sunday,Mid-Day,85,153,238,35.71
2011-05-01,15,Sunday,Mid-Day,113,153,266,42.48
2011-05-01,16,Sunday,Evening Rush,75,139,214,35.05
2011-05-01,17,Sunday,Evening Rush,60,136,196,30.61
2011-05-01,18,Sunday,Evening Rush,33,126,159,20.75
2011-05-01,19,Sunday,Evening Rush,47,131,178,26.4
2011-05-01,20,Sunday,Night,35,86,121,28.93
2011-05-01,21,Sunday,Night,23,82,105,21.9
2011-05-01,22,Sunday,Night,32,68,100,32.0
2011-05-01,23,Sunday,Night,64,82,146,43.84
2011-05-02,0,Monday,Early Morning,68,109,177,38.42
2011-05-02,1,Monday,Early Morning,41,73,114,35.96
2011-05-02,2,Monday,Early Morning,16,19,35,45.71
2011-05-02,3,Monday,Early Morning,9,7,16,56.25
2011-05-02,4,Monday,Early Morning,9,8,17,52.94
2011-05-02,5,Monday,Early Morning,4,16,20,20.0
2011-05-02,6,Monday,Morning Rush,3,59,62,4.84
2011-05-02,7,Monday,Morning Rush,16,193,209,7.66
2011-05-02,8,Monday,Morning Rush,21,350,371,5.66
2011-05-02,9,Monday,Morning Rush,41,131,172,23.84
2011-05-02,10,Monday,Mid-Day,31,77,108,28.7
2011-05-02,11,Monday,Mid-Day,34,96,130,26.15
2011-05-02,12,Monday,Mid-Day,40,147,187,21.39
2011-05-02,13,Monday,Mid-Day,51,119,170,30.0
2011-05-02,14,Monday,Mid-Day,48,133,181,26.52
2011-05-02,15,Monday,Mid-Day,45,110,155,29.03
2011-05-02,16,Monday,Evening Rush,49,220,269,18.22
2011-05-02,17,Monday,Evening Rush,65,472,537,12.1
2011-05-02,18,Monday,Evening Rush,68,450,518,13.13
2011-05-02,19,Monday,Evening Rush,46,268,314,14.65
2011-05-02,20,Monday,Night,44,174,218,20.18
2011-05-02,21,Monday,Night,54,178,232,23.28
2011-05-02,22,Monday,Night,28,97,125,22.4
2011-05-02,23,Monday,Night,16,48,64,25.0
2011-05-03,0,Tuesday,Early Morning,0,16,16,0.0
2011-05-03,1,Tuesday,Early Morning,0,14,14,0.0
2011-05-03,2,Tuesday,Early Morning,0,5,5,0.0
2011-05-03,3,Tuesday,Early Morning,0,2,2,0.0
2011-05-03,4,Tuesday,Early Morning,3,1,4,75.0
2011-05-03,5,Tuesday,Early Morning,0,14,14,0.0
2011-05-03,6,Tuesday,Morning Rush,7,102,109,6.42
2011-05-03,7,Tuesday,Morning Rush,17,248,265,6.42
2011-05-03,8,Tuesday,Morning Rush,24,435,459,5.23
2011-05-03,9,Tuesday,Morning Rush,29,157,186,15.59
2011-05-03,10,Tuesday,Mid-Day,36,91,127,28.35
2011-05-03,11,Tuesday,Mid-Day,20,120,140,14.29
2011-05-03,12,Tuesday,Mid-Day,48,169,217,22.12
2011-05-03,13,Tuesday,Mid-Day,50,144,194,25.77
2011-05-03,14,Tuesday,Mid-Day,36,122,158,22.78
2011-05-03,15,Tuesday,Mid-Day,37,117,154,24.03
2011-05-03,16,Tuesday,Evening Rush,46,225,271,16.97
2011-05-03,17,Tuesday,Evening Rush,53,464,517,10.25
2011-05-03,18,Tuesday,Evening Rush,59,485,544,10.85
2011-05-03,19,Tuesday,Evening Rush,42,323,365,11.51
2011-05-03,20,Tuesday,Night,28,262,290,9.66
2011-05-03,21,Tuesday,Night,42,183,225,18.67
2011-05-03,22,Tuesday,Night,14,99,113,12.39
2011-05-03,23,Tuesday,Night,12,50,62,19.35
2011-05-04,0,Wednesday,Early Morning,5,22,27,18.52
2011-05-04,1,Wednesday,Early Morning,1,6,7,14.29
2011-05-04,2,Wednesday,Early Morning,0,4,4,0.0
2011-05-04,3,Wednesday,Early Morning,0,1,1,0.0
2011-05-04,4,Wednesday,Early Morning,1,2,3,33.33
2011-05-04,5,Wednesday,Early Morning,1,8,9,11.11
2011-05-04,6,Wednesday,Morning Rush,0,21,21,0.0
2011-05-04,7,Wednesday,Morning Rush,6,46,52,11.54
2011-05-04,8,Wednesday,Morning Rush,5,74,79,6.33
2011-05-04,9,Wednesday,Morning Rush,5,35,40,12.5
2011-05-04,10,Wednesday,Mid-Day,5,26,31,16.13
2011-05-04,11,Wednesday,Mid-Day,3,69,72,4.17
2011-05-04,12,Wednesday,Mid-Day,19,105,124,15.32
2011-05-04,13,Wednesday,Mid-Day,15,128,143,10.49
2011-05-04,14,Wednesday,Mid-Day,13,94,107,12.15
2011-05-04,15,Wednesday,Mid-Day,22,107,129,17.05
2011-05-04,16,Wednesday,Evening Rush,22,173,195,11.28
2011-05-04,17,Wednesday,Evening Rush,22,388,410,5.37
2011-05-04,18,Wednesday,Evening Rush,29,367,396,7.32
2011-05-04,19,Wednesday,Evening Rush,30,266,296,10.14
2011-05-04,20,Wednesday,Night,17,174,191,8.9
2011-05-04,21,Wednesday,Night,17,133,150,11.33
2011-05-04,22,Wednesday,Night,9,80,89,10.11
2011-05-04,23,Wednesday,Night,8,49,57,14.04
2011-05-05,0,Thursday,Early Morning,4,23,27,14.81
2011-05-05,1,Thursday,Early Morning,4,6,10,40.0
2011-05-05,2,Thursday,Early Morning,1,4,5,20.0
2011-05-05,3,Thursday,Early Morning,0,4,4,0.0
2011-05-05,4,Thursday,Early Morning,4,3,7,57.14
2011-05-05,5,Thursday,Early Morning,1,29,30,3.33
2011-05-05,6,Thursday,Morning Rush,3,86,89,3.37
2011-05-05,7,Thursday,Morning Rush,16,255,271,5.9
2011-05-05,8,Thursday,Morning Rush,25,415,440,5.68
2011-05-05,9,Thursday,Morning Rush,20,164,184,10.87
2011-05-05,10,Thursday,Mid-Day,30,98,128,23.44
2011-05-05,11,Thursday,Mid-Day,43,105,148,29.05
2011-05-05,12,Thursday,Mid-Day,27,169,196,13.78
2011-05-05,13,Thursday,Mid-Day,50,142,192,26.04
2011-05-05,14,Thursday,Mid-Day,19,135,154,12.34
2011-05-05,15,Thursday,Mid-Day,27,120,147,18.37
2011-05-05,16,Thursday,Evening Rush,36,233,269,13.38
2011-05-05,17,Thursday,Evening Rush,66,467,533,12.38
2011-05-05,18,Thursday,Evening Rush,64,456,520,12.31
2011-05-05,19,Thursday,Evening Rush,56,305,361,15.51
2011-05-05,20,Thursday,Night,33,225,258,12.79
2011-05-05,21,Thursday,Night,39,141,180,21.67
2011-05-05,22,Thursday,Night,30,135,165,18.18
2011-05-05,23,Thursday,Night,16,99,115,13.91
2011-05-06,0,Friday,Early Morning,13,43,56,23.21
2011-05-06,1,Friday,Early Morning,8,24,32,25.0
2011-05-06,2,Friday,Early Morning,1,15,16,6.25
2011-05-06,3,Friday,Early Morning,3,6,9,33.33
2011-05-06,4,Friday,Early Morning,0,1,1,0.0
2011-05-06,5,Friday,Early Morning,0,16,16,0.0
2011-05-06,6,Friday,Morning Rush,8,74,82,9.76
2011-05-06,7,Friday,Morning Rush,20,202,222,9.01
2011-05-06,8,Friday,Morning Rush,35,415,450,7.78
2011-05-06,9,Friday,Morning Rush,27,161,188,14.36
2011-05-06,10,Friday,Mid-Day,30,97,127,23.62
2011-05-06,11,Friday,Mid-Day,42,123,165,25.45
2011-05-06,12,Friday,Mid-Day,48,198,246,19.51
2011-05-06,13,Friday,Mid-Day,71,182,253,28.06
2011-05-06,14,Friday,Mid-Day,86,127,213,40.38
2011-05-06,15,Friday,Mid-Day,89,171,260,34.23
2011-05-06,16,Friday,Evening Rush,82,262,344,23.84
2011-05-06,17,Friday,Evening Rush,83,470,553,15.01
2011-05-06,18,Friday,Evening Rush,85,385,470,18.09
2011-05-06,19,Friday,Evening Rush,39,253,292,13.36
2011-05-06,20,Friday,Night,29,161,190,15.26
2011-05-06,21,Friday,Night,22,130,152,14.47
2011-05-06,22,Friday,Night,46,105,151,30.46
2011-05-06,23,Friday,Night,27,93,120,22.5
2011-05-07,0,Saturday,Early Morning,10,76,86,11.63
2011-05-07,1,Saturday,Early Morning,8,50,58,13.79
2011-05-07,2,Saturday,Early Morning,5,47,52,9.62
2011-05-07,3,Saturday,Early Morning,9,9,18,50.0
2011-05-07,4,Saturday,Early Morning,1,4,5,20.0
2011-05-07,5,Saturday,Early Morning,4,3,7,57.14
2011-05-07,6,Saturday,Morning Rush,1,12,13,7.69
2011-05-07,7,Saturday,Morning Rush,8,32,40,20.0
2011-05-07,8,Saturday,Morning Rush,19,96,115,16.52
2011-05-07,9,Saturday,Morning Rush,54,164,218,24.77
2011-05-07,10,Saturday,Mid-Day,90,208,298,30.2
2011-05-07,11,Saturday,Mid-Day,132,215,347,38.04
2011-05-07,12,Saturday,Mid-Day,129,244,373,34.58
2011-05-07,13,Saturday,Mid-Day,196,240,436,44.95
2011-05-07,14,Saturday,Mid-Day,143,235,378,37.83
2011-05-07,15,Saturday,Mid-Day,148,230,378,39.15
2011-05-07,16,Saturday,Evening Rush,119,223,342,34.8
2011-05-07,17,Saturday,Evening Rush,138,216,354,38.98
2011-05-07,18,Saturday,Evening Rush,114,175,289,39.45
2011-05-07,19,Saturday,Evening Rush,88,179,267,32.96
2011-05-07,20,Saturday,Night,82,137,219,37.44
2011-05-07,21,Saturday,Night,58,124,182,31.87
2011-05-07,22,Saturday,Night,26,94,120,21.67
2011-05-07,23,Saturday,Night,30,89,119,25.21
2011-05-08,0,Sunday,Early Morning,22,78,100,22.0
2011-05-08,1,Sunday,Early Morning,8,56,64,12.5
2011-05-08,2,Sunday,Early Morning,17,42,59,28.81
2011-05-08,3,Sunday,Early Morning,10,21,31,32.26
2011-05-08,4,Sunday,Early Morning,2,8,10,20.0
2011-05-08,5,Sunday,Early Morning,0,5,5,0.0
2011-05-08,6,Sunday,Morning Rush,2,4,6,33.33
2011-05-08,7,Sunday,Morning Rush,8,15,23,34.78
2011-05-08,8,Sunday,Morning Rush,28,58,86,32.56
2011-05-08,9,Sunday,Morning Rush,48,112,160,30.0
2011-05-08,10,Sunday,Mid-Day,91,153,244,37.3
2011-05-08,11,Sunday,Mid-Day,142,198,340,41.76
2011-05-08,12,Sunday,Mid-Day,139,243,382,36.39
2011-05-08,13,Sunday,Mid-Day,166,224,390,42.56
2011-05-08,14,Sunday,Mid-Day,126,240,366,34.43
2011-05-08,15,Sunday,Mid-Day,128,230,358,35.75
2011-05-08,16,Sunday,Evening Rush,122,263,385,31.69
2011-05-08,17,Sunday,Evening Rush,106,245,351,30.2
2011-05-08,18,Sunday,Evening Rush,63,205,268,23.51
2011-05-08,19,Sunday,Evening Rush,61,178,239,25.52
2011-05-08,20,Sunday,Night,42,132,174,24.14
2011-05-08,21,Sunday,Night,32,95,127,25.2
2011-05-08,22,Sunday,Night,29,86,115,25.22
2011-05-08,23,Sunday,Night,9,41,50,18.0
2011-05-09,0,Monday,Early Morning,31,22,53,58.49
2011-05-09,1,Monday,Early Morning,25,8,33,75.76
2011-05-09,2,Monday,Early Morning,6,2,8,75.0
2011-05-09,3,Monday,Early Morning,0,7,7,0.0
2011-05-09,4,Monday,Early Morning,0,4,4,0.0
2011-05-09,5,Monday,Early Morning,0,23,23,0.0
2011-05-09,6,Monday,Morning Rush,2,87,89,2.25
2011-05-09,7,Monday,Morning Rush,16,221,237,6.75
2011-05-09,8,Monday,Morning Rush,23,351,374,6.15
2011-05-09,9,Monday,Morning Rush,36,142,178,20.22
2011-05-09,10,Monday,Mid-Day,24,95,119,20.17
2011-05-09,11,Monday,Mid-Day,26,99,125,20.8
2011-05-09,12,Monday,Mid-Day,35,160,195,17.95
2011-05-09,13,Monday,Mid-Day,36,138,174,20.69
2011-05-09,14,Monday,Mid-Day,44,118,162,27.16
2011-05-09,15,Monday,Mid-Day,51,148,199,25.63
2011-05-09,16,Monday,Evening Rush,49,255,304,16.12
2011-05-09,17,Monday,Evening Rush,59,539,598,9.87
2011-05-09,18,Monday,Evening Rush,66,458,524,12.6
2011-05-09,19,Monday,Evening Rush,45,339,384,11.72
2011-05-09,20,Monday,Night,25,214,239,10.46
2011-05-09,21,Monday,Night,28,128,156,17.95
2011-05-09,22,Monday,Night,21,95,116,18.1
2011-05-09,23,Monday,Night,16,45,61,26.23
2011-05-10,0,Tuesday,Early Morning,6,12,18,33.33
2011-05-10,1,Tuesday,Early Morning,3,12,15,20.0
2011-05-10,2,Tuesday,Early Morning,1,4,5,20.0
2011-05-10,3,Tuesday,Early Morning,1,3,4,25.0
2011-05-10,4,Tuesday,Early Morning,0,2,2,0.0
2011-05-10,5,Tuesday,Early Morning,1,28,29,3.45
2011-05-10,6,Tuesday,Morning Rush,9,103,112,8.04
2011-05-10,7,Tuesday,Morning Rush,13,301,314,4.14
2011-05-10,8,Tuesday,Morning Rush,28,397,425,6.59
2011-05-10,9,Tuesday,Morning Rush,29,176,205,14.15
2011-05-10,10,Tuesday,Mid-Day,27,100,127,21.26
2011-05-10,11,Tuesday,Mid-Day,17,108,125,13.6
2011-05-10,12,Tuesday,Mid-Day,47,170,217,21.66
2011-05-10,13,Tuesday,Mid-Day,50,152,202,24.75
2011-05-10,14,Tuesday,Mid-Day,42,134,176,23.86
2011-05-10,15,Tuesday,Mid-Day,28,152,180,15.56
2011-05-10,16,Tuesday,Evening Rush,56,271,327,17.13
2011-05-10,17,Tuesday,Evening Rush,79,532,611,12.93
2011-05-10,18,Tuesday,Evening Rush,70,480,550,12.73
2011-05-10,19,Tuesday,Evening Rush,69,365,434,15.9
2011-05-10,20,Tuesday,Night,50,241,291,17.18
2011-05-10,21,Tuesday,Night,30,173,203,14.78
2011-05-10,22,Tuesday,Night,29,121,150,19.33
2011-05-10,23,Tuesday,Night,9,72,81,11.11
2011-05-11,0,Wednesday,Early Morning,8,30,38,21.05
2011-05-11,1,Wednesday,Early Morning,4,16,20,20.0
2011-05-11,2,Wednesday,Early Morning,6,4,10,60.0
2011-05-11,3,Wednesday,Early Morning,0,3,3,0.0
2011-05-11,4,Wednesday,Early Morning,0,2,2,0.0
2011-05-11,5,Wednesday,Early Morning,0,20,20,0.0
2011-05-11,6,Wednesday,Morning Rush,6,93,99,6.06
2011-05-11,7,Wednesday,Morning Rush,25,293,318,7.86
2011-05-11,8,Wednesday,Morning Rush,21,421,442,4.75
2011-05-11,9,Wednesday,Morning Rush,21,182,203,10.34
2011-05-11,10,Wednesday,Mid-Day,30,124,154,19.48
2011-05-11,11,Wednesday,Mid-Day,18,123,141,12.77
2011-05-11,12,Wednesday,Mid-Day,41,185,226,18.14
2011-05-11,13,Wednesday,Mid-Day,36,157,193,18.65
2011-05-11,14,Wednesday,Mid-Day,36,141,177,20.34
2011-05-11,15,Wednesday,Mid-Day,48,131,179,26.82
2011-05-11,16,Wednesday,Evening Rush,49,240,289,16.96
2011-05-11,17,Wednesday,Evening Rush,17,242,259,6.56
2011-05-11,18,Wednesday,Evening Rush,40,234,274,14.6
2011-05-11,19,Wednesday,Evening Rush,60,341,401,14.96
2011-05-11,20,Wednesday,Night,28,245,273,10.26
2011-05-11,21,Wednesday,Night,32,202,234,13.68
2011-05-11,22,Wednesday,Night,12,134,146,8.22
2011-05-11,23,Wednesday,Night,12,69,81,14.81
2011-05-12,0,Thursday,Early Morning,5,39,44,11.36
2011-05-12,1,Thursday,Early Morning,1,16,17,5.88
2011-05-12,2,Thursday,Early Morning,1,14,15,6.67
2011-05-12,3,Thursday,Early Morning,0,5,5,0.0
2011-05-12,4,Thursday,Early Morning,1,5,6,16.67
2011-05-12,5,Thursday,Early Morning,2,27,29,6.9
2011-05-12,6,Thursday,Morning Rush,9,103,112,8.04
2011-05-12,7,Thursday,Morning Rush,14,283,297,4.71
2011-05-12,8,Thursday,Morning Rush,27,394,421,6.41
2011-05-12,9,Thursday,Morning Rush,21,191,212,9.91
2011-05-12,10,Thursday,Mid-Day,28,119,147,19.05
2011-05-12,11,Thursday,Mid-Day,43,136,179,24.02
2011-05-12,12,Thursday,Mid-Day,43,164,207,20.77
2011-05-12,13,Thursday,Mid-Day,48,170,218,22.02
2011-05-12,14,Thursday,Mid-Day,43,148,191,22.51
2011-05-12,15,Thursday,Mid-Day,54,163,217,24.88
2011-05-12,16,Thursday,Evening Rush,50,238,288,17.36
2011-05-12,17,Thursday,Evening Rush,54,540,594,9.09
2011-05-12,18,Thursday,Evening Rush,64,463,527,12.14
2011-05-12,19,Thursday,Evening Rush,59,305,364,16.21
2011-05-12,20,Thursday,Night,56,220,276,20.29
2011-05-12,21,Thursday,Night,31,192,223,13.9
2011-05-12,22,Thursday,Night,25,147,172,14.53
2011-05-12,23,Thursday,Night,16,87,103,15.53
2011-05-13,0,Friday,Early Morning,6,46,52,11.54
2011-05-13,1,Friday,Early Morning,5,15,20,25.0
2011-05-13,2,Friday,Early Morning,3,8,11,27.27
2011-05-13,3,Friday,Early Morning,2,2,4,50.0
2011-05-13,4,Friday,Early Morning,2,3,5,40.0
2011-05-13,5,Friday,Early Morning,1,24,25,4.0
2011-05-13,6,Friday,Morning Rush,6,76,82,7.32
2011-05-13,7,Friday,Morning Rush,16,141,157,10.19
2011-05-13,8,Friday,Morning Rush,26,361,387,6.72
2011-05-13,9,Friday,Morning Rush,18,215,233,7.73
2011-05-13,10,Friday,Mid-Day,31,99,130,23.85
2011-05-13,11,Friday,Mid-Day,56,90,146,38.36
2011-05-13,12,Friday,Mid-Day,53,170,223,23.77
2011-05-13,13,Friday,Mid-Day,69,157,226,30.53
2011-05-13,14,Friday,Mid-Day,70,120,190,36.84
2011-05-13,15,Friday,Mid-Day,56,142,198,28.28
2011-05-13,16,Friday,Evening Rush,44,256,300,14.67
2011-05-13,17,Friday,Evening Rush,62,429,491,12.63
2011-05-13,18,Friday,Evening Rush,39,359,398,9.8
2011-05-13,19,Friday,Evening Rush,25,245,270,9.26
2011-05-13,20,Friday,Night,22,130,152,14.47
2011-05-13,21,Friday,Night,24,130,154,15.58
2011-05-13,22,Friday,Night,25,107,132,18.94
2011-05-13,23,Friday,Night,31,88,119,26.05
2011-05-14,0,Saturday,Early Morning,24,78,102,23.53
2011-05-14,1,Saturday,Early Morning,18,64,82,21.95
2011-05-14,2,Saturday,Early Morning,15,37,52,28.85
2011-05-14,3,Saturday,Early Morning,5,30,35,14.29
2011-05-14,4,Saturday,Early Morning,1,4,5,20.0
2011-05-14,5,Saturday,Early Morning,7,7,14,50.0
2011-05-14,6,Saturday,Morning Rush,2,9,11,18.18
2011-05-14,7,Saturday,Morning Rush,4,28,32,12.5
2011-05-14,8,Saturday,Morning Rush,16,72,88,18.18
2011-05-14,9,Saturday,Morning Rush,14,86,100,14.0
2011-05-14,10,Saturday,Mid-Day,34,133,167,20.36
2011-05-14,11,Saturday,Mid-Day,72,207,279,25.81
2011-05-14,12,Saturday,Mid-Day,75,204,279,26.88
2011-05-14,13,Saturday,Mid-Day,68,180,248,27.42
2011-05-14,14,Saturday,Mid-Day,57,159,216,26.39
2011-05-14,15,Saturday,Mid-Day,73,221,294,24.83
2011-05-14,16,Saturday,Evening Rush,107,188,295,36.27
2011-05-14,17,Saturday,Evening Rush,78,194,272,28.68
2011-05-14,18,Saturday,Evening Rush,88,216,304,28.95
2011-05-14,19,Saturday,Evening Rush,69,179,248,27.82
2011-05-14,20,Saturday,Night,42,115,157,26.75
2011-05-14,21,Saturday,Night,15,44,59,25.42
2011-05-14,22,Saturday,Night,7,19,26,26.92
2011-05-14,23,Saturday,Night,11,33,44,25.0
2011-05-15,0,Sunday,Early Morning,5,34,39,12.82
2011-05-15,1,Sunday,Early Morning,4,43,47,8.51
2011-05-15,2,Sunday,Early Morning,13,37,50,26.0
2011-05-15,3,Sunday,Early Morning,11,21,32,34.38
2011-05-15,4,Sunday,Early Morning,5,8,13,38.46
2011-05-15,5,Sunday,Early Morning,3,11,14,21.43
2011-05-15,6,Sunday,Morning Rush,3,14,17,17.65
2011-05-15,7,Sunday,Morning Rush,4,38,42,9.52
2011-05-15,8,Sunday,Morning Rush,24,46,70,34.29
2011-05-15,9,Sunday,Morning Rush,36,98,134,26.87
2011-05-15,10,Sunday,Mid-Day,73,153,226,32.3
2011-05-15,11,Sunday,Mid-Day,120,202,322,37.27
2011-05-15,12,Sunday,Mid-Day,120,247,367,32.7
2011-05-15,13,Sunday,Mid-Day,195,261,456,42.76
2011-05-15,14,Sunday,Mid-Day,183,254,437,41.88
2011-05-15,15,Sunday,Mid-Day,206,253,459,44.88
2011-05-15,16,Sunday,Evening Rush,158,282,440,35.91
2011-05-15,17,Sunday,Evening Rush,137,255,392,34.95
2011-05-15,18,Sunday,Evening Rush,60,177,237,25.32
2011-05-15,19,Sunday,Evening Rush,78,153,231,33.77
2011-05-15,20,Sunday,Night,53,138,191,27.75
2011-05-15,21,Sunday,Night,44,107,151,29.14
2011-05-15,22,Sunday,Night,29,88,117,24.79
2011-05-15,23,Sunday,Night,18,51,69,26.09
2011-05-16,0,Monday,Early Morning,17,21,38,44.74
2011-05-16,1,Monday,Early Morning,6,8,14,42.86
2011-05-16,2,Monday,Early Morning,4,9,13,30.77
2011-05-16,3,Monday,Early Morning,1,3,4,25.0
2011-05-16,4,Monday,Early Morning,1,5,6,16.67
2011-05-16,5,Monday,Early Morning,1,20,21,4.76
2011-05-16,6,Monday,Morning Rush,11,93,104,10.58
2011-05-16,7,Monday,Morning Rush,27,245,272,9.93
2011-05-16,8,Monday,Morning Rush,28,366,394,7.11
2011-05-16,9,Monday,Morning Rush,38,156,194,19.59
2011-05-16,10,Monday,Mid-Day,37,75,112,33.04
2011-05-16,11,Monday,Mid-Day,56,129,185,30.27
2011-05-16,12,Monday,Mid-Day,72,137,209,34.45
2011-05-16,13,Monday,Mid-Day,61,153,214,28.5
2011-05-16,14,Monday,Mid-Day,76,117,193,39.38
2011-05-16,15,Monday,Mid-Day,55,110,165,33.33
2011-05-16,16,Monday,Evening Rush,45,181,226,19.91
2011-05-16,17,Monday,Evening Rush,47,227,274,17.15
2011-05-16,18,Monday,Evening Rush,55,398,453,12.14
2011-05-16,19,Monday,Evening Rush,36,272,308,11.69
2011-05-16,20,Monday,Night,31,167,198,15.66
2011-05-16,21,Monday,Night,28,149,177,15.82
2011-05-16,22,Monday,Night,22,105,127,17.32
2011-05-16,23,Monday,Night,18,39,57,31.58
2011-05-17,0,Tuesday,Early Morning,13,18,31,41.94
2011-05-17,1,Tuesday,Early Morning,7,6,13,53.85
2011-05-17,2,Tuesday,Early Morning,4,4,8,50.0
2011-05-17,3,Tuesday,Early Morning,1,3,4,25.0
2011-05-17,4,Tuesday,Early Morning,2,2,4,50.0
2011-05-17,5,Tuesday,Early Morning,0,22,22,0.0
2011-05-17,6,Tuesday,Morning Rush,0,49,49,0.0
2011-05-17,7,Tuesday,Morning Rush,13,138,151,8.61
2011-05-17,8,Tuesday,Morning Rush,22,325,347,6.34
2011-05-17,9,Tuesday,Morning Rush,17,190,207,8.21
2011-05-17,10,Tuesday,Mid-Day,31,73,104,29.81
2011-05-17,11,Tuesday,Mid-Day,26,104,130,20.0
2011-05-17,12,Tuesday,Mid-Day,38,115,153,24.84
2011-05-17,13,Tuesday,Mid-Day,31,141,172,18.02
2011-05-17,14,Tuesday,Mid-Day,61,123,184,33.15
2011-05-17,15,Tuesday,Mid-Day,79,131,210,37.62
2011-05-17,16,Tuesday,Evening Rush,73,217,290,25.17
2011-05-17,17,Tuesday,Evening Rush,83,521,604,13.74
2011-05-17,18,Tuesday,Evening Rush,54,426,480,11.25
2011-05-17,19,Tuesday,Evening Rush,51,298,349,14.61
2011-05-17,20,Tuesday,Night,30,253,283,10.6
2011-05-17,21,Tuesday,Night,23,151,174,13.22
2011-05-17,22,Tuesday,Night,12,86,98,12.24
2011-05-17,23,Tuesday,Night,7,49,56,12.5
2011-05-18,0,Wednesday,Early Morning,8,15,23,34.78
2011-05-18,1,Wednesday,Early Morning,3,9,12,25.0
2011-05-18,2,Wednesday,Early Morning,1,5,6,16.67
2011-05-18,3,Wednesday,Early Morning,6,3,9,66.67
2011-05-18,4,Wednesday,Early Morning,1,2,3,33.33
2011-05-18,5,Wednesday,Early Morning,0,9,9,0.0
2011-05-18,6,Wednesday,Morning Rush,2,99,101,1.98
2011-05-18,7,Wednesday,Morning Rush,14,260,274,5.11
2011-05-18,8,Wednesday,Morning Rush,25,428,453,5.52
2011-05-18,9,Wednesday,Morning Rush,26,176,202,12.87
2011-05-18,10,Wednesday,Mid-Day,33,73,106,31.13
2011-05-18,11,Wednesday,Mid-Day,6,17,23,26.09
2011-05-18,12,Wednesday,Mid-Day,12,42,54,22.22
2011-05-18,13,Wednesday,Mid-Day,30,92,122,24.59
2011-05-18,14,Wednesday,Mid-Day,44,94,138,31.88
2011-05-18,15,Wednesday,Mid-Day,34,133,167,20.36
2011-05-18,16,Wednesday,Evening Rush,53,241,294,18.03
2011-05-18,17,Wednesday,Evening Rush,78,487,565,13.81
2011-05-18,18,Wednesday,Evening Rush,58,431,489,11.86
2011-05-18,19,Wednesday,Evening Rush,43,288,331,12.99
2011-05-18,20,Wednesday,Night,24,189,213,11.27
2011-05-18,21,Wednesday,Night,11,74,85,12.94
2011-05-18,22,Wednesday,Night,14,103,117,11.97
2011-05-18,23,Wednesday,Night,10,49,59,16.95
2011-05-19,0,Thursday,Early Morning,6,23,29,20.69
2011-05-19,1,Thursday,Early Morning,2,4,6,33.33
2011-05-19,2,Thursday,Early Morning,3,12,15,20.0
2011-05-19,3,Thursday,Early Morning,1,3,4,25.0
2011-05-19,4,Thursday,Early Morning,2,3,5,40.0
2011-05-19,5,Thursday,Early Morning,2,24,26,7.69
2011-05-19,6,Thursday,Morning Rush,17,86,103,16.5
2011-05-19,7,Thursday,Morning Rush,18,239,257,7.0
2011-05-19,8,Thursday,Morning Rush,34,453,487,6.98
2011-05-19,9,Thursday,Morning Rush,40,176,216,18.52
2011-05-19,10,Thursday,Mid-Day,35,95,130,26.92
2011-05-19,11,Thursday,Mid-Day,53,111,164,32.32
2011-05-19,12,Thursday,Mid-Day,38,130,168,22.62
2011-05-19,13,Thursday,Mid-Day,44,139,183,24.04
2011-05-19,14,Thursday,Mid-Day,43,137,180,23.89
2011-05-19,15,Thursday,Mid-Day,63,125,188,33.51
2011-05-19,16,Thursday,Evening Rush,55,247,302,18.21
2011-05-19,17,Thursday,Evening Rush,60,487,547,10.97
2011-05-19,18,Thursday,Evening Rush,59,454,513,11.5
2011-05-19,19,Thursday,Evening Rush,65,345,410,15.85
2011-05-19,20,Thursday,Night,46,236,282,16.31
2011-05-19,21,Thursday,Night,29,180,209,13.88
2011-05-19,22,Thursday,Night,11,68,79,13.92
2011-05-19,23,Thursday,Night,9,63,72,12.5
2011-05-20,0,Friday,Early Morning,15,33,48,31.25
2011-05-20,1,Friday,Early Morning,8,17,25,32.0
2011-05-20,2,Friday,Early Morning,4,4,8,50.0
2011-05-20,3,Friday,Early Morning,1,4,5,20.0
2011-05-20,4,Friday,Early Morning,1,4,5,20.0
2011-05-20,5,Friday,Early Morning,0,28,28,0.0
2011-05-20,6,Friday,Morning Rush,15,102,117,12.82
2011-05-20,7,Friday,Morning Rush,30,289,319,9.4
2011-05-20,8,Friday,Morning Rush,41,476,517,7.93
2011-05-20,9,Friday,Morning Rush,35,199,234,14.96
2011-05-20,10,Friday,Mid-Day,44,104,148,29.73
2011-05-20,11,Friday,Mid-Day,63,133,196,32.14
2011-05-20,12,Friday,Mid-Day,69,186,255,27.06
2011-05-20,13,Friday,Mid-Day,60,172,232,25.86
2011-05-20,14,Friday,Mid-Day,66,131,197,33.5
2011-05-20,15,Friday,Mid-Day,74,168,242,30.58
2011-05-20,16,Friday,Evening Rush,61,269,330,18.48
2011-05-20,17,Friday,Evening Rush,71,483,554,12.82
2011-05-20,18,Friday,Evening Rush,79,394,473,16.7
2011-05-20,19,Friday,Evening Rush,49,253,302,16.23
2011-05-20,20,Friday,Night,40,180,220,18.18
2011-05-20,21,Friday,Night,40,155,195,20.51
2011-05-20,22,Friday,Night,28,124,152,18.42
2011-05-20,23,Friday,Night,15,100,115,13.04
2011-05-21,0,Saturday,Early Morning,20,78,98,20.41
2011-05-21,1,Saturday,Early Morning,8,64,72,11.11
2011-05-21,2,Saturday,Early Morning,5,35,40,12.5
2011-05-21,3,Saturday,Early Morning,7,12,19,36.84
2011-05-21,4,Saturday,Early Morning,1,6,7,14.29
2011-05-21,5,Saturday,Early Morning,1,4,5,20.0
2011-05-21,6,Saturday,Morning Rush,6,22,28,21.43
2011-05-21,7,Saturday,Morning Rush,10,33,43,23.26
2011-05-21,8,Saturday,Morning Rush,29,97,126,23.02
2011-05-21,9,Saturday,Morning Rush,60,165,225,26.67
2011-05-21,10,Saturday,Mid-Day,122,201,323,37.77
2011-05-21,11,Saturday,Mid-Day,173,245,418,41.39
2011-05-21,12,Saturday,Mid-Day,222,271,493,45.03
2011-05-21,13,Saturday,Mid-Day,191,271,462,41.34
2011-05-21,14,Saturday,Mid-Day,187,269,456,41.01
2011-05-21,15,Saturday,Mid-Day,232,274,506,45.85
2011-05-21,16,Saturday,Evening Rush,204,267,471,43.31
2011-05-21,17,Saturday,Evening Rush,191,253,444,43.02
2011-05-21,18,Saturday,Evening Rush,191,253,444,43.02
2011-05-21,19,Saturday,Evening Rush,117,184,301,38.87
2011-05-21,20,Saturday,Night,84,164,248,33.87
2011-05-21,21,Saturday,Night,77,150,227,33.92
2011-05-21,22,Saturday,Night,78,126,204,38.24
2011-05-21,23,Saturday,Night,42,103,145,28.97
2011-05-22,0,Sunday,Early Morning,31,100,131,23.66
2011-05-22,1,Sunday,Early Morning,17,81,98,17.35
2011-05-22,2,Sunday,Early Morning,18,50,68,26.47
2011-05-22,3,Sunday,Early Morning,10,23,33,30.3
2011-05-22,4,Sunday,Early Morning,3,9,12,25.0
2011-05-22,5,Sunday,Early Morning,1,5,6,16.67
2011-05-22,6,Sunday,Morning Rush,5,13,18,27.78
2011-05-22,7,Sunday,Morning Rush,13,27,40,32.5
2011-05-22,8,Sunday,Morning Rush,29,65,94,30.85
2011-05-22,9,Sunday,Morning Rush,59,130,189,31.22
2011-05-22,10,Sunday,Mid-Day,135,170,305,44.26
2011-05-22,11,Sunday,Mid-Day,164,209,373,43.97
2011-05-22,12,Sunday,Mid-Day,146,255,401,36.41
2011-05-22,13,Sunday,Mid-Day,180,275,455,39.56
2011-05-22,14,Sunday,Mid-Day,125,191,316,39.56
2011-05-22,15,Sunday,Mid-Day,110,221,331,33.23
2011-05-22,16,Sunday,Evening Rush,72,201,273,26.37
2011-05-22,17,Sunday,Evening Rush,93,213,306,30.39
2011-05-22,18,Sunday,Evening Rush,120,238,358,33.52
2011-05-22,19,Sunday,Evening Rush,107,193,300,35.67
2011-05-22,20,Sunday,Night,57,174,231,24.68
2011-05-22,21,Sunday,Night,27,109,136,19.85
2011-05-22,22,Sunday,Night,35,86,121,28.93
2011-05-22,23,Sunday,Night,19,46,65,29.23
2011-05-23,0,Monday,Early Morning,23,18,41,56.1
2011-05-23,1,Monday,Early Morning,4,5,9,44.44
2011-05-23,2,Monday,Early Morning,2,3,5,40.0
2011-05-23,3,Monday,Early Morning,0,4,4,0.0
2011-05-23,4,Monday,Early Morning,2,2,4,50.0
2011-05-23,5,Monday,Early Morning,0,11,11,0.0
2011-05-23,6,Monday,Morning Rush,4,92,96,4.17
2011-05-23,7,Monday,Morning Rush,13,223,236,5.51
2011-05-23,8,Monday,Morning Rush,50,359,409,12.22
2011-05-23,9,Monday,Morning Rush,36,131,167,21.56
2011-05-23,10,Monday,Mid-Day,49,72,121,40.5
2011-05-23,11,Monday,Mid-Day,73,107,180,40.56
2011-05-23,12,Monday,Mid-Day,65,139,204,31.86
2011-05-23,13,Monday,Mid-Day,49,155,204,24.02
2011-05-23,14,Monday,Mid-Day,57,130,187,30.48
2011-05-23,15,Monday,Mid-Day,57,119,176,32.39
2011-05-23,16,Monday,Evening Rush,56,223,279,20.07
2011-05-23,17,Monday,Evening Rush,56,373,429,13.05
2011-05-23,18,Monday,Evening Rush,68,385,453,15.01
2011-05-23,19,Monday,Evening Rush,56,302,358,15.64
2011-05-23,20,Monday,Night,39,271,310,12.58
2011-05-23,21,Monday,Night,33,155,188,17.55
2011-05-23,22,Monday,Night,25,106,131,19.08
2011-05-23,23,Monday,Night,19,53,72,26.39
2011-05-24,0,Tuesday,Early Morning,12,23,35,34.29
2011-05-24,1,Tuesday,Early Morning,6,9,15,40.0
2011-05-24,2,Tuesday,Early Morning,2,8,10,20.0
2011-05-24,3,Tuesday,Early Morning,0,2,2,0.0
2011-05-24,4,Tuesday,Early Morning,1,3,4,25.0
2011-05-24,5,Tuesday,Early Morning,2,22,24,8.33
2011-05-24,6,Tuesday,Morning Rush,10,102,112,8.93
2011-05-24,7,Tuesday,Morning Rush,26,288,314,8.28
2011-05-24,8,Tuesday,Morning Rush,31,403,434,7.14
2011-05-24,9,Tuesday,Morning Rush,27,111,138,19.57
2011-05-24,10,Tuesday,Mid-Day,18,90,108,16.67
2011-05-24,11,Tuesday,Mid-Day,33,142,175,18.86
2011-05-24,12,Tuesday,Mid-Day,41,129,170,24.12
2011-05-24,13,Tuesday,Mid-Day,38,152,190,20.0
2011-05-24,14,Tuesday,Mid-Day,27,126,153,17.65
2011-05-24,15,Tuesday,Mid-Day,59,129,188,31.38
2011-05-24,16,Tuesday,Evening Rush,52,225,277,18.77
2011-05-24,17,Tuesday,Evening Rush,56,492,548,10.22
2011-05-24,18,Tuesday,Evening Rush,74,490,564,13.12
2011-05-24,19,Tuesday,Evening Rush,45,310,355,12.68
2011-05-24,20,Tuesday,Night,39,241,280,13.93
2011-05-24,21,Tuesday,Night,21,168,189,11.11
2011-05-24,22,Tuesday,Night,26,115,141,18.44
2011-05-24,23,Tuesday,Night,13,53,66,19.7
2011-05-25,0,Wednesday,Early Morning,3,32,35,8.57
2011-05-25,1,Wednesday,Early Morning,6,2,8,75.0
2011-05-25,2,Wednesday,Early Morning,0,8,8,0.0
2011-05-25,3,Wednesday,Early Morning,0,9,9,0.0
2011-05-25,4,Wednesday,Early Morning,0,3,3,0.0
2011-05-25,5,Wednesday,Early Morning,2,23,25,8.0
2011-05-25,6,Wednesday,Morning Rush,4,113,117,3.42
2011-05-25,7,Wednesday,Morning Rush,29,284,313,9.27
2011-05-25,8,Wednesday,Morning Rush,36,495,531,6.78
2011-05-25,9,Wednesday,Morning Rush,27,207,234,11.54
2011-05-25,10,Wednesday,Mid-Day,30,105,135,22.22
2011-05-25,11,Wednesday,Mid-Day,36,104,140,25.71
2011-05-25,12,Wednesday,Mid-Day,32,178,210,15.24
2011-05-25,13,Wednesday,Mid-Day,39,163,202,19.31
2011-05-25,14,Wednesday,Mid-Day,47,121,168,27.98
2011-05-25,15,Wednesday,Mid-Day,37,145,182,20.33
2011-05-25,16,Wednesday,Evening Rush,61,238,299,20.4
2011-05-25,17,Wednesday,Evening Rush,77,524,601,12.81
2011-05-25,18,Wednesday,Evening Rush,66,451,517,12.77
2011-05-25,19,Wednesday,Evening Rush,73,332,405,18.02
2011-05-25,20,Wednesday,Night,56,284,340,16.47
2011-05-25,21,Wednesday,Night,33,203,236,13.98
2011-05-25,22,Wednesday,Night,34,140,174,19.54
2011-05-25,23,Wednesday,Night,12,74,86,13.95
2011-05-26,0,Thursday,Early Morning,11,34,45,24.44
2011-05-26,1,Thursday,Early Morning,3,13,16,18.75
2011-05-26,2,Thursday,Early Morning,7,7,14,50.0
2011-05-26,3,Thursday,Early Morning,0,4,4,0.0
2011-05-26,4,Thursday,Early Morning,0,2,2,0.0
2011-05-26,5,Thursday,Early Morning,2,25,27,7.41
2011-05-26,6,Thursday,Morning Rush,4,94,98,4.08
2011-05-26,7,Thursday,Morning Rush,16,270,286,5.59
2011-05-26,8,Thursday,Morning Rush,31,458,489,6.34
2011-05-26,9,Thursday,Morning Rush,22,194,216,10.19
2011-05-26,10,Thursday,Mid-Day,49,94,143,34.27
2011-05-26,11,Thursday,Mid-Day,36,124,160,22.5
2011-05-26,12,Thursday,Mid-Day,53,141,194,27.32
2011-05-26,13,Thursday,Mid-Day,52,145,197,26.4
2011-05-26,14,Thursday,Mid-Day,44,145,189,23.28
2011-05-26,15,Thursday,Mid-Day,40,101,141,28.37
2011-05-26,16,Thursday,Evening Rush,58,233,291,19.93
2011-05-26,17,Thursday,Evening Rush,49,445,494,9.92
2011-05-26,18,Thursday,Evening Rush,74,404,478,15.48
2011-05-26,19,Thursday,Evening Rush,67,311,378,17.72
2011-05-26,20,Thursday,Night,55,267,322,17.08
2011-05-26,21,Thursday,Night,45,178,223,20.18
2011-05-26,22,Thursday,Night,23,157,180,12.78
2011-05-26,23,Thursday,Night,17,73,90,18.89
2011-05-27,0,Friday,Early Morning,14,55,69,20.29
2011-05-27,1,Friday,Early Morning,14,36,50,28.0
2011-05-27,2,Friday,Early Morning,6,12,18,33.33
2011-05-27,3,Friday,Early Morning,1,11,12,8.33
2011-05-27,4,Friday,Early Morning,2,5,7,28.57
2011-05-27,5,Friday,Early Morning,2,29,31,6.45
2011-05-27,6,Friday,Morning Rush,8,73,81,9.88
2011-05-27,7,Friday,Morning Rush,20,229,249,8.03
2011-05-27,8,Friday,Morning Rush,25,393,418,5.98
2011-05-27,9,Friday,Morning Rush,37,190,227,16.3
2011-05-27,10,Friday,Mid-Day,42,111,153,27.45
2011-05-27,11,Friday,Mid-Day,40,126,166,24.1
2011-05-27,12,Friday,Mid-Day,53,190,243,21.81
2011-05-27,13,Friday,Mid-Day,51,158,209,24.4
2011-05-27,14,Friday,Mid-Day,51,188,239,21.34
2011-05-27,15,Friday,Mid-Day,98,258,356,27.53
2011-05-27,16,Friday,Evening Rush,63,356,419,15.04
2011-05-27,17,Friday,Evening Rush,77,414,491,15.68
2011-05-27,18,Friday,Evening Rush,89,310,399,22.31
2011-05-27,19,Friday,Evening Rush,69,210,279,24.73
2011-05-27,20,Friday,Night,24,120,144,16.67
2011-05-27,21,Friday,Night,37,114,151,24.5
2011-05-27,22,Friday,Night,25,116,141,17.73
2011-05-27,23,Friday,Night,23,104,127,18.11
2011-05-28,0,Saturday,Early Morning,15,79,94,15.96
2011-05-28,1,Saturday,Early Morning,8,47,55,14.55
2011-05-28,2,Saturday,Early Morning,13,35,48,27.08
2011-05-28,3,Saturday,Early Morning,2,13,15,13.33
2011-05-28,4,Saturday,Early Morning,0,4,4,0.0
2011-05-28,5,Saturday,Early Morning,4,3,7,57.14
2011-05-28,6,Saturday,Morning Rush,3,16,19,15.79
2011-05-28,7,Saturday,Morning Rush,17,33,50,34.0
2011-05-28,8,Saturday,Morning Rush,27,75,102,26.47
2011-05-28,9,Saturday,Morning Rush,61,116,177,34.46
2011-05-28,10,Saturday,Mid-Day,110,166,276,39.86
2011-05-28,11,Saturday,Mid-Day,171,178,349,49.0
2011-05-28,12,Saturday,Mid-Day,145,213,358,40.5
2011-05-28,13,Saturday,Mid-Day,168,217,385,43.64
2011-05-28,14,Saturday,Mid-Day,172,210,382,45.03
2011-05-28,15,Saturday,Mid-Day,187,187,374,50.0
2011-05-28,16,Saturday,Evening Rush,201,201,402,50.0
2011-05-28,17,Saturday,Evening Rush,180,161,341,52.79
2011-05-28,18,Saturday,Evening Rush,173,212,385,44.94
2011-05-28,19,Saturday,Evening Rush,99,153,252,39.29
2011-05-28,20,Saturday,Night,68,128,196,34.69
2011-05-28,21,Saturday,Night,87,114,201,43.28
2011-05-28,22,Saturday,Night,46,115,161,28.57
2011-05-28,23,Saturday,Night,44,81,125,35.2
2011-05-29,0,Sunday,Early Morning,32,51,83,38.55
2011-05-29,1,Sunday,Early Morning,17,49,66,25.76
2011-05-29,2,Sunday,Early Morning,12,49,61,19.67
2011-05-29,3,Sunday,Early Morning,2,24,26,7.69
2011-05-29,4,Sunday,Early Morning,13,10,23,56.52
2011-05-29,5,Sunday,Early Morning,3,3,6,50.0
2011-05-29,6,Sunday,Morning Rush,5,10,15,33.33
2011-05-29,7,Sunday,Morning Rush,13,17,30,43.33
2011-05-29,8,Sunday,Morning Rush,34,62,96,35.42
2011-05-29,9,Sunday,Morning Rush,74,78,152,48.68
2011-05-29,10,Sunday,Mid-Day,130,121,251,51.79
2011-05-29,11,Sunday,Mid-Day,139,180,319,43.57
2011-05-29,12,Sunday,Mid-Day,216,186,402,53.73
2011-05-29,13,Sunday,Mid-Day,237,181,418,56.7
2011-05-29,14,Sunday,Mid-Day,183,168,351,52.14
2011-05-29,15,Sunday,Mid-Day,221,155,376,58.78
2011-05-29,16,Sunday,Evening Rush,194,167,361,53.74
2011-05-29,17,Sunday,Evening Rush,214,169,383,55.87
2011-05-29,18,Sunday,Evening Rush,151,177,328,46.04
2011-05-29,19,Sunday,Evening Rush,141,146,287,49.13
2011-05-29,20,Sunday,Night,91,128,219,41.55
2011-05-29,21,Sunday,Night,107,122,229,46.72
2011-05-29,22,Sunday,Night,78,93,171,45.61
2011-05-29,23,Sunday,Night,48,87,135,35.56
2011-05-30,0,Monday,Early Morning,38,65,103,36.89
2011-05-30,1,Monday,Early Morning,26,53,79,32.91
2011-05-30,2,Monday,Early Morning,17,28,45,37.78
2011-05-30,3,Monday,Early Morning,10,8,18,55.56
2011-05-30,4,Monday,Early Morning,2,4,6,33.33
2011-05-30,5,Monday,Early Morning,1,6,7,14.29
2011-05-30,6,Monday,Morning Rush,6,10,16,37.5
2011-05-30,7,Monday,Morning Rush,12,19,31,38.71
2011-05-30,8,Monday,Morning Rush,36,58,94,38.3
2011-05-30,9,Monday,Morning Rush,47,81,128,36.72
2011-05-30,10,Monday,Mid-Day,116,153,269,43.12
2011-05-30,11,Monday,Mid-Day,153,168,321,47.66
2011-05-30,12,Monday,Mid-Day,179,187,366,48.91
2011-05-30,13,Monday,Mid-Day,133,217,350,38.0
2011-05-30,14,Monday,Mid-Day,142,185,327,43.43
2011-05-30,15,Monday,Mid-Day,132,179,311,42.44
2011-05-30,16,Monday,Evening Rush,101,208,309,32.69
2011-05-30,17,Monday,Evening Rush,102,202,304,33.55
2011-05-30,18,Monday,Evening Rush,77,172,249,30.92
2011-05-30,19,Monday,Evening Rush,68,157,225,30.22
2011-05-30,20,Monday,Night,69,168,237,29.11
2011-05-30,21,Monday,Night,42,107,149,28.19
2011-05-30,22,Monday,Night,26,80,106,24.53
2011-05-30,23,Monday,Night,14,34,48,29.17
2011-05-31,0,Tuesday,Early Morning,9,20,29,31.03
2011-05-31,1,Tuesday,Early Morning,8,9,17,47.06
2011-05-31,2,Tuesday,Early Morning,5,7,12,41.67
2011-05-31,3,Tuesday,Early Morning,1,3,4,25.0
2011-05-31,4,Tuesday,Early Morning,0,3,3,0.0
2011-05-31,5,Tuesday,Early Morning,0,26,26,0.0
2011-05-31,6,Tuesday,Morning Rush,11,98,109,10.09
2011-05-31,7,Tuesday,Morning Rush,16,219,235,6.81
2011-05-31,8,Tuesday,Morning Rush,34,372,406,8.37
2011-05-31,9,Tuesday,Morning Rush,22,153,175,12.57
2011-05-31,10,Tuesday,Mid-Day,37,72,109,33.94
2011-05-31,11,Tuesday,Mid-Day,28,78,106,26.42
2011-05-31,12,Tuesday,Mid-Day,37,125,162,22.84
2011-05-31,13,Tuesday,Mid-Day,37,110,147,25.17
2011-05-31,14,Tuesday,Mid-Day,41,99,140,29.29
2011-05-31,15,Tuesday,Mid-Day,42,133,175,24.0
2011-05-31,16,Tuesday,Evening Rush,44,205,249,17.67
2011-05-31,17,Tuesday,Evening Rush,67,428,495,13.54
2011-05-31,18,Tuesday,Evening Rush,55,362,417,13.19
2011-05-31,19,Tuesday,Evening Rush,39,246,285,13.68
2011-05-31,20,Tuesday,Night,38,213,251,15.14
2011-05-31,21,Tuesday,Night,45,165,210,21.43
2011-05-31,22,Tuesday,Night,42,117,159,26.42
2011-05-31,23,Tuesday,Night,15,46,61,24.59
2011-06-01,0,Wednesday,Early Morning,9,25,34,26.47
2011-06-01,1,Wednesday,Early Morning,8,9,17,47.06
2011-06-01,2,Wednesday,Early Morning,0,3,3,0.0
2011-06-01,3,Wednesday,Early Morning,0,6,6,0.0
2011-06-01,4,Wednesday,Early Morning,0,4,4,0.0
2011-06-01,5,Wednesday,Early Morning,2,19,21,9.52
2011-06-01,6,Wednesday,Morning Rush,7,121,128,5.47
2011-06-01,7,Wednesday,Morning Rush,19,265,284,6.69
2011-06-01,8,Wednesday,Morning Rush,37,417,454,8.15
2011-06-01,9,Wednesday,Morning Rush,34,173,207,16.43
2011-06-01,10,Wednesday,Mid-Day,31,84,115,26.96
2011-06-01,11,Wednesday,Mid-Day,26,86,112,23.21
2011-06-01,12,Wednesday,Mid-Day,32,137,169,18.93
2011-06-01,13,Wednesday,Mid-Day,29,125,154,18.83
2011-06-01,14,Wednesday,Mid-Day,40,105,145,27.59
2011-06-01,15,Wednesday,Mid-Day,25,127,152,16.45
2011-06-01,16,Wednesday,Evening Rush,39,227,266,14.66
2011-06-01,17,Wednesday,Evening Rush,52,434,486,10.7
2011-06-01,18,Wednesday,Evening Rush,31,278,309,10.03
2011-06-01,19,Wednesday,Evening Rush,16,248,264,6.06
2011-06-01,20,Wednesday,Night,23,233,256,8.98
2011-06-01,21,Wednesday,Night,29,161,190,15.26
2011-06-01,22,Wednesday,Night,14,115,129,10.85
2011-06-01,23,Wednesday,Night,10,59,69,14.49
2011-06-02,0,Thursday,Early Morning,11,31,42,26.19
2011-06-02,1,Thursday,Early Morning,3,12,15,20.0
2011-06-02,2,Thursday,Early Morning,0,6,6,0.0
2011-06-02,3,Thursday,Early Morning,0,4,4,0.0
2011-06-02,4,Thursday,Early Morning,0,3,3,0.0
2011-06-02,5,Thursday,Early Morning,3,28,31,9.68
2011-06-02,6,Thursday,Morning Rush,7,106,113,6.19
2011-06-02,7,Thursday,Morning Rush,19,285,304,6.25
2011-06-02,8,Thursday,Morning Rush,25,442,467,5.35
2011-06-02,9,Thursday,Morning Rush,28,197,225,12.44
2011-06-02,10,Thursday,Mid-Day,33,106,139,23.74
2011-06-02,11,Thursday,Mid-Day,42,123,165,25.45
2011-06-02,12,Thursday,Mid-Day,39,193,232,16.81
2011-06-02,13,Thursday,Mid-Day,35,168,203,17.24
2011-06-02,14,Thursday,Mid-Day,43,142,185,23.24
2011-06-02,15,Thursday,Mid-Day,44,144,188,23.4
2011-06-02,16,Thursday,Evening Rush,63,255,318,19.81
2011-06-02,17,Thursday,Evening Rush,88,484,572,15.38
2011-06-02,18,Thursday,Evening Rush,74,451,525,14.1
2011-06-02,19,Thursday,Evening Rush,58,321,379,15.3
2011-06-02,20,Thursday,Night,51,286,337,15.13
2011-06-02,21,Thursday,Night,33,215,248,13.31
2011-06-02,22,Thursday,Night,14,141,155,9.03
2011-06-02,23,Thursday,Night,23,89,112,20.54
2011-06-03,0,Friday,Early Morning,15,53,68,22.06
2011-06-03,1,Friday,Early Morning,7,15,22,31.82
2011-06-03,2,Friday,Early Morning,0,12,12,0.0
2011-06-03,3,Friday,Early Morning,0,5,5,0.0
2011-06-03,4,Friday,Early Morning,1,5,6,16.67
2011-06-03,5,Friday,Early Morning,4,24,28,14.29
2011-06-03,6,Friday,Morning Rush,8,98,106,7.55
2011-06-03,7,Friday,Morning Rush,25,252,277,9.03
2011-06-03,8,Friday,Morning Rush,31,471,502,6.18
2011-06-03,9,Friday,Morning Rush,36,194,230,15.65
2011-06-03,10,Friday,Mid-Day,54,107,161,33.54
2011-06-03,11,Friday,Mid-Day,57,135,192,29.69
2011-06-03,12,Friday,Mid-Day,51,208,259,19.69
2011-06-03,13,Friday,Mid-Day,58,190,248,23.39
2011-06-03,14,Friday,Mid-Day,66,174,240,27.5
2011-06-03,15,Friday,Mid-Day,56,156,212,26.42
2011-06-03,16,Friday,Evening Rush,63,286,349,18.05
2011-06-03,17,Friday,Evening Rush,73,485,558,13.08
2011-06-03,18,Friday,Evening Rush,76,488,564,13.48
2011-06-03,19,Friday,Evening Rush,53,338,391,13.55
2011-06-03,20,Friday,Night,57,236,293,19.45
2011-06-03,21,Friday,Night,51,196,247,20.65
2011-06-03,22,Friday,Night,26,145,171,15.2
2011-06-03,23,Friday,Night,30,141,171,17.54
2011-06-04,0,Saturday,Early Morning,24,69,93,25.81
2011-06-04,1,Saturday,Early Morning,14,80,94,14.89
2011-06-04,2,Saturday,Early Morning,18,41,59,30.51
2011-06-04,3,Saturday,Early Morning,8,10,18,44.44
2011-06-04,4,Saturday,Early Morning,4,11,15,26.67
2011-06-04,5,Saturday,Early Morning,3,5,8,37.5
2011-06-04,6,Saturday,Morning Rush,11,17,28,39.29
2011-06-04,7,Saturday,Morning Rush,27,60,87,31.03
2011-06-04,8,Saturday,Morning Rush,29,96,125,23.2
2011-06-04,9,Saturday,Morning Rush,55,169,224,24.55
2011-06-04,10,Saturday,Mid-Day,115,202,317,36.28
2011-06-04,11,Saturday,Mid-Day,120,249,369,32.52
2011-06-04,12,Saturday,Mid-Day,150,270,420,35.71
2011-06-04,13,Saturday,Mid-Day,188,268,456,41.23
2011-06-04,14,Saturday,Mid-Day,193,258,451,42.79
2011-06-04,15,Saturday,Mid-Day,180,224,404,44.55
2011-06-04,16,Saturday,Evening Rush,168,272,440,38.18
2011-06-04,17,Saturday,Evening Rush,142,202,344,41.28
2011-06-04,18,Saturday,Evening Rush,127,214,341,37.24
2011-06-04,19,Saturday,Evening Rush,79,206,285,27.72
2011-06-04,20,Saturday,Night,90,149,239,37.66
2011-06-04,21,Saturday,Night,46,139,185,24.86
2011-06-04,22,Saturday,Night,49,141,190,25.79
2011-06-04,23,Saturday,Night,29,121,150,19.33
2011-06-05,0,Sunday,Early Morning,23,90,113,20.35
2011-06-05,1,Sunday,Early Morning,26,70,96,27.08
2011-06-05,2,Sunday,Early Morning,16,48,64,25.0
2011-06-05,3,Sunday,Early Morning,22,25,47,46.81
2011-06-05,4,Sunday,Early Morning,4,8,12,33.33
2011-06-05,5,Sunday,Early Morning,1,5,6,16.67
2011-06-05,6,Sunday,Morning Rush,10,11,21,47.62
2011-06-05,7,Sunday,Morning Rush,8,19,27,29.63
2011-06-05,8,Sunday,Morning Rush,24,74,98,24.49
2011-06-05,9,Sunday,Morning Rush,53,111,164,32.32
2011-06-05,10,Sunday,Mid-Day,83,168,251,33.07
2011-06-05,11,Sunday,Mid-Day,121,214,335,36.12
2011-06-05,12,Sunday,Mid-Day,123,212,335,36.72
2011-06-05,13,Sunday,Mid-Day,154,213,367,41.96
2011-06-05,14,Sunday,Mid-Day,161,224,385,41.82
2011-06-05,15,Sunday,Mid-Day,161,256,417,38.61
2011-06-05,16,Sunday,Evening Rush,138,260,398,34.67
2011-06-05,17,Sunday,Evening Rush,126,264,390,32.31
2011-06-05,18,Sunday,Evening Rush,124,239,363,34.16
2011-06-05,19,Sunday,Evening Rush,108,249,357,30.25
2011-06-05,20,Sunday,Night,84,195,279,30.11
2011-06-05,21,Sunday,Night,54,111,165,32.73
2011-06-05,22,Sunday,Night,36,94,130,27.69
2011-06-05,23,Sunday,Night,25,61,86,29.07
2011-06-06,0,Monday,Early Morning,11,18,29,37.93
2011-06-06,1,Monday,Early Morning,9,5,14,64.29
2011-06-06,2,Monday,Early Morning,4,4,8,50.0
2011-06-06,3,Monday,Early Morning,2,3,5,40.0
2011-06-06,4,Monday,Early Morning,4,4,8,50.0
2011-06-06,5,Monday,Early Morning,7,24,31,22.58
2011-06-06,6,Monday,Morning Rush,11,101,112,9.82
2011-06-06,7,Monday,Morning Rush,18,281,299,6.02
2011-06-06,8,Monday,Morning Rush,28,410,438,6.39
2011-06-06,9,Monday,Morning Rush,26,162,188,13.83
2011-06-06,10,Monday,Mid-Day,31,64,95,32.63
2011-06-06,11,Monday,Mid-Day,39,72,111,35.14
2011-06-06,12,Monday,Mid-Day,25,128,153,16.34
2011-06-06,13,Monday,Mid-Day,28,152,180,15.56
2011-06-06,14,Monday,Mid-Day,46,99,145,31.72
2011-06-06,15,Monday,Mid-Day,38,127,165,23.03
2011-06-06,16,Monday,Evening Rush,34,233,267,12.73
2011-06-06,17,Monday,Evening Rush,63,516,579,10.88
2011-06-06,18,Monday,Evening Rush,56,500,556,10.07
2011-06-06,19,Monday,Evening Rush,64,343,407,15.72
2011-06-06,20,Monday,Night,59,277,336,17.56
2011-06-06,21,Monday,Night,29,160,189,15.34
2011-06-06,22,Monday,Night,36,137,173,20.81
2011-06-06,23,Monday,Night,5,55,60,8.33
2011-06-07,0,Tuesday,Early Morning,5,15,20,25.0
2011-06-07,1,Tuesday,Early Morning,2,2,4,50.0
2011-06-07,2,Tuesday,Early Morning,3,2,5,60.0
2011-06-07,3,Tuesday,Early Morning,1,1,2,50.0
2011-06-07,4,Tuesday,Early Morning,2,3,5,40.0
2011-06-07,5,Tuesday,Early Morning,2,30,32,6.25
2011-06-07,6,Tuesday,Morning Rush,10,116,126,7.94
2011-06-07,7,Tuesday,Morning Rush,23,311,334,6.89
2011-06-07,8,Tuesday,Morning Rush,45,432,477,9.43
2011-06-07,9,Tuesday,Morning Rush,27,190,217,12.44
2011-06-07,10,Tuesday,Mid-Day,37,86,123,30.08
2011-06-07,11,Tuesday,Mid-Day,38,113,151,25.17
2011-06-07,12,Tuesday,Mid-Day,42,141,183,22.95
2011-06-07,13,Tuesday,Mid-Day,55,141,196,28.06
2011-06-07,14,Tuesday,Mid-Day,34,112,146,23.29
2011-06-07,15,Tuesday,Mid-Day,56,127,183,30.6
2011-06-07,16,Tuesday,Evening Rush,55,253,308,17.86
2011-06-07,17,Tuesday,Evening Rush,64,475,539,11.87
2011-06-07,18,Tuesday,Evening Rush,72,479,551,13.07
2011-06-07,19,Tuesday,Evening Rush,69,355,424,16.27
2011-06-07,20,Tuesday,Night,45,301,346,13.01
2011-06-07,21,Tuesday,Night,31,187,218,14.22
2011-06-07,22,Tuesday,Night,27,126,153,17.65
2011-06-07,23,Tuesday,Night,18,72,90,20.0
2011-06-08,0,Wednesday,Early Morning,12,29,41,29.27
2011-06-08,1,Wednesday,Early Morning,3,20,23,13.04
2011-06-08,2,Wednesday,Early Morning,0,7,7,0.0
2011-06-08,3,Wednesday,Early Morning,2,1,3,66.67
2011-06-08,4,Wednesday,Early Morning,0,6,6,0.0
2011-06-08,5,Wednesday,Early Morning,0,21,21,0.0
2011-06-08,6,Wednesday,Morning Rush,13,103,116,11.21
2011-06-08,7,Wednesday,Morning Rush,24,329,353,6.8
2011-06-08,8,Wednesday,Morning Rush,46,435,481,9.56
2011-06-08,9,Wednesday,Morning Rush,34,168,202,16.83
2011-06-08,10,Wednesday,Mid-Day,27,63,90,30.0
2011-06-08,11,Wednesday,Mid-Day,28,106,134,20.9
2011-06-08,12,Wednesday,Mid-Day,15,134,149,10.07
2011-06-08,13,Wednesday,Mid-Day,20,116,136,14.71
2011-06-08,14,Wednesday,Mid-Day,44,111,155,28.39
2011-06-08,15,Wednesday,Mid-Day,28,100,128,21.88
2011-06-08,16,Wednesday,Evening Rush,34,199,233,14.59
2011-06-08,17,Wednesday,Evening Rush,80,426,506,15.81
2011-06-08,18,Wednesday,Evening Rush,61,398,459,13.29
2011-06-08,19,Wednesday,Evening Rush,61,323,384,15.89
2011-06-08,20,Wednesday,Night,55,225,280,19.64
2011-06-08,21,Wednesday,Night,34,168,202,16.83
2011-06-08,22,Wednesday,Night,37,139,176,21.02
2011-06-08,23,Wednesday,Night,18,98,116,15.52
2011-06-09,0,Thursday,Early Morning,7,40,47,14.89
2011-06-09,1,Thursday,Early Morning,3,13,16,18.75
2011-06-09,2,Thursday,Early Morning,0,6,6,0.0
2011-06-09,3,Thursday,Early Morning,0,2,2,0.0
2011-06-09,4,Thursday,Early Morning,2,4,6,33.33
2011-06-09,5,Thursday,Early Morning,1,19,20,5.0
2011-06-09,6,Thursday,Morning Rush,13,105,118,11.02
2011-06-09,7,Thursday,Morning Rush,31,283,314,9.87
2011-06-09,8,Thursday,Morning Rush,32,400,432,7.41
2011-06-09,9,Thursday,Morning Rush,20,148,168,11.9
2011-06-09,10,Thursday,Mid-Day,20,74,94,21.28
2011-06-09,11,Thursday,Mid-Day,36,82,118,30.51
2011-06-09,12,Thursday,Mid-Day,40,100,140,28.57
2011-06-09,13,Thursday,Mid-Day,18,118,136,13.24
2011-06-09,14,Thursday,Mid-Day,25,93,118,21.19
2011-06-09,15,Thursday,Mid-Day,18,86,104,17.31
2011-06-09,16,Thursday,Evening Rush,30,170,200,15.0
2011-06-09,17,Thursday,Evening Rush,54,355,409,13.2
2011-06-09,18,Thursday,Evening Rush,52,414,466,11.16
2011-06-09,19,Thursday,Evening Rush,55,271,326,16.87
2011-06-09,20,Thursday,Night,40,214,254,15.75
2011-06-09,21,Thursday,Night,29,142,171,16.96
2011-06-09,22,Thursday,Night,22,131,153,14.38
2011-06-09,23,Thursday,Night,15,82,97,15.46
2011-06-10,0,Friday,Early Morning,8,61,69,11.59
2011-06-10,1,Friday,Early Morning,5,18,23,21.74
2011-06-10,2,Friday,Early Morning,6,7,13,46.15
2011-06-10,3,Friday,Early Morning,3,3,6,50.0
2011-06-10,4,Friday,Early Morning,0,4,4,0.0
2011-06-10,5,Friday,Early Morning,0,28,28,0.0
2011-06-10,6,Friday,Morning Rush,10,94,104,9.62
2011-06-10,7,Friday,Morning Rush,25,242,267,9.36
2011-06-10,8,Friday,Morning Rush,29,423,452,6.42
2011-06-10,9,Friday,Morning Rush,37,176,213,17.37
2011-06-10,10,Friday,Mid-Day,23,88,111,20.72
2011-06-10,11,Friday,Mid-Day,46,107,153,30.07
2011-06-10,12,Friday,Mid-Day,40,167,207,19.32
2011-06-10,13,Friday,Mid-Day,40,149,189,21.16
2011-06-10,14,Friday,Mid-Day,44,121,165,26.67
2011-06-10,15,Friday,Mid-Day,49,163,212,23.11
2011-06-10,16,Friday,Evening Rush,46,239,285,16.14
2011-06-10,17,Friday,Evening Rush,63,454,517,12.19
2011-06-10,18,Friday,Evening Rush,96,367,463,20.73
2011-06-10,19,Friday,Evening Rush,61,245,306,19.93
2011-06-10,20,Friday,Night,53,197,250,21.2
2011-06-10,21,Friday,Night,55,163,218,25.23
2011-06-10,22,Friday,Night,40,145,185,21.62
2011-06-10,23,Friday,Night,36,110,146,24.66
2011-06-11,0,Saturday,Early Morning,28,89,117,23.93
2011-06-11,1,Saturday,Early Morning,10,67,77,12.99
2011-06-11,2,Saturday,Early Morning,10,50,60,16.67
2011-06-11,3,Saturday,Early Morning,10,18,28,35.71
2011-06-11,4,Saturday,Early Morning,4,9,13,30.77
2011-06-11,5,Saturday,Early Morning,4,12,16,25.0
2011-06-11,6,Saturday,Morning Rush,9,31,40,22.5
2011-06-11,7,Saturday,Morning Rush,18,50,68,26.47
2011-06-11,8,Saturday,Morning Rush,32,111,143,22.38
2011-06-11,9,Saturday,Morning Rush,59,171,230,25.65
2011-06-11,10,Saturday,Mid-Day,91,173,264,34.47
2011-06-11,11,Saturday,Mid-Day,110,215,325,33.85
2011-06-11,12,Saturday,Mid-Day,112,235,347,32.28
2011-06-11,13,Saturday,Mid-Day,150,237,387,38.76
2011-06-11,14,Saturday,Mid-Day,148,232,380,38.95
2011-06-11,15,Saturday,Mid-Day,142,232,374,37.97
2011-06-11,16,Saturday,Evening Rush,169,225,394,42.89
2011-06-11,17,Saturday,Evening Rush,147,190,337,43.62
2011-06-11,18,Saturday,Evening Rush,131,155,286,45.8
2011-06-11,19,Saturday,Evening Rush,97,167,264,36.74
2011-06-11,20,Saturday,Night,95,180,275,34.55
2011-06-11,21,Saturday,Night,76,144,220,34.55
2011-06-11,22,Saturday,Night,53,137,190,27.89
2011-06-11,23,Saturday,Night,24,107,131,18.32
2011-06-12,0,Sunday,Early Morning,19,100,119,15.97
2011-06-12,1,Sunday,Early Morning,19,74,93,20.43
2011-06-12,2,Sunday,Early Morning,9,57,66,13.64
2011-06-12,3,Sunday,Early Morning,8,20,28,28.57
2011-06-12,4,Sunday,Early Morning,8,6,14,57.14
2011-06-12,5,Sunday,Early Morning,5,5,10,50.0
2011-06-12,6,Sunday,Morning Rush,5,9,14,35.71
2011-06-12,7,Sunday,Morning Rush,7,27,34,20.59
2011-06-12,8,Sunday,Morning Rush,28,64,92,30.43
2011-06-12,9,Sunday,Morning Rush,75,107,182,41.21
2011-06-12,10,Sunday,Mid-Day,120,191,311,38.59
2011-06-12,11,Sunday,Mid-Day,131,236,367,35.69
2011-06-12,12,Sunday,Mid-Day,176,244,420,41.9
2011-06-12,13,Sunday,Mid-Day,109,264,373,29.22
2011-06-12,14,Sunday,Mid-Day,96,219,315,30.48
2011-06-12,15,Sunday,Mid-Day,142,218,360,39.44
2011-06-12,16,Sunday,Evening Rush,115,235,350,32.86
2011-06-12,17,Sunday,Evening Rush,94,158,252,37.3
2011-06-12,18,Sunday,Evening Rush,69,187,256,26.95
2011-06-12,19,Sunday,Evening Rush,67,156,223,30.04
2011-06-12,20,Sunday,Night,62,144,206,30.1
2011-06-12,21,Sunday,Night,39,101,140,27.86
2011-06-12,22,Sunday,Night,31,97,128,24.22
2011-06-12,23,Sunday,Night,33,74,107,30.84
2011-06-13,0,Monday,Early Morning,8,20,28,28.57
2011-06-13,1,Monday,Early Morning,6,10,16,37.5
2011-06-13,2,Monday,Early Morning,2,8,10,20.0
2011-06-13,3,Monday,Early Morning,1,6,7,14.29
2011-06-13,4,Monday,Early Morning,1,3,4,25.0
2011-06-13,5,Monday,Early Morning,2,27,29,6.9
2011-06-13,6,Monday,Morning Rush,7,98,105,6.67
2011-06-13,7,Monday,Morning Rush,26,302,328,7.93
2011-06-13,8,Monday,Morning Rush,44,432,476,9.24
2011-06-13,9,Monday,Morning Rush,35,189,224,15.63
2011-06-13,10,Monday,Mid-Day,38,80,118,32.2
2011-06-13,11,Monday,Mid-Day,53,106,159,33.33
2011-06-13,12,Monday,Mid-Day,35,161,196,17.86
2011-06-13,13,Monday,Mid-Day,53,174,227,23.35
2011-06-13,14,Monday,Mid-Day,55,145,200,27.5
2011-06-13,15,Monday,Mid-Day,58,127,185,31.35
2011-06-13,16,Monday,Evening Rush,64,262,326,19.63
2011-06-13,17,Monday,Evening Rush,72,529,601,11.98
2011-06-13,18,Monday,Evening Rush,76,510,586,12.97
2011-06-13,19,Monday,Evening Rush,75,348,423,17.73
2011-06-13,20,Monday,Night,78,253,331,23.56
2011-06-13,21,Monday,Night,40,178,218,18.35
2011-06-13,22,Monday,Night,20,114,134,14.93
2011-06-13,23,Monday,Night,14,75,89,15.73
2011-06-14,0,Tuesday,Early Morning,13,18,31,41.94
2011-06-14,1,Tuesday,Early Morning,3,10,13,23.08
2011-06-14,2,Tuesday,Early Morning,2,8,10,20.0
2011-06-14,3,Tuesday,Early Morning,1,1,2,50.0
2011-06-14,4,Tuesday,Early Morning,0,3,3,0.0
2011-06-14,5,Tuesday,Early Morning,3,23,26,11.54
2011-06-14,6,Tuesday,Morning Rush,6,107,113,5.31
2011-06-14,7,Tuesday,Morning Rush,19,346,365,5.21
2011-06-14,8,Tuesday,Morning Rush,45,441,486,9.26
2011-06-14,9,Tuesday,Morning Rush,19,174,193,9.84
2011-06-14,10,Tuesday,Mid-Day,33,97,130,25.38
2011-06-14,11,Tuesday,Mid-Day,40,103,143,27.97
2011-06-14,12,Tuesday,Mid-Day,30,139,169,17.75
2011-06-14,13,Tuesday,Mid-Day,33,176,209,15.79
2011-06-14,14,Tuesday,Mid-Day,41,118,159,25.79
2011-06-14,15,Tuesday,Mid-Day,42,136,178,23.6
2011-06-14,16,Tuesday,Evening Rush,51,279,330,15.45
2011-06-14,17,Tuesday,Evening Rush,85,484,569,14.94
2011-06-14,18,Tuesday,Evening Rush,65,473,538,12.08
2011-06-14,19,Tuesday,Evening Rush,51,335,386,13.21
2011-06-14,20,Tuesday,Night,60,237,297,20.2
2011-06-14,21,Tuesday,Night,37,206,243,15.23
2011-06-14,22,Tuesday,Night,29,159,188,15.43
2011-06-14,23,Tuesday,Night,19,91,110,17.27
2011-06-15,0,Wednesday,Early Morning,8,44,52,15.38
2011-06-15,1,Wednesday,Early Morning,0,14,14,0.0
2011-06-15,2,Wednesday,Early Morning,0,9,9,0.0
2011-06-15,3,Wednesday,Early Morning,0,1,1,0.0
2011-06-15,4,Wednesday,Early Morning,0,4,4,0.0
2011-06-15,5,Wednesday,Early Morning,1,20,21,4.76
2011-06-15,6,Wednesday,Morning Rush,11,110,121,9.09
2011-06-15,7,Wednesday,Morning Rush,22,348,370,5.95
2011-06-15,8,Wednesday,Morning Rush,53,445,498,10.64
2011-06-15,9,Wednesday,Morning Rush,22,185,207,10.63
2011-06-15,10,Wednesday,Mid-Day,27,108,135,20.0
2011-06-15,11,Wednesday,Mid-Day,49,115,164,29.88
2011-06-15,12,Wednesday,Mid-Day,33,178,211,15.64
2011-06-15,13,Wednesday,Mid-Day,43,146,189,22.75
2011-06-15,14,Wednesday,Mid-Day,50,128,178,28.09
2011-06-15,15,Wednesday,Mid-Day,33,131,164,20.12
2011-06-15,16,Wednesday,Evening Rush,47,265,312,15.06
2011-06-15,17,Wednesday,Evening Rush,83,555,638,13.01
2011-06-15,18,Wednesday,Evening Rush,80,527,607,13.18
2011-06-15,19,Wednesday,Evening Rush,54,362,416,12.98
2011-06-15,20,Wednesday,Night,57,273,330,17.27
2011-06-15,21,Wednesday,Night,48,209,257,18.68
2011-06-15,22,Wednesday,Night,31,144,175,17.71
2011-06-15,23,Wednesday,Night,17,90,107,15.89
2011-06-16,0,Thursday,Early Morning,9,38,47,19.15
2011-06-16,1,Thursday,Early Morning,4,13,17,23.53
2011-06-16,2,Thursday,Early Morning,1,4,5,20.0
2011-06-16,3,Thursday,Early Morning,0,4,4,0.0
2011-06-16,4,Thursday,Early Morning,0,6,6,0.0
2011-06-16,5,Thursday,Early Morning,7,18,25,28.0
2011-06-16,6,Thursday,Morning Rush,8,104,112,7.14
2011-06-16,7,Thursday,Morning Rush,16,172,188,8.51
2011-06-16,8,Thursday,Morning Rush,24,364,388,6.19
2011-06-16,9,Thursday,Morning Rush,29,232,261,11.11
2011-06-16,10,Thursday,Mid-Day,18,103,121,14.88
2011-06-16,11,Thursday,Mid-Day,33,117,150,22.0
2011-06-16,12,Thursday,Mid-Day,41,165,206,19.9
2011-06-16,13,Thursday,Mid-Day,37,114,151,24.5
2011-06-16,14,Thursday,Mid-Day,39,114,153,25.49
2011-06-16,15,Thursday,Mid-Day,32,127,159,20.13
2011-06-16,16,Thursday,Evening Rush,36,258,294,12.24
2011-06-16,17,Thursday,Evening Rush,42,230,272,15.44
2011-06-16,18,Thursday,Evening Rush,26,299,325,8.0
2011-06-16,19,Thursday,Evening Rush,58,269,327,17.74
2011-06-16,20,Thursday,Night,25,176,201,12.44
2011-06-16,21,Thursday,Night,34,154,188,18.09
2011-06-16,22,Thursday,Night,24,127,151,15.89
2011-06-16,23,Thursday,Night,2,14,16,12.5
2011-06-17,0,Friday,Early Morning,3,21,24,12.5
2011-06-17,1,Friday,Early Morning,4,19,23,17.39
2011-06-17,2,Friday,Early Morning,2,11,13,15.38
2011-06-17,3,Friday,Early Morning,1,5,6,16.67
2011-06-17,4,Friday,Early Morning,1,5,6,16.67
2011-06-17,5,Friday,Early Morning,1,12,13,7.69
2011-06-17,6,Friday,Morning Rush,8,89,97,8.25
2011-06-17,7,Friday,Morning Rush,25,225,250,10.0
2011-06-17,8,Friday,Morning Rush,28,426,454,6.17
2011-06-17,9,Friday,Morning Rush,28,196,224,12.5
2011-06-17,10,Friday,Mid-Day,44,126,170,25.88
2011-06-17,11,Friday,Mid-Day,43,138,181,23.76
2011-06-17,12,Friday,Mid-Day,49,194,243,20.16
2011-06-17,13,Friday,Mid-Day,48,156,204,23.53
2011-06-17,14,Friday,Mid-Day,73,142,215,33.95
2011-06-17,15,Friday,Mid-Day,62,181,243,25.51
2011-06-17,16,Friday,Evening Rush,69,286,355,19.44
2011-06-17,17,Friday,Evening Rush,85,467,552,15.4
2011-06-17,18,Friday,Evening Rush,62,388,450,13.78
2011-06-17,19,Friday,Evening Rush,53,275,328,16.16
2011-06-17,20,Friday,Night,40,192,232,17.24
2011-06-17,21,Friday,Night,49,159,208,23.56
2011-06-17,22,Friday,Night,48,127,175,27.43
2011-06-17,23,Friday,Night,37,141,178,20.79
2011-06-18,0,Saturday,Early Morning,21,83,104,20.19
2011-06-18,1,Saturday,Early Morning,15,80,95,15.79
2011-06-18,2,Saturday,Early Morning,16,37,53,30.19
2011-06-18,3,Saturday,Early Morning,4,16,20,20.0
2011-06-18,4,Saturday,Early Morning,1,4,5,20.0
2011-06-18,5,Saturday,Early Morning,1,6,7,14.29
2011-06-18,6,Saturday,Morning Rush,9,18,27,33.33
2011-06-18,7,Saturday,Morning Rush,12,45,57,21.05
2011-06-18,8,Saturday,Morning Rush,28,103,131,21.37
2011-06-18,9,Saturday,Morning Rush,62,156,218,28.44
2011-06-18,10,Saturday,Mid-Day,68,176,244,27.87
2011-06-18,11,Saturday,Mid-Day,134,270,404,33.17
2011-06-18,12,Saturday,Mid-Day,162,258,420,38.57
2011-06-18,13,Saturday,Mid-Day,135,192,327,41.28
2011-06-18,14,Saturday,Mid-Day,138,196,334,41.32
2011-06-18,15,Saturday,Mid-Day,153,214,367,41.69
2011-06-18,16,Saturday,Evening Rush,193,275,468,41.24
2011-06-18,17,Saturday,Evening Rush,210,239,449,46.77
2011-06-18,18,Saturday,Evening Rush,118,263,381,30.97
2011-06-18,19,Saturday,Evening Rush,99,227,326,30.37
2011-06-18,20,Saturday,Night,61,127,188,32.45
2011-06-18,21,Saturday,Night,58,125,183,31.69
2011-06-18,22,Saturday,Night,56,105,161,34.78
2011-06-18,23,Saturday,Night,53,97,150,35.33
2011-06-19,0,Sunday,Early Morning,18,71,89,20.22
2011-06-19,1,Sunday,Early Morning,17,59,76,22.37
2011-06-19,2,Sunday,Early Morning,13,59,72,18.06
2011-06-19,3,Sunday,Early Morning,14,16,30,46.67
2011-06-19,4,Sunday,Early Morning,7,10,17,41.18
2011-06-19,5,Sunday,Early Morning,7,12,19,36.84
2011-06-19,6,Sunday,Morning Rush,11,22,33,33.33
2011-06-19,7,Sunday,Morning Rush,35,36,71,49.3
2011-06-19,8,Sunday,Morning Rush,25,59,84,29.76
2011-06-19,9,Sunday,Morning Rush,58,111,169,34.32
2011-06-19,10,Sunday,Mid-Day,86,158,244,35.25
2011-06-19,11,Sunday,Mid-Day,141,236,377,37.4
2011-06-19,12,Sunday,Mid-Day,141,255,396,35.61
2011-06-19,13,Sunday,Mid-Day,149,214,363,41.05
2011-06-19,14,Sunday,Mid-Day,124,193,317,39.12
2011-06-19,15,Sunday,Mid-Day,146,216,362,40.33
2011-06-19,16,Sunday,Evening Rush,121,257,378,32.01
2011-06-19,17,Sunday,Evening Rush,159,238,397,40.05
2011-06-19,18,Sunday,Evening Rush,78,218,296,26.35
2011-06-19,19,Sunday,Evening Rush,94,217,311,30.23
2011-06-19,20,Sunday,Night,86,146,232,37.07
2011-06-19,21,Sunday,Night,57,110,167,34.13
2011-06-19,22,Sunday,Night,38,114,152,25.0
2011-06-19,23,Sunday,Night,14,78,92,15.22
2011-06-20,0,Monday,Early Morning,7,19,26,26.92
2011-06-20,1,Monday,Early Morning,9,3,12,75.0
2011-06-20,2,Monday,Early Morning,2,0,2,100.0
2011-06-20,3,Monday,Early Morning,1,0,1,100.0
2011-06-20,4,Monday,Early Morning,1,2,3,33.33
2011-06-20,5,Monday,Early Morning,0,3,3,0.0
2011-06-20,6,Monday,Morning Rush,1,25,26,3.85
2011-06-20,7,Monday,Morning Rush,0,46,46,0.0
2011-06-20,8,Monday,Morning Rush,12,209,221,5.43
2011-06-20,9,Monday,Morning Rush,19,200,219,8.68
2011-06-20,10,Monday,Mid-Day,33,58,91,36.26
2011-06-20,11,Monday,Mid-Day,27,67,94,28.72
2011-06-20,12,Monday,Mid-Day,33,129,162,20.37
2011-06-20,13,Monday,Mid-Day,50,129,179,27.93
2011-06-20,14,Monday,Mid-Day,45,130,175,25.71
2011-06-20,15,Monday,Mid-Day,66,139,205,32.2
2011-06-20,16,Monday,Evening Rush,61,238,299,20.4
2011-06-20,17,Monday,Evening Rush,81,484,565,14.34
2011-06-20,18,Monday,Evening Rush,64,474,538,11.9
2011-06-20,19,Monday,Evening Rush,62,369,431,14.39
2011-06-20,20,Monday,Night,52,264,316,16.46
2011-06-20,21,Monday,Night,39,167,206,18.93
2011-06-20,22,Monday,Night,24,106,130,18.46
2011-06-20,23,Monday,Night,10,50,60,16.67
2011-06-21,0,Tuesday,Early Morning,10,23,33,30.3
2011-06-21,1,Tuesday,Early Morning,2,12,14,14.29
2011-06-21,2,Tuesday,Early Morning,1,5,6,16.67
2011-06-21,3,Tuesday,Early Morning,0,2,2,0.0
2011-06-21,4,Tuesday,Early Morning,2,7,9,22.22
2011-06-21,5,Tuesday,Early Morning,3,22,25,12.0
2011-06-21,6,Tuesday,Morning Rush,8,107,115,6.96
2011-06-21,7,Tuesday,Morning Rush,21,288,309,6.8
2011-06-21,8,Tuesday,Morning Rush,33,368,401,8.23
2011-06-21,9,Tuesday,Morning Rush,32,243,275,11.64
2011-06-21,10,Tuesday,Mid-Day,41,120,161,25.47
2011-06-21,11,Tuesday,Mid-Day,52,119,171,30.41
2011-06-21,12,Tuesday,Mid-Day,40,149,189,21.16
2011-06-21,13,Tuesday,Mid-Day,49,158,207,23.67
2011-06-21,14,Tuesday,Mid-Day,44,108,152,28.95
2011-06-21,15,Tuesday,Mid-Day,42,128,170,24.71
2011-06-21,16,Tuesday,Evening Rush,62,273,335,18.51
2011-06-21,17,Tuesday,Evening Rush,65,507,572,11.36
2011-06-21,18,Tuesday,Evening Rush,67,469,536,12.5
2011-06-21,19,Tuesday,Evening Rush,67,358,425,15.76
2011-06-21,20,Tuesday,Night,72,254,326,22.09
2011-06-21,21,Tuesday,Night,38,191,229,16.59
2011-06-21,22,Tuesday,Night,12,97,109,11.01
2011-06-21,23,Tuesday,Night,11,53,64,17.19
2011-06-22,0,Wednesday,Early Morning,15,18,33,45.45
2011-06-22,1,Wednesday,Early Morning,2,19,21,9.52
2011-06-22,2,Wednesday,Early Morning,2,5,7,28.57
2011-06-22,3,Wednesday,Early Morning,0,7,7,0.0
2011-06-22,4,Wednesday,Early Morning,3,8,11,27.27
2011-06-22,5,Wednesday,Early Morning,2,21,23,8.7
2011-06-22,6,Wednesday,Morning Rush,12,110,122,9.84
2011-06-22,7,Wednesday,Morning Rush,23,288,311,7.4
2011-06-22,8,Wednesday,Morning Rush,27,396,423,6.38
2011-06-22,9,Wednesday,Morning Rush,14,205,219,6.39
2011-06-22,10,Wednesday,Mid-Day,31,104,135,22.96
2011-06-22,11,Wednesday,Mid-Day,37,108,145,25.52
2011-06-22,12,Wednesday,Mid-Day,44,144,188,23.4
2011-06-22,13,Wednesday,Mid-Day,34,113,147,23.13
2011-06-22,14,Wednesday,Mid-Day,32,113,145,22.07
2011-06-22,15,Wednesday,Mid-Day,32,114,146,21.92
2011-06-22,16,Wednesday,Evening Rush,34,224,258,13.18
2011-06-22,17,Wednesday,Evening Rush,67,462,529,12.67
2011-06-22,18,Wednesday,Evening Rush,66,447,513,12.87
2011-06-22,19,Wednesday,Evening Rush,62,280,342,18.13
2011-06-22,20,Wednesday,Night,52,230,282,18.44
2011-06-22,21,Wednesday,Night,31,216,247,12.55
2011-06-22,22,Wednesday,Night,25,123,148,16.89
2011-06-22,23,Wednesday,Night,14,91,105,13.33
2011-06-23,0,Thursday,Early Morning,5,44,49,10.2
2011-06-23,1,Thursday,Early Morning,5,26,31,16.13
2011-06-23,2,Thursday,Early Morning,0,4,4,0.0
2011-06-23,3,Thursday,Early Morning,1,4,5,20.0
2011-06-23,4,Thursday,Early Morning,0,7,7,0.0
2011-06-23,5,Thursday,Early Morning,2,22,24,8.33
2011-06-23,6,Thursday,Morning Rush,8,92,100,8.0
2011-06-23,7,Thursday,Morning Rush,26,301,327,7.95
2011-06-23,8,Thursday,Morning Rush,20,412,432,4.63
2011-06-23,9,Thursday,Morning Rush,33,194,227,14.54
2011-06-23,10,Thursday,Mid-Day,39,88,127,30.71
2011-06-23,11,Thursday,Mid-Day,28,108,136,20.59
2011-06-23,12,Thursday,Mid-Day,30,130,160,18.75
2011-06-23,13,Thursday,Mid-Day,37,149,186,19.89
2011-06-23,14,Thursday,Mid-Day,46,103,149,30.87
2011-06-23,15,Thursday,Mid-Day,62,127,189,32.8
2011-06-23,16,Thursday,Evening Rush,58,217,275,21.09
2011-06-23,17,Thursday,Evening Rush,74,495,569,13.01
2011-06-23,18,Thursday,Evening Rush,57,483,540,10.56
2011-06-23,19,Thursday,Evening Rush,56,344,400,14.0
2011-06-23,20,Thursday,Night,75,277,352,21.31
2011-06-23,21,Thursday,Night,46,188,234,19.66
2011-06-23,22,Thursday,Night,23,139,162,14.2
2011-06-23,23,Thursday,Night,15,90,105,14.29
2011-06-24,0,Friday,Early Morning,10,53,63,15.87
2011-06-24,1,Friday,Early Morning,8,20,28,28.57
2011-06-24,2,Friday,Early Morning,4,10,14,28.57
2011-06-24,3,Friday,Early Morning,1,4,5,20.0
2011-06-24,4,Friday,Early Morning,1,8,9,11.11
2011-06-24,5,Friday,Early Morning,2,18,20,10.0
2011-06-24,6,Friday,Morning Rush,4,87,91,4.4
2011-06-24,7,Friday,Morning Rush,21,247,268,7.84
2011-06-24,8,Friday,Morning Rush,27,439,466,5.79
2011-06-24,9,Friday,Morning Rush,28,203,231,12.12
2011-06-24,10,Friday,Mid-Day,43,102,145,29.66
2011-06-24,11,Friday,Mid-Day,56,147,203,27.59
2011-06-24,12,Friday,Mid-Day,51,150,201,25.37
2011-06-24,13,Friday,Mid-Day,43,178,221,19.46
2011-06-24,14,Friday,Mid-Day,67,162,229,29.26
2011-06-24,15,Friday,Mid-Day,69,147,216,31.94
2011-06-24,16,Friday,Evening Rush,80,247,327,24.46
2011-06-24,17,Friday,Evening Rush,85,472,557,15.26
2011-06-24,18,Friday,Evening Rush,87,365,452,19.25
2011-06-24,19,Friday,Evening Rush,92,293,385,23.9
2011-06-24,20,Friday,Night,66,222,288,22.92
2011-06-24,21,Friday,Night,50,183,233,21.46
2011-06-24,22,Friday,Night,41,126,167,24.55
2011-06-24,23,Friday,Night,33,139,172,19.19
2011-06-25,0,Saturday,Early Morning,19,97,116,16.38
2011-06-25,1,Saturday,Early Morning,20,75,95,21.05
2011-06-25,2,Saturday,Early Morning,8,51,59,13.56
2011-06-25,3,Saturday,Early Morning,18,21,39,46.15
2011-06-25,4,Saturday,Early Morning,7,4,11,63.64
2011-06-25,5,Saturday,Early Morning,6,8,14,42.86
2011-06-25,6,Saturday,Morning Rush,12,17,29,41.38
2011-06-25,7,Saturday,Morning Rush,7,35,42,16.67
2011-06-25,8,Saturday,Morning Rush,27,85,112,24.11
2011-06-25,9,Saturday,Morning Rush,47,139,186,25.27
2011-06-25,10,Saturday,Mid-Day,99,203,302,32.78
2011-06-25,11,Saturday,Mid-Day,122,209,331,36.86
2011-06-25,12,Saturday,Mid-Day,140,252,392,35.71
2011-06-25,13,Saturday,Mid-Day,140,231,371,37.74
2011-06-25,14,Saturday,Mid-Day,151,232,383,39.43
2011-06-25,15,Saturday,Mid-Day,157,235,392,40.05
2011-06-25,16,Saturday,Evening Rush,175,235,410,42.68
2011-06-25,17,Saturday,Evening Rush,152,247,399,38.1
2011-06-25,18,Saturday,Evening Rush,108,199,307,35.18
2011-06-25,19,Saturday,Evening Rush,121,254,375,32.27
2011-06-25,20,Saturday,Night,74,195,269,27.51
2011-06-25,21,Saturday,Night,62,140,202,30.69
2011-06-25,22,Saturday,Night,61,126,187,32.62
2011-06-25,23,Saturday,Night,49,130,179,27.37
2011-06-26,0,Sunday,Early Morning,30,85,115,26.09
2011-06-26,1,Sunday,Early Morning,17,73,90,18.89
2011-06-26,2,Sunday,Early Morning,17,70,87,19.54
2011-06-26,3,Sunday,Early Morning,12,22,34,35.29
2011-06-26,4,Sunday,Early Morning,3,8,11,27.27
2011-06-26,5,Sunday,Early Morning,3,9,12,25.0
2011-06-26,6,Sunday,Morning Rush,7,13,20,35.0
2011-06-26,7,Sunday,Morning Rush,24,27,51,47.06
2011-06-26,8,Sunday,Morning Rush,29,78,107,27.1
2011-06-26,9,Sunday,Morning Rush,75,131,206,36.41
2011-06-26,10,Sunday,Mid-Day,136,196,332,40.96
2011-06-26,11,Sunday,Mid-Day,127,219,346,36.71
2011-06-26,12,Sunday,Mid-Day,175,268,443,39.5
2011-06-26,13,Sunday,Mid-Day,197,245,442,44.57
2011-06-26,14,Sunday,Mid-Day,197,246,443,44.47
2011-06-26,15,Sunday,Mid-Day,174,229,403,43.18
2011-06-26,16,Sunday,Evening Rush,177,278,455,38.9
2011-06-26,17,Sunday,Evening Rush,178,243,421,42.28
2011-06-26,18,Sunday,Evening Rush,117,265,382,30.63
2011-06-26,19,Sunday,Evening Rush,89,228,317,28.08
2011-06-26,20,Sunday,Night,55,158,213,25.82
2011-06-26,21,Sunday,Night,48,135,183,26.23
2011-06-26,22,Sunday,Night,19,95,114,16.67
2011-06-26,23,Sunday,Night,14,64,78,17.95
2011-06-27,0,Monday,Early Morning,7,25,32,21.88
2011-06-27,1,Monday,Early Morning,4,11,15,26.67
2011-06-27,2,Monday,Early Morning,3,3,6,50.0
2011-06-27,3,Monday,Early Morning,0,2,2,0.0
2011-06-27,4,Monday,Early Morning,1,8,9,11.11
2011-06-27,5,Monday,Early Morning,1,21,22,4.55
2011-06-27,6,Monday,Morning Rush,4,90,94,4.26
2011-06-27,7,Monday,Morning Rush,14,247,261,5.36
2011-06-27,8,Monday,Morning Rush,29,418,447,6.49
2011-06-27,9,Monday,Morning Rush,37,150,187,19.79
2011-06-27,10,Monday,Mid-Day,55,95,150,36.67
2011-06-27,11,Monday,Mid-Day,55,95,150,36.67
2011-06-27,12,Monday,Mid-Day,40,130,170,23.53
2011-06-27,13,Monday,Mid-Day,37,127,164,22.56
2011-06-27,14,Monday,Mid-Day,58,100,158,36.71
2011-06-27,15,Monday,Mid-Day,76,126,202,37.62
2011-06-27,16,Monday,Evening Rush,53,222,275,19.27
2011-06-27,17,Monday,Evening Rush,90,514,604,14.9
2011-06-27,18,Monday,Evening Rush,79,512,591,13.37
2011-06-27,19,Monday,Evening Rush,56,340,396,14.14
2011-06-27,20,Monday,Night,54,251,305,17.7
2011-06-27,21,Monday,Night,52,190,242,21.49
2011-06-27,22,Monday,Night,33,112,145,22.76
2011-06-27,23,Monday,Night,16,65,81,19.75
2011-06-28,0,Tuesday,Early Morning,5,25,30,16.67
2011-06-28,1,Tuesday,Early Morning,5,8,13,38.46
2011-06-28,2,Tuesday,Early Morning,2,9,11,18.18
2011-06-28,3,Tuesday,Early Morning,0,2,2,0.0
2011-06-28,4,Tuesday,Early Morning,1,7,8,12.5
2011-06-28,5,Tuesday,Early Morning,1,20,21,4.76
2011-06-28,6,Tuesday,Morning Rush,7,117,124,5.65
2011-06-28,7,Tuesday,Morning Rush,27,320,347,7.78
2011-06-28,8,Tuesday,Morning Rush,39,417,456,8.55
2011-06-28,9,Tuesday,Morning Rush,38,208,246,15.45
2011-06-28,10,Tuesday,Mid-Day,45,112,157,28.66
2011-06-28,11,Tuesday,Mid-Day,49,118,167,29.34
2011-06-28,12,Tuesday,Mid-Day,41,161,202,20.3
2011-06-28,13,Tuesday,Mid-Day,33,156,189,17.46
2011-06-28,14,Tuesday,Mid-Day,43,117,160,26.88
2011-06-28,15,Tuesday,Mid-Day,39,127,166,23.49
2011-06-28,16,Tuesday,Evening Rush,41,220,261,15.71
2011-06-28,17,Tuesday,Evening Rush,70,509,579,12.09
2011-06-28,18,Tuesday,Evening Rush,68,436,504,13.49
2011-06-28,19,Tuesday,Evening Rush,44,255,299,14.72
2011-06-28,20,Tuesday,Night,50,246,296,16.89
2011-06-28,21,Tuesday,Night,31,164,195,15.9
2011-06-28,22,Tuesday,Night,30,104,134,22.39
2011-06-28,23,Tuesday,Night,23,58,81,28.4
2011-06-29,0,Wednesday,Early Morning,11,25,36,30.56
2011-06-29,1,Wednesday,Early Morning,10,18,28,35.71
2011-06-29,2,Wednesday,Early Morning,7,9,16,43.75
2011-06-29,3,Wednesday,Early Morning,2,3,5,40.0
2011-06-29,4,Wednesday,Early Morning,0,5,5,0.0
2011-06-29,5,Wednesday,Early Morning,3,19,22,13.64
2011-06-29,6,Wednesday,Morning Rush,12,104,116,10.34
2011-06-29,7,Wednesday,Morning Rush,18,318,336,5.36
2011-06-29,8,Wednesday,Morning Rush,41,499,540,7.59
2011-06-29,9,Wednesday,Morning Rush,32,189,221,14.48
2011-06-29,10,Wednesday,Mid-Day,31,95,126,24.6
2011-06-29,11,Wednesday,Mid-Day,53,117,170,31.18
2011-06-29,12,Wednesday,Mid-Day,55,188,243,22.63
2011-06-29,13,Wednesday,Mid-Day,45,186,231,19.48
2011-06-29,14,Wednesday,Mid-Day,50,138,188,26.6
2011-06-29,15,Wednesday,Mid-Day,43,146,189,22.75
2011-06-29,16,Wednesday,Evening Rush,60,268,328,18.29
2011-06-29,17,Wednesday,Evening Rush,78,492,570,13.68
2011-06-29,18,Wednesday,Evening Rush,78,510,588,13.27
2011-06-29,19,Wednesday,Evening Rush,60,341,401,14.96
2011-06-29,20,Wednesday,Night,69,264,333,20.72
2011-06-29,21,Wednesday,Night,26,195,221,11.76
2011-06-29,22,Wednesday,Night,32,151,183,17.49
2011-06-29,23,Wednesday,Night,32,97,129,24.81
2011-06-30,0,Thursday,Early Morning,15,39,54,27.78
2011-06-30,1,Thursday,Early Morning,13,19,32,40.63
2011-06-30,2,Thursday,Early Morning,2,6,8,25.0
2011-06-30,3,Thursday,Early Morning,2,7,9,22.22
2011-06-30,4,Thursday,Early Morning,2,4,6,33.33
2011-06-30,5,Thursday,Early Morning,1,24,25,4.0
2011-06-30,6,Thursday,Morning Rush,4,119,123,3.25
2011-06-30,7,Thursday,Morning Rush,29,291,320,9.06
2011-06-30,8,Thursday,Morning Rush,44,511,555,7.93
2011-06-30,9,Thursday,Morning Rush,33,227,260,12.69
2011-06-30,10,Thursday,Mid-Day,35,97,132,26.52
2011-06-30,11,Thursday,Mid-Day,47,122,169,27.81
2011-06-30,12,Thursday,Mid-Day,50,183,233,21.46
2011-06-30,13,Thursday,Mid-Day,70,162,232,30.17
2011-06-30,14,Thursday,Mid-Day,46,117,163,28.22
2011-06-30,15,Thursday,Mid-Day,64,176,240,26.67
2011-06-30,16,Thursday,Evening Rush,63,260,323,19.5
2011-06-30,17,Thursday,Evening Rush,98,496,594,16.5
2011-06-30,18,Thursday,Evening Rush,114,472,586,19.45
2011-06-30,19,Thursday,Evening Rush,89,366,455,19.56
2011-06-30,20,Thursday,Night,55,285,340,16.18
2011-06-30,21,Thursday,Night,81,242,323,25.08
2011-06-30,22,Thursday,Night,43,164,207,20.77
2011-06-30,23,Thursday,Night,27,99,126,21.43
2011-07-01,0,Friday,Early Morning,20,48,68,29.41
2011-07-01,1,Friday,Early Morning,15,16,31,48.39
2011-07-01,2,Friday,Early Morning,6,7,13,46.15
2011-07-01,3,Friday,Early Morning,5,6,11,45.45
2011-07-01,4,Friday,Early Morning,1,5,6,16.67
2011-07-01,5,Friday,Early Morning,3,27,30,10.0
2011-07-01,6,Friday,Morning Rush,11,97,108,10.19
2011-07-01,7,Friday,Morning Rush,25,218,243,10.29
2011-07-01,8,Friday,Morning Rush,39,453,492,7.93
2011-07-01,9,Friday,Morning Rush,58,202,260,22.31
2011-07-01,10,Friday,Mid-Day,61,109,170,35.88
2011-07-01,11,Friday,Mid-Day,68,146,214,31.78
2011-07-01,12,Friday,Mid-Day,83,180,263,31.56
2011-07-01,13,Friday,Mid-Day,83,209,292,28.42
2011-07-01,14,Friday,Mid-Day,78,225,303,25.74
2011-07-01,15,Friday,Mid-Day,82,299,381,21.52
2011-07-01,16,Friday,Evening Rush,85,342,427,19.91
2011-07-01,17,Friday,Evening Rush,99,362,461,21.48
2011-07-01,18,Friday,Evening Rush,98,324,422,23.22
2011-07-01,19,Friday,Evening Rush,80,238,318,25.16
2011-07-01,20,Friday,Night,84,185,269,31.23
2011-07-01,21,Friday,Night,69,149,218,31.65
2011-07-01,22,Friday,Night,49,173,222,22.07
2011-07-01,23,Friday,Night,44,96,140,31.43
2011-07-02,0,Saturday,Early Morning,31,84,115,26.96
2011-07-02,1,Saturday,Early Morning,20,58,78,25.64
2011-07-02,2,Saturday,Early Morning,9,43,52,17.31
2011-07-02,3,Saturday,Early Morning,5,21,26,19.23
2011-07-02,4,Saturday,Early Morning,3,8,11,27.27
2011-07-02,5,Saturday,Early Morning,1,13,14,7.14
2011-07-02,6,Saturday,Morning Rush,11,21,32,34.38
2011-07-02,7,Saturday,Morning Rush,10,35,45,22.22
2011-07-02,8,Saturday,Morning Rush,38,94,132,28.79
2011-07-02,9,Saturday,Morning Rush,55,124,179,30.73
2011-07-02,10,Saturday,Mid-Day,103,168,271,38.01
2011-07-02,11,Saturday,Mid-Day,144,213,357,40.34
2011-07-02,12,Saturday,Mid-Day,142,232,374,37.97
2011-07-02,13,Saturday,Mid-Day,178,226,404,44.06
2011-07-02,14,Saturday,Mid-Day,177,215,392,45.15
2011-07-02,15,Saturday,Mid-Day,168,163,331,50.76
2011-07-02,16,Saturday,Evening Rush,206,192,398,51.76
2011-07-02,17,Saturday,Evening Rush,179,170,349,51.29
2011-07-02,18,Saturday,Evening Rush,193,190,383,50.39
2011-07-02,19,Saturday,Evening Rush,156,149,305,51.15
2011-07-02,20,Saturday,Night,136,148,284,47.89
2011-07-02,21,Saturday,Night,95,137,232,40.95
2011-07-02,22,Saturday,Night,78,123,201,38.81
2011-07-02,23,Saturday,Night,66,88,154,42.86
2011-07-03,0,Sunday,Early Morning,47,97,144,32.64
2011-07-03,1,Sunday,Early Morning,23,55,78,29.49
2011-07-03,2,Sunday,Early Morning,19,50,69,27.54
2011-07-03,3,Sunday,Early Morning,8,25,33,24.24
2011-07-03,4,Sunday,Early Morning,3,2,5,60.0
2011-07-03,5,Sunday,Early Morning,0,1,1,0.0
2011-07-03,6,Sunday,Morning Rush,0,3,3,0.0
2011-07-03,7,Sunday,Morning Rush,3,22,25,12.0
2011-07-03,8,Sunday,Morning Rush,39,53,92,42.39
2011-07-03,9,Sunday,Morning Rush,82,99,181,45.3
2011-07-03,10,Sunday,Mid-Day,131,133,264,49.62
2011-07-03,11,Sunday,Mid-Day,215,175,390,55.13
2011-07-03,12,Sunday,Mid-Day,198,206,404,49.01
2011-07-03,13,Sunday,Mid-Day,248,173,421,58.91
2011-07-03,14,Sunday,Mid-Day,225,150,375,60.0
2011-07-03,15,Sunday,Mid-Day,194,182,376,51.6
2011-07-03,16,Sunday,Evening Rush,195,219,414,47.1
2011-07-03,17,Sunday,Evening Rush,181,177,358,50.56
2011-07-03,18,Sunday,Evening Rush,74,107,181,40.88
2011-07-03,19,Sunday,Evening Rush,100,83,183,54.64
2011-07-03,20,Sunday,Night,83,93,176,47.16
2011-07-03,21,Sunday,Night,75,92,167,44.91
2011-07-03,22,Sunday,Night,69,93,162,42.59
2011-07-03,23,Sunday,Night,70,77,147,47.62
2011-07-04,0,Monday,Early Morning,63,77,140,45.0
2011-07-04,1,Monday,Early Morning,43,76,119,36.13
2011-07-04,2,Monday,Early Morning,33,30,63,52.38
2011-07-04,3,Monday,Early Morning,13,13,26,50.0
2011-07-04,4,Monday,Early Morning,8,4,12,66.67
2011-07-04,5,Monday,Early Morning,1,3,4,25.0
2011-07-04,6,Monday,Morning Rush,5,11,16,31.25
2011-07-04,7,Monday,Morning Rush,17,19,36,47.22
2011-07-04,8,Monday,Morning Rush,42,44,86,48.84
2011-07-04,9,Monday,Morning Rush,142,96,238,59.66
2011-07-04,10,Monday,Mid-Day,166,114,280,59.29
2011-07-04,11,Monday,Mid-Day,177,172,349,50.72
2011-07-04,12,Monday,Mid-Day,237,210,447,53.02
2011-07-04,13,Monday,Mid-Day,242,181,423,57.21
2011-07-04,14,Monday,Mid-Day,235,173,408,57.6
2011-07-04,15,Monday,Mid-Day,224,184,408,54.9
2011-07-04,16,Monday,Evening Rush,236,216,452,52.21
2011-07-04,17,Monday,Evening Rush,240,196,436,55.05
2011-07-04,18,Monday,Evening Rush,222,196,418,53.11
2011-07-04,19,Monday,Evening Rush,170,205,375,45.33
2011-07-04,20,Monday,Night,195,191,386,50.52
2011-07-04,21,Monday,Night,195,262,457,42.67
2011-07-04,22,Monday,Night,115,211,326,35.28
2011-07-04,23,Monday,Night,44,94,138,31.88
2011-07-05,0,Tuesday,Early Morning,19,36,55,34.55
2011-07-05,1,Tuesday,Early Morning,15,24,39,38.46
2011-07-05,2,Tuesday,Early Morning,8,5,13,61.54
2011-07-05,3,Tuesday,Early Morning,1,7,8,12.5
2011-07-05,4,Tuesday,Early Morning,1,4,5,20.0
2011-07-05,5,Tuesday,Early Morning,1,19,20,5.0
2011-07-05,6,Tuesday,Morning Rush,3,91,94,3.19
2011-07-05,7,Tuesday,Morning Rush,22,248,270,8.15
2011-07-05,8,Tuesday,Morning Rush,41,391,432,9.49
2011-07-05,9,Tuesday,Morning Rush,50,177,227,22.03
2011-07-05,10,Tuesday,Mid-Day,55,84,139,39.57
2011-07-05,11,Tuesday,Mid-Day,75,97,172,43.6
2011-07-05,12,Tuesday,Mid-Day,71,130,201,35.32
2011-07-05,13,Tuesday,Mid-Day,67,136,203,33.0
2011-07-05,14,Tuesday,Mid-Day,66,112,178,37.08
2011-07-05,15,Tuesday,Mid-Day,51,111,162,31.48
2011-07-05,16,Tuesday,Evening Rush,79,202,281,28.11
2011-07-05,17,Tuesday,Evening Rush,79,466,545,14.5
2011-07-05,18,Tuesday,Evening Rush,70,426,496,14.11
2011-07-05,19,Tuesday,Evening Rush,71,297,368,19.29
2011-07-05,20,Tuesday,Night,59,225,284,20.77
2011-07-05,21,Tuesday,Night,77,168,245,31.43
2011-07-05,22,Tuesday,Night,31,124,155,20.0
2011-07-05,23,Tuesday,Night,19,54,73,26.03
2011-07-06,0,Wednesday,Early Morning,11,26,37,29.73
2011-07-06,1,Wednesday,Early Morning,4,11,15,26.67
2011-07-06,2,Wednesday,Early Morning,1,4,5,20.0
2011-07-06,3,Wednesday,Early Morning,0,6,6,0.0
2011-07-06,4,Wednesday,Early Morning,0,6,6,0.0
2011-07-06,5,Wednesday,Early Morning,5,30,35,14.29
2011-07-06,6,Wednesday,Morning Rush,9,112,121,7.44
2011-07-06,7,Wednesday,Morning Rush,24,288,312,7.69
2011-07-06,8,Wednesday,Morning Rush,31,397,428,7.24
2011-07-06,9,Wednesday,Morning Rush,31,158,189,16.4
2011-07-06,10,Wednesday,Mid-Day,13,30,43,30.23
2011-07-06,11,Wednesday,Mid-Day,24,103,127,18.9
2011-07-06,12,Wednesday,Mid-Day,38,114,152,25.0
2011-07-06,13,Wednesday,Mid-Day,33,107,140,23.57
2011-07-06,14,Wednesday,Mid-Day,50,113,163,30.67
2011-07-06,15,Wednesday,Mid-Day,55,130,185,29.73
2011-07-06,16,Wednesday,Evening Rush,57,218,275,20.73
2011-07-06,17,Wednesday,Evening Rush,79,517,596,13.26
2011-07-06,18,Wednesday,Evening Rush,77,486,563,13.68
2011-07-06,19,Wednesday,Evening Rush,71,323,394,18.02
2011-07-06,20,Wednesday,Night,55,257,312,17.63
2011-07-06,21,Wednesday,Night,66,175,241,27.39
2011-07-06,22,Wednesday,Night,30,156,186,16.13
2011-07-06,23,Wednesday,Night,20,78,98,20.41
2011-07-07,0,Thursday,Early Morning,6,29,35,17.14
2011-07-07,1,Thursday,Early Morning,2,14,16,12.5
2011-07-07,2,Thursday,Early Morning,1,7,8,12.5
2011-07-07,3,Thursday,Early Morning,2,2,4,50.0
2011-07-07,4,Thursday,Early Morning,0,4,4,0.0
2011-07-07,5,Thursday,Early Morning,2,30,32,6.25
2011-07-07,6,Thursday,Morning Rush,11,107,118,9.32
2011-07-07,7,Thursday,Morning Rush,13,279,292,4.45
2011-07-07,8,Thursday,Morning Rush,28,415,443,6.32
2011-07-07,9,Thursday,Morning Rush,25,154,179,13.97
2011-07-07,10,Thursday,Mid-Day,29,72,101,28.71
2011-07-07,11,Thursday,Mid-Day,30,112,142,21.13
2011-07-07,12,Thursday,Mid-Day,32,139,171,18.71
2011-07-07,13,Thursday,Mid-Day,48,107,155,30.97
2011-07-07,14,Thursday,Mid-Day,39,121,160,24.38
2011-07-07,15,Thursday,Mid-Day,47,119,166,28.31
2011-07-07,16,Thursday,Evening Rush,47,218,265,17.74
2011-07-07,17,Thursday,Evening Rush,80,489,569,14.06
2011-07-07,18,Thursday,Evening Rush,70,492,562,12.46
2011-07-07,19,Thursday,Evening Rush,79,286,365,21.64
2011-07-07,20,Thursday,Night,61,224,285,21.4
2011-07-07,21,Thursday,Night,39,170,209,18.66
2011-07-07,22,Thursday,Night,32,150,182,17.58
2011-07-07,23,Thursday,Night,31,98,129,24.03
2011-07-08,0,Friday,Early Morning,6,41,47,12.77
2011-07-08,1,Friday,Early Morning,9,25,34,26.47
2011-07-08,2,Friday,Early Morning,10,12,22,45.45
2011-07-08,3,Friday,Early Morning,2,4,6,33.33
2011-07-08,4,Friday,Early Morning,7,4,11,63.64
2011-07-08,5,Friday,Early Morning,3,24,27,11.11
2011-07-08,6,Friday,Morning Rush,11,91,102,10.78
2011-07-08,7,Friday,Morning Rush,30,302,332,9.04
2011-07-08,8,Friday,Morning Rush,36,421,457,7.88
2011-07-08,9,Friday,Morning Rush,30,211,241,12.45
2011-07-08,10,Friday,Mid-Day,30,108,138,21.74
2011-07-08,11,Friday,Mid-Day,61,104,165,36.97
2011-07-08,12,Friday,Mid-Day,49,164,213,23.0
2011-07-08,13,Friday,Mid-Day,54,175,229,23.58
2011-07-08,14,Friday,Mid-Day,53,163,216,24.54
2011-07-08,15,Friday,Mid-Day,39,102,141,27.66
2011-07-08,16,Friday,Evening Rush,27,105,132,20.45
2011-07-08,17,Friday,Evening Rush,6,161,167,3.59
2011-07-08,18,Friday,Evening Rush,35,281,316,11.08
2011-07-08,19,Friday,Evening Rush,45,225,270,16.67
2011-07-08,20,Friday,Night,30,220,250,12.0
2011-07-08,21,Friday,Night,46,158,204,22.55
2011-07-08,22,Friday,Night,33,136,169,19.53
2011-07-08,23,Friday,Night,40,111,151,26.49
2011-07-09,0,Saturday,Early Morning,31,90,121,25.62
2011-07-09,1,Saturday,Early Morning,5,48,53,9.43
2011-07-09,2,Saturday,Early Morning,12,43,55,21.82
2011-07-09,3,Saturday,Early Morning,7,23,30,23.33
2011-07-09,4,Saturday,Early Morning,2,4,6,33.33
2011-07-09,5,Saturday,Early Morning,4,11,15,26.67
2011-07-09,6,Saturday,Morning Rush,11,27,38,28.95
2011-07-09,7,Saturday,Morning Rush,21,50,71,29.58
2011-07-09,8,Saturday,Morning Rush,68,114,182,37.36
2011-07-09,9,Saturday,Morning Rush,77,170,247,31.17
2011-07-09,10,Saturday,Mid-Day,87,177,264,32.95
2011-07-09,11,Saturday,Mid-Day,101,189,290,34.83
2011-07-09,12,Saturday,Mid-Day,145,221,366,39.62
2011-07-09,13,Saturday,Mid-Day,167,249,416,40.14
2011-07-09,14,Saturday,Mid-Day,158,215,373,42.36
2011-07-09,15,Saturday,Mid-Day,182,220,402,45.27
2011-07-09,16,Saturday,Evening Rush,171,245,416,41.11
2011-07-09,17,Saturday,Evening Rush,160,241,401,39.9
2011-07-09,18,Saturday,Evening Rush,132,246,378,34.92
2011-07-09,19,Saturday,Evening Rush,128,178,306,41.83
2011-07-09,20,Saturday,Night,129,185,314,41.08
2011-07-09,21,Saturday,Night,83,155,238,34.87
2011-07-09,22,Saturday,Night,60,154,214,28.04
2011-07-09,23,Saturday,Night,47,93,140,33.57
2011-07-10,0,Sunday,Early Morning,42,112,154,27.27
2011-07-10,1,Sunday,Early Morning,19,94,113,16.81
2011-07-10,2,Sunday,Early Morning,28,68,96,29.17
2011-07-10,3,Sunday,Early Morning,6,19,25,24.0
2011-07-10,4,Sunday,Early Morning,0,5,5,0.0
2011-07-10,5,Sunday,Early Morning,7,10,17,41.18
2011-07-10,6,Sunday,Morning Rush,8,17,25,32.0
2011-07-10,7,Sunday,Morning Rush,27,38,65,41.54
2011-07-10,8,Sunday,Morning Rush,27,65,92,29.35
2011-07-10,9,Sunday,Morning Rush,62,107,169,36.69
2011-07-10,10,Sunday,Mid-Day,95,173,268,35.45
2011-07-10,11,Sunday,Mid-Day,110,177,287,38.33
2011-07-10,12,Sunday,Mid-Day,133,244,377,35.28
2011-07-10,13,Sunday,Mid-Day,139,228,367,37.87
2011-07-10,14,Sunday,Mid-Day,122,227,349,34.96
2011-07-10,15,Sunday,Mid-Day,142,219,361,39.34
2011-07-10,16,Sunday,Evening Rush,128,244,372,34.41
2011-07-10,17,Sunday,Evening Rush,146,217,363,40.22
2011-07-10,18,Sunday,Evening Rush,141,222,363,38.84
2011-07-10,19,Sunday,Evening Rush,120,183,303,39.6
2011-07-10,20,Sunday,Night,101,167,268,37.69
2011-07-10,21,Sunday,Night,65,162,227,28.63
2011-07-10,22,Sunday,Night,56,87,143,39.16
2011-07-10,23,Sunday,Night,19,53,72,26.39
2011-07-11,0,Monday,Early Morning,10,25,35,28.57
2011-07-11,1,Monday,Early Morning,5,5,10,50.0
2011-07-11,2,Monday,Early Morning,8,4,12,66.67
2011-07-11,3,Monday,Early Morning,2,8,10,20.0
2011-07-11,4,Monday,Early Morning,0,4,4,0.0
2011-07-11,5,Monday,Early Morning,5,21,26,19.23
2011-07-11,6,Monday,Morning Rush,19,102,121,15.7
2011-07-11,7,Monday,Morning Rush,28,289,317,8.83
2011-07-11,8,Monday,Morning Rush,35,385,420,8.33
2011-07-11,9,Monday,Morning Rush,41,167,208,19.71
2011-07-11,10,Monday,Mid-Day,44,73,117,37.61
2011-07-11,11,Monday,Mid-Day,39,89,128,30.47
2011-07-11,12,Monday,Mid-Day,40,108,148,27.03
2011-07-11,13,Monday,Mid-Day,22,119,141,15.6
2011-07-11,14,Monday,Mid-Day,40,94,134,29.85
2011-07-11,15,Monday,Mid-Day,38,108,146,26.03
2011-07-11,16,Monday,Evening Rush,57,182,239,23.85
2011-07-11,17,Monday,Evening Rush,59,455,514,11.48
2011-07-11,18,Monday,Evening Rush,57,415,472,12.08
2011-07-11,19,Monday,Evening Rush,80,293,373,21.45
2011-07-11,20,Monday,Night,42,194,236,17.8
2011-07-11,21,Monday,Night,21,109,130,16.15
2011-07-11,22,Monday,Night,20,70,90,22.22
2011-07-11,23,Monday,Night,11,44,55,20.0
2011-07-12,0,Tuesday,Early Morning,3,19,22,13.64
2011-07-12,1,Tuesday,Early Morning,6,8,14,42.86
2011-07-12,2,Tuesday,Early Morning,2,7,9,22.22
2011-07-12,3,Tuesday,Early Morning,2,6,8,25.0
2011-07-12,4,Tuesday,Early Morning,0,6,6,0.0
2011-07-12,5,Tuesday,Early Morning,4,21,25,16.0
2011-07-12,6,Tuesday,Morning Rush,13,102,115,11.3
2011-07-12,7,Tuesday,Morning Rush,29,301,330,8.79
2011-07-12,8,Tuesday,Morning Rush,35,382,417,8.39
2011-07-12,9,Tuesday,Morning Rush,27,149,176,15.34
2011-07-12,10,Tuesday,Mid-Day,38,85,123,30.89
2011-07-12,11,Tuesday,Mid-Day,39,86,125,31.2
2011-07-12,12,Tuesday,Mid-Day,38,125,163,23.31
2011-07-12,13,Tuesday,Mid-Day,32,104,136,23.53
2011-07-12,14,Tuesday,Mid-Day,33,91,124,26.61
2011-07-12,15,Tuesday,Mid-Day,37,111,148,25.0
2011-07-12,16,Tuesday,Evening Rush,25,177,202,12.38
2011-07-12,17,Tuesday,Evening Rush,48,380,428,11.21
2011-07-12,18,Tuesday,Evening Rush,39,472,511,7.63
2011-07-12,19,Tuesday,Evening Rush,42,295,337,12.46
2011-07-12,20,Tuesday,Night,57,251,308,18.51
2011-07-12,21,Tuesday,Night,49,209,258,18.99
2011-07-12,22,Tuesday,Night,44,150,194,22.68
2011-07-12,23,Tuesday,Night,20,59,79,25.32
2011-07-13,0,Wednesday,Early Morning,9,37,46,19.57
2011-07-13,1,Wednesday,Early Morning,1,11,12,8.33
2011-07-13,2,Wednesday,Early Morning,2,3,5,40.0
2011-07-13,3,Wednesday,Early Morning,0,4,4,0.0
2011-07-13,4,Wednesday,Early Morning,0,5,5,0.0
2011-07-13,5,Wednesday,Early Morning,4,22,26,15.38
2011-07-13,6,Wednesday,Morning Rush,18,103,121,14.88
2011-07-13,7,Wednesday,Morning Rush,32,281,313,10.22
2011-07-13,8,Wednesday,Morning Rush,31,418,449,6.9
2011-07-13,9,Wednesday,Morning Rush,23,163,186,12.37
2011-07-13,10,Wednesday,Mid-Day,33,80,113,29.2
2011-07-13,11,Wednesday,Mid-Day,55,110,165,33.33
2011-07-13,12,Wednesday,Mid-Day,40,134,174,22.99
2011-07-13,13,Wednesday,Mid-Day,39,119,158,24.68
2011-07-13,14,Wednesday,Mid-Day,27,89,116,23.28
2011-07-13,15,Wednesday,Mid-Day,13,33,46,28.26
2011-07-13,16,Wednesday,Evening Rush,23,118,141,16.31
2011-07-13,17,Wednesday,Evening Rush,70,418,488,14.34
2011-07-13,18,Wednesday,Evening Rush,51,412,463,11.02
2011-07-13,19,Wednesday,Evening Rush,79,340,419,18.85
2011-07-13,20,Wednesday,Night,61,281,342,17.84
2011-07-13,21,Wednesday,Night,56,194,250,22.4
2011-07-13,22,Wednesday,Night,48,136,184,26.09
2011-07-13,23,Wednesday,Night,33,83,116,28.45
2011-07-14,0,Thursday,Early Morning,14,32,46,30.43
2011-07-14,1,Thursday,Early Morning,4,21,25,16.0
2011-07-14,2,Thursday,Early Morning,3,7,10,30.0
2011-07-14,3,Thursday,Early Morning,1,5,6,16.67
2011-07-14,4,Thursday,Early Morning,0,6,6,0.0
2011-07-14,5,Thursday,Early Morning,6,22,28,21.43
2011-07-14,6,Thursday,Morning Rush,14,116,130,10.77
2011-07-14,7,Thursday,Morning Rush,23,311,334,6.89
2011-07-14,8,Thursday,Morning Rush,53,433,486,10.91
2011-07-14,9,Thursday,Morning Rush,29,195,224,12.95
2011-07-14,10,Thursday,Mid-Day,32,95,127,25.2
2011-07-14,11,Thursday,Mid-Day,38,110,148,25.68
2011-07-14,12,Thursday,Mid-Day,51,172,223,22.87
2011-07-14,13,Thursday,Mid-Day,39,138,177,22.03
2011-07-14,14,Thursday,Mid-Day,49,129,178,27.53
2011-07-14,15,Thursday,Mid-Day,42,138,180,23.33
2011-07-14,16,Thursday,Evening Rush,43,231,274,15.69
2011-07-14,17,Thursday,Evening Rush,78,517,595,13.11
2011-07-14,18,Thursday,Evening Rush,94,484,578,16.26
2011-07-14,19,Thursday,Evening Rush,67,333,400,16.75
2011-07-14,20,Thursday,Night,81,267,348,23.28
2011-07-14,21,Thursday,Night,58,203,261,22.22
2011-07-14,22,Thursday,Night,42,134,176,23.86
2011-07-14,23,Thursday,Night,27,97,124,21.77
2011-07-15,0,Friday,Early Morning,23,57,80,28.75
2011-07-15,1,Friday,Early Morning,7,13,20,35.0
2011-07-15,2,Friday,Early Morning,16,22,38,42.11
2011-07-15,3,Friday,Early Morning,1,6,7,14.29
2011-07-15,4,Friday,Early Morning,2,8,10,20.0
2011-07-15,5,Friday,Early Morning,7,16,23,30.43
2011-07-15,6,Friday,Morning Rush,12,108,120,10.0
2011-07-15,7,Friday,Morning Rush,17,257,274,6.2
2011-07-15,8,Friday,Morning Rush,50,514,564,8.87
2011-07-15,9,Friday,Morning Rush,31,176,207,14.98
2011-07-15,10,Friday,Mid-Day,59,107,166,35.54
2011-07-15,11,Friday,Mid-Day,73,137,210,34.76
2011-07-15,12,Friday,Mid-Day,61,177,238,25.63
2011-07-15,13,Friday,Mid-Day,85,162,247,34.41
2011-07-15,14,Friday,Mid-Day,105,160,265,39.62
2011-07-15,15,Friday,Mid-Day,74,163,237,31.22
2011-07-15,16,Friday,Evening Rush,96,265,361,26.59
2011-07-15,17,Friday,Evening Rush,104,483,587,17.72
2011-07-15,18,Friday,Evening Rush,102,394,496,20.56
2011-07-15,19,Friday,Evening Rush,114,280,394,28.93
2011-07-15,20,Friday,Night,92,251,343,26.82
2011-07-15,21,Friday,Night,75,186,261,28.74
2011-07-15,22,Friday,Night,71,152,223,31.84
2011-07-15,23,Friday,Night,41,126,167,24.55
2011-07-16,0,Saturday,Early Morning,42,68,110,38.18
2011-07-16,1,Saturday,Early Morning,24,51,75,32.0
2011-07-16,2,Saturday,Early Morning,10,48,58,17.24
2011-07-16,3,Saturday,Early Morning,6,20,26,23.08
2011-07-16,4,Saturday,Early Morning,9,7,16,56.25
2011-07-16,5,Saturday,Early Morning,4,6,10,40.0
2011-07-16,6,Saturday,Morning Rush,16,21,37,43.24
2011-07-16,7,Saturday,Morning Rush,14,38,52,26.92
2011-07-16,8,Saturday,Morning Rush,37,90,127,29.13
2011-07-16,9,Saturday,Morning Rush,72,150,222,32.43
2011-07-16,10,Saturday,Mid-Day,114,208,322,35.4
2011-07-16,11,Saturday,Mid-Day,171,225,396,43.18
2011-07-16,12,Saturday,Mid-Day,187,276,463,40.39
2011-07-16,13,Saturday,Mid-Day,221,276,497,44.47
2011-07-16,14,Saturday,Mid-Day,201,232,433,46.42
2011-07-16,15,Saturday,Mid-Day,205,223,428,47.9
2011-07-16,16,Saturday,Evening Rush,183,242,425,43.06
2011-07-16,17,Saturday,Evening Rush,234,241,475,49.26
2011-07-16,18,Saturday,Evening Rush,185,243,428,43.22
2011-07-16,19,Saturday,Evening Rush,164,242,406,40.39
2011-07-16,20,Saturday,Night,108,188,296,36.49
2011-07-16,21,Saturday,Night,85,167,252,33.73
2011-07-16,22,Saturday,Night,65,136,201,32.34
2011-07-16,23,Saturday,Night,61,107,168,36.31
2011-07-17,0,Sunday,Early Morning,34,91,125,27.2
2011-07-17,1,Sunday,Early Morning,16,86,102,15.69
2011-07-17,2,Sunday,Early Morning,28,66,94,29.79
2011-07-17,3,Sunday,Early Morning,21,26,47,44.68
2011-07-17,4,Sunday,Early Morning,4,6,10,40.0
2011-07-17,5,Sunday,Early Morning,4,8,12,33.33
2011-07-17,6,Sunday,Morning Rush,10,11,21,47.62
2011-07-17,7,Sunday,Morning Rush,20,30,50,40.0
2011-07-17,8,Sunday,Morning Rush,45,73,118,38.14
2011-07-17,9,Sunday,Morning Rush,74,110,184,40.22
2011-07-17,10,Sunday,Mid-Day,127,177,304,41.78
2011-07-17,11,Sunday,Mid-Day,147,244,391,37.6
2011-07-17,12,Sunday,Mid-Day,177,243,420,42.14
2011-07-17,13,Sunday,Mid-Day,200,272,472,42.37
2011-07-17,14,Sunday,Mid-Day,168,262,430,39.07
2011-07-17,15,Sunday,Mid-Day,129,195,324,39.81
2011-07-17,16,Sunday,Evening Rush,129,188,317,40.69
2011-07-17,17,Sunday,Evening Rush,133,236,369,36.04
2011-07-17,18,Sunday,Evening Rush,147,243,390,37.69
2011-07-17,19,Sunday,Evening Rush,145,234,379,38.26
2011-07-17,20,Sunday,Night,85,177,262,32.44
2011-07-17,21,Sunday,Night,59,148,207,28.5
2011-07-17,22,Sunday,Night,65,116,181,35.91
2011-07-17,23,Sunday,Night,39,54,93,41.94
2011-07-18,0,Monday,Early Morning,21,30,51,41.18
2011-07-18,1,Monday,Early Morning,17,8,25,68.0
2011-07-18,2,Monday,Early Morning,2,8,10,20.0
2011-07-18,3,Monday,Early Morning,3,4,7,42.86
2011-07-18,4,Monday,Early Morning,1,3,4,25.0
2011-07-18,5,Monday,Early Morning,2,15,17,11.76
2011-07-18,6,Monday,Morning Rush,10,95,105,9.52
2011-07-18,7,Monday,Morning Rush,22,255,277,7.94
2011-07-18,8,Monday,Morning Rush,18,329,347,5.19
2011-07-18,9,Monday,Morning Rush,33,170,203,16.26
2011-07-18,10,Monday,Mid-Day,52,78,130,40.0
2011-07-18,11,Monday,Mid-Day,42,99,141,29.79
2011-07-18,12,Monday,Mid-Day,39,126,165,23.64
2011-07-18,13,Monday,Mid-Day,27,125,152,17.76
2011-07-18,14,Monday,Mid-Day,32,106,138,23.19
2011-07-18,15,Monday,Mid-Day,53,111,164,32.32
2011-07-18,16,Monday,Evening Rush,45,220,265,16.98
2011-07-18,17,Monday,Evening Rush,72,473,545,13.21
2011-07-18,18,Monday,Evening Rush,80,478,558,14.34
2011-07-18,19,Monday,Evening Rush,63,335,398,15.83
2011-07-18,20,Monday,Night,91,232,323,28.17
2011-07-18,21,Monday,Night,48,154,202,23.76
2011-07-18,22,Monday,Night,36,104,140,25.71
2011-07-18,23,Monday,Night,32,59,91,35.16
2011-07-19,0,Tuesday,Early Morning,25,26,51,49.02
2011-07-19,1,Tuesday,Early Morning,7,6,13,53.85
2011-07-19,2,Tuesday,Early Morning,9,4,13,69.23
2011-07-19,3,Tuesday,Early Morning,2,1,3,66.67
2011-07-19,4,Tuesday,Early Morning,1,4,5,20.0
2011-07-19,5,Tuesday,Early Morning,0,19,19,0.0
2011-07-19,6,Tuesday,Morning Rush,8,126,134,5.97
2011-07-19,7,Tuesday,Morning Rush,28,287,315,8.89
2011-07-19,8,Tuesday,Morning Rush,31,381,412,7.52
2011-07-19,9,Tuesday,Morning Rush,22,177,199,11.06
2011-07-19,10,Tuesday,Mid-Day,29,112,141,20.57
2011-07-19,11,Tuesday,Mid-Day,29,98,127,22.83
2011-07-19,12,Tuesday,Mid-Day,26,127,153,16.99
2011-07-19,13,Tuesday,Mid-Day,33,139,172,19.19
2011-07-19,14,Tuesday,Mid-Day,41,111,152,26.97
2011-07-19,15,Tuesday,Mid-Day,48,110,158,30.38
2011-07-19,16,Tuesday,Evening Rush,61,216,277,22.02
2011-07-19,17,Tuesday,Evening Rush,68,445,513,13.26
2011-07-19,18,Tuesday,Evening Rush,80,450,530,15.09
2011-07-19,19,Tuesday,Evening Rush,54,334,388,13.92
2011-07-19,20,Tuesday,Night,48,229,277,17.33
2011-07-19,21,Tuesday,Night,47,194,241,19.5
2011-07-19,22,Tuesday,Night,36,120,156,23.08
2011-07-19,23,Tuesday,Night,19,73,92,20.65
2011-07-20,0,Wednesday,Early Morning,11,29,40,27.5
2011-07-20,1,Wednesday,Early Morning,4,7,11,36.36
2011-07-20,2,Wednesday,Early Morning,2,7,9,22.22
2011-07-20,3,Wednesday,Early Morning,2,4,6,33.33
2011-07-20,4,Wednesday,Early Morning,0,4,4,0.0
2011-07-20,5,Wednesday,Early Morning,4,19,23,17.39
2011-07-20,6,Wednesday,Morning Rush,5,111,116,4.31
2011-07-20,7,Wednesday,Morning Rush,27,276,303,8.91
2011-07-20,8,Wednesday,Morning Rush,34,404,438,7.76
2011-07-20,9,Wednesday,Morning Rush,28,181,209,13.4
2011-07-20,10,Wednesday,Mid-Day,34,76,110,30.91
2011-07-20,11,Wednesday,Mid-Day,26,116,142,18.31
2011-07-20,12,Wednesday,Mid-Day,28,121,149,18.79
2011-07-20,13,Wednesday,Mid-Day,23,97,120,19.17
2011-07-20,14,Wednesday,Mid-Day,44,83,127,34.65
2011-07-20,15,Wednesday,Mid-Day,36,102,138,26.09
2011-07-20,16,Wednesday,Evening Rush,30,204,234,12.82
2011-07-20,17,Wednesday,Evening Rush,50,405,455,10.99
2011-07-20,18,Wednesday,Evening Rush,68,429,497,13.68
2011-07-20,19,Wednesday,Evening Rush,59,323,382,15.45
2011-07-20,20,Wednesday,Night,45,264,309,14.56
2011-07-20,21,Wednesday,Night,33,209,242,13.64
2011-07-20,22,Wednesday,Night,25,144,169,14.79
2011-07-20,23,Wednesday,Night,26,73,99,26.26
2011-07-21,0,Thursday,Early Morning,13,29,42,30.95
2011-07-21,1,Thursday,Early Morning,5,16,21,23.81
2011-07-21,2,Thursday,Early Morning,2,4,6,33.33
2011-07-21,3,Thursday,Early Morning,1,5,6,16.67
2011-07-21,4,Thursday,Early Morning,0,4,4,0.0
2011-07-21,5,Thursday,Early Morning,2,16,18,11.11
2011-07-21,6,Thursday,Morning Rush,6,111,117,5.13
2011-07-21,7,Thursday,Morning Rush,23,251,274,8.39
2011-07-21,8,Thursday,Morning Rush,23,358,381,6.04
2011-07-21,9,Thursday,Morning Rush,34,166,200,17.0
2011-07-21,10,Thursday,Mid-Day,31,47,78,39.74
2011-07-21,11,Thursday,Mid-Day,27,79,106,25.47
2011-07-21,12,Thursday,Mid-Day,29,106,135,21.48
2011-07-21,13,Thursday,Mid-Day,21,81,102,20.59
2011-07-21,14,Thursday,Mid-Day,50,97,147,34.01
2011-07-21,15,Thursday,Mid-Day,40,93,133,30.08
2011-07-21,16,Thursday,Evening Rush,43,167,210,20.48
2011-07-21,17,Thursday,Evening Rush,40,374,414,9.66
2011-07-21,18,Thursday,Evening Rush,39,343,382,10.21
2011-07-21,19,Thursday,Evening Rush,51,233,284,17.96
2011-07-21,20,Thursday,Night,38,199,237,16.03
2011-07-21,21,Thursday,Night,38,187,225,16.89
2011-07-21,22,Thursday,Night,36,113,149,24.16
2011-07-21,23,Thursday,Night,40,73,113,35.4
2011-07-22,0,Friday,Early Morning,9,51,60,15.0
2011-07-22,1,Friday,Early Morning,7,17,24,29.17
2011-07-22,2,Friday,Early Morning,0,14,14,0.0
2011-07-22,3,Friday,Early Morning,1,6,7,14.29
2011-07-22,4,Friday,Early Morning,8,5,13,61.54
2011-07-22,5,Friday,Early Morning,2,17,19,10.53
2011-07-22,6,Friday,Morning Rush,13,83,96,13.54
2011-07-22,7,Friday,Morning Rush,20,232,252,7.94
2011-07-22,8,Friday,Morning Rush,30,292,322,9.32
2011-07-22,9,Friday,Morning Rush,31,177,208,14.9
2011-07-22,10,Friday,Mid-Day,32,83,115,27.83
2011-07-22,11,Friday,Mid-Day,23,86,109,21.1
2011-07-22,12,Friday,Mid-Day,20,95,115,17.39
2011-07-22,13,Friday,Mid-Day,25,98,123,20.33
2011-07-22,14,Friday,Mid-Day,24,77,101,23.76
2011-07-22,15,Friday,Mid-Day,32,101,133,24.06
2011-07-22,16,Friday,Evening Rush,29,153,182,15.93
2011-07-22,17,Friday,Evening Rush,35,271,306,11.44
2011-07-22,18,Friday,Evening Rush,34,250,284,11.97
2011-07-22,19,Friday,Evening Rush,40,210,250,16.0
2011-07-22,20,Friday,Night,46,166,212,21.7
2011-07-22,21,Friday,Night,38,152,190,20.0
2011-07-22,22,Friday,Night,44,105,149,29.53
2011-07-22,23,Friday,Night,19,84,103,18.45
2011-07-23,0,Saturday,Early Morning,16,85,101,15.84
2011-07-23,1,Saturday,Early Morning,13,57,70,18.57
2011-07-23,2,Saturday,Early Morning,13,48,61,21.31
2011-07-23,3,Saturday,Early Morning,6,16,22,27.27
2011-07-23,4,Saturday,Early Morning,5,4,9,55.56
2011-07-23,5,Saturday,Early Morning,1,6,7,14.29
2011-07-23,6,Saturday,Morning Rush,6,19,25,24.0
2011-07-23,7,Saturday,Morning Rush,7,38,45,15.56
2011-07-23,8,Saturday,Morning Rush,24,85,109,22.02
2011-07-23,9,Saturday,Morning Rush,30,102,132,22.73
2011-07-23,10,Saturday,Mid-Day,61,137,198,30.81
2011-07-23,11,Saturday,Mid-Day,62,154,216,28.7
2011-07-23,12,Saturday,Mid-Day,71,164,235,30.21
2011-07-23,13,Saturday,Mid-Day,78,167,245,31.84
2011-07-23,14,Saturday,Mid-Day,84,152,236,35.59
2011-07-23,15,Saturday,Mid-Day,78,137,215,36.28
2011-07-23,16,Saturday,Evening Rush,70,151,221,31.67
2011-07-23,17,Saturday,Evening Rush,70,127,197,35.53
2011-07-23,18,Saturday,Evening Rush,62,134,196,31.63
2011-07-23,19,Saturday,Evening Rush,80,137,217,36.87
2011-07-23,20,Saturday,Night,47,98,145,32.41
2011-07-23,21,Saturday,Night,39,115,154,25.32
2011-07-23,22,Saturday,Night,37,88,125,29.6
2011-07-23,23,Saturday,Night,27,77,104,25.96
2011-07-24,0,Sunday,Early Morning,42,77,119,35.29
2011-07-24,1,Sunday,Early Morning,33,63,96,34.38
2011-07-24,2,Sunday,Early Morning,12,48,60,20.0
2011-07-24,3,Sunday,Early Morning,17,20,37,45.95
2011-07-24,4,Sunday,Early Morning,1,5,6,16.67
2011-07-24,5,Sunday,Early Morning,5,3,8,62.5
2011-07-24,6,Sunday,Morning Rush,9,13,22,40.91
2011-07-24,7,Sunday,Morning Rush,6,29,35,17.14
2011-07-24,8,Sunday,Morning Rush,22,82,104,21.15
2011-07-24,9,Sunday,Morning Rush,42,112,154,27.27
2011-07-24,10,Sunday,Mid-Day,61,165,226,26.99
2011-07-24,11,Sunday,Mid-Day,74,169,243,30.45
2011-07-24,12,Sunday,Mid-Day,85,161,246,34.55
2011-07-24,13,Sunday,Mid-Day,90,162,252,35.71
2011-07-24,14,Sunday,Mid-Day,79,204,283,27.92
2011-07-24,15,Sunday,Mid-Day,68,170,238,28.57
2011-07-24,16,Sunday,Evening Rush,62,187,249,24.9
2011-07-24,17,Sunday,Evening Rush,75,174,249,30.12
2011-07-24,18,Sunday,Evening Rush,67,176,243,27.57
2011-07-24,19,Sunday,Evening Rush,70,170,240,29.17
2011-07-24,20,Sunday,Night,52,143,195,26.67
2011-07-24,21,Sunday,Night,42,111,153,27.45
2011-07-24,22,Sunday,Night,23,75,98,23.47
2011-07-24,23,Sunday,Night,13,37,50,26.0
2011-07-25,0,Monday,Early Morning,17,17,34,50.0
2011-07-25,1,Monday,Early Morning,4,8,12,33.33
2011-07-25,2,Monday,Early Morning,3,3,6,50.0
2011-07-25,3,Monday,Early Morning,2,2,4,50.0
2011-07-25,4,Monday,Early Morning,0,6,6,0.0
2011-07-25,5,Monday,Early Morning,2,22,24,8.33
2011-07-25,6,Monday,Morning Rush,7,100,107,6.54
2011-07-25,7,Monday,Morning Rush,20,257,277,7.22
2011-07-25,8,Monday,Morning Rush,34,353,387,8.79
2011-07-25,9,Monday,Morning Rush,11,124,135,8.15
2011-07-25,10,Monday,Mid-Day,30,54,84,35.71
2011-07-25,11,Monday,Mid-Day,24,83,107,22.43
2011-07-25,12,Monday,Mid-Day,17,50,67,25.37
2011-07-25,13,Monday,Mid-Day,14,64,78,17.95
2011-07-25,14,Monday,Mid-Day,28,62,90,31.11
2011-07-25,15,Monday,Mid-Day,16,96,112,14.29
2011-07-25,16,Monday,Evening Rush,37,161,198,18.69
2011-07-25,17,Monday,Evening Rush,48,437,485,9.9
2011-07-25,18,Monday,Evening Rush,60,473,533,11.26
2011-07-25,19,Monday,Evening Rush,62,324,386,16.06
2011-07-25,20,Monday,Night,55,247,302,18.21
2011-07-25,21,Monday,Night,41,153,194,21.13
2011-07-25,22,Monday,Night,13,112,125,10.4
2011-07-25,23,Monday,Night,23,64,87,26.44
2011-07-26,0,Tuesday,Early Morning,8,20,28,28.57
2011-07-26,1,Tuesday,Early Morning,6,6,12,50.0
2011-07-26,2,Tuesday,Early Morning,1,6,7,14.29
2011-07-26,3,Tuesday,Early Morning,2,2,4,50.0
2011-07-26,4,Tuesday,Early Morning,0,6,6,0.0
2011-07-26,5,Tuesday,Early Morning,3,24,27,11.11
2011-07-26,6,Tuesday,Morning Rush,2,108,110,1.82
2011-07-26,7,Tuesday,Morning Rush,30,288,318,9.43
2011-07-26,8,Tuesday,Morning Rush,32,392,424,7.55
2011-07-26,9,Tuesday,Morning Rush,25,162,187,13.37
2011-07-26,10,Tuesday,Mid-Day,42,96,138,30.43
2011-07-26,11,Tuesday,Mid-Day,49,102,151,32.45
2011-07-26,12,Tuesday,Mid-Day,25,122,147,17.01
2011-07-26,13,Tuesday,Mid-Day,43,139,182,23.63
2011-07-26,14,Tuesday,Mid-Day,46,101,147,31.29
2011-07-26,15,Tuesday,Mid-Day,49,114,163,30.06
2011-07-26,16,Tuesday,Evening Rush,41,213,254,16.14
2011-07-26,17,Tuesday,Evening Rush,72,465,537,13.41
2011-07-26,18,Tuesday,Evening Rush,68,478,546,12.45
2011-07-26,19,Tuesday,Evening Rush,69,329,398,17.34
2011-07-26,20,Tuesday,Night,47,243,290,16.21
2011-07-26,21,Tuesday,Night,45,222,267,16.85
2011-07-26,22,Tuesday,Night,27,131,158,17.09
2011-07-26,23,Tuesday,Night,18,71,89,20.22
2011-07-27,0,Wednesday,Early Morning,19,26,45,42.22
2011-07-27,1,Wednesday,Early Morning,1,9,10,10.0
2011-07-27,2,Wednesday,Early Morning,1,5,6,16.67
2011-07-27,3,Wednesday,Early Morning,0,4,4,0.0
2011-07-27,4,Wednesday,Early Morning,1,3,4,25.0
2011-07-27,5,Wednesday,Early Morning,0,18,18,0.0
2011-07-27,6,Wednesday,Morning Rush,4,119,123,3.25
2011-07-27,7,Wednesday,Morning Rush,34,313,347,9.8
2011-07-27,8,Wednesday,Morning Rush,28,405,433,6.47
2011-07-27,9,Wednesday,Morning Rush,27,189,216,12.5
2011-07-27,10,Wednesday,Mid-Day,32,82,114,28.07
2011-07-27,11,Wednesday,Mid-Day,42,94,136,30.88
2011-07-27,12,Wednesday,Mid-Day,37,132,169,21.89
2011-07-27,13,Wednesday,Mid-Day,29,151,180,16.11
2011-07-27,14,Wednesday,Mid-Day,20,107,127,15.75
2011-07-27,15,Wednesday,Mid-Day,37,103,140,26.43
2011-07-27,16,Wednesday,Evening Rush,40,228,268,14.93
2011-07-27,17,Wednesday,Evening Rush,81,491,572,14.16
2011-07-27,18,Wednesday,Evening Rush,78,463,541,14.42
2011-07-27,19,Wednesday,Evening Rush,87,288,375,23.2
2011-07-27,20,Wednesday,Night,55,239,294,18.71
2011-07-27,21,Wednesday,Night,49,196,245,20.0
2011-07-27,22,Wednesday,Night,37,143,180,20.56
2011-07-27,23,Wednesday,Night,16,93,109,14.68
2011-07-28,0,Thursday,Early Morning,14,31,45,31.11
2011-07-28,1,Thursday,Early Morning,3,26,29,10.34
2011-07-28,2,Thursday,Early Morning,2,5,7,28.57
2011-07-28,3,Thursday,Early Morning,0,5,5,0.0
2011-07-28,4,Thursday,Early Morning,0,6,6,0.0
2011-07-28,5,Thursday,Early Morning,1,26,27,3.7
2011-07-28,6,Thursday,Morning Rush,6,110,116,5.17
2011-07-28,7,Thursday,Morning Rush,27,278,305,8.85
2011-07-28,8,Thursday,Morning Rush,47,409,456,10.31
2011-07-28,9,Thursday,Morning Rush,21,189,210,10.0
2011-07-28,10,Thursday,Mid-Day,30,86,116,25.86
2011-07-28,11,Thursday,Mid-Day,41,113,154,26.62
2011-07-28,12,Thursday,Mid-Day,35,151,186,18.82
2011-07-28,13,Thursday,Mid-Day,26,126,152,17.11
2011-07-28,14,Thursday,Mid-Day,27,111,138,19.57
2011-07-28,15,Thursday,Mid-Day,22,124,146,15.07
2011-07-28,16,Thursday,Evening Rush,42,214,256,16.41
2011-07-28,17,Thursday,Evening Rush,45,423,468,9.62
2011-07-28,18,Thursday,Evening Rush,55,428,483,11.39
2011-07-28,19,Thursday,Evening Rush,37,285,322,11.49
2011-07-28,20,Thursday,Night,41,229,270,15.19
2011-07-28,21,Thursday,Night,31,165,196,15.82
2011-07-28,22,Thursday,Night,25,149,174,14.37
2011-07-28,23,Thursday,Night,28,95,123,22.76
2011-07-29,0,Friday,Early Morning,12,45,57,21.05
2011-07-29,1,Friday,Early Morning,12,22,34,35.29
2011-07-29,2,Friday,Early Morning,3,10,13,23.08
2011-07-29,3,Friday,Early Morning,2,9,11,18.18
2011-07-29,4,Friday,Early Morning,2,4,6,33.33
2011-07-29,5,Friday,Early Morning,4,23,27,14.81
2011-07-29,6,Friday,Morning Rush,7,83,90,7.78
2011-07-29,7,Friday,Morning Rush,26,228,254,10.24
2011-07-29,8,Friday,Morning Rush,30,354,384,7.81
2011-07-29,9,Friday,Morning Rush,28,151,179,15.64
2011-07-29,10,Friday,Mid-Day,37,69,106,34.91
2011-07-29,11,Friday,Mid-Day,43,118,161,26.71
2011-07-29,12,Friday,Mid-Day,40,95,135,29.63
2011-07-29,13,Friday,Mid-Day,42,114,156,26.92
2011-07-29,14,Friday,Mid-Day,34,114,148,22.97
2011-07-29,15,Friday,Mid-Day,40,129,169,23.67
2011-07-29,16,Friday,Evening Rush,35,198,233,15.02
2011-07-29,17,Friday,Evening Rush,47,374,421,11.16
2011-07-29,18,Friday,Evening Rush,49,313,362,13.54
2011-07-29,19,Friday,Evening Rush,22,219,241,9.13
2011-07-29,20,Friday,Night,53,153,206,25.73
2011-07-29,21,Friday,Night,29,134,163,17.79
2011-07-29,22,Friday,Night,47,127,174,27.01
2011-07-29,23,Friday,Night,26,90,116,22.41
2011-07-30,0,Saturday,Early Morning,60,73,133,45.11
2011-07-30,1,Saturday,Early Morning,15,75,90,16.67
2011-07-30,2,Saturday,Early Morning,11,31,42,26.19
2011-07-30,3,Saturday,Early Morning,18,25,43,41.86
2011-07-30,4,Saturday,Early Morning,4,6,10,40.0
2011-07-30,5,Saturday,Early Morning,4,9,13,30.77
2011-07-30,6,Saturday,Morning Rush,6,18,24,25.0
2011-07-30,7,Saturday,Morning Rush,3,39,42,7.14
2011-07-30,8,Saturday,Morning Rush,27,87,114,23.68
2011-07-30,9,Saturday,Morning Rush,49,125,174,28.16
2011-07-30,10,Saturday,Mid-Day,79,182,261,30.27
2011-07-30,11,Saturday,Mid-Day,111,206,317,35.02
2011-07-30,12,Saturday,Mid-Day,111,230,341,32.55
2011-07-30,13,Saturday,Mid-Day,125,183,308,40.58
2011-07-30,14,Saturday,Mid-Day,112,193,305,36.72
2011-07-30,15,Saturday,Mid-Day,113,189,302,37.42
2011-07-30,16,Saturday,Evening Rush,126,176,302,41.72
2011-07-30,17,Saturday,Evening Rush,93,209,302,30.79
2011-07-30,18,Saturday,Evening Rush,92,207,299,30.77
2011-07-30,19,Saturday,Evening Rush,101,155,256,39.45
2011-07-30,20,Saturday,Night,74,132,206,35.92
2011-07-30,21,Saturday,Night,82,123,205,40.0
2011-07-30,22,Saturday,Night,80,129,209,38.28
2011-07-30,23,Saturday,Night,63,114,177,35.59
2011-07-31,0,Sunday,Early Morning,33,80,113,29.2
2011-07-31,1,Sunday,Early Morning,8,71,79,10.13
2011-07-31,2,Sunday,Early Morning,19,48,67,28.36
2011-07-31,3,Sunday,Early Morning,24,26,50,48.0
2011-07-31,4,Sunday,Early Morning,6,7,13,46.15
2011-07-31,5,Sunday,Early Morning,4,4,8,50.0
2011-07-31,6,Sunday,Morning Rush,5,8,13,38.46
2011-07-31,7,Sunday,Morning Rush,19,26,45,42.22
2011-07-31,8,Sunday,Morning Rush,54,88,142,38.03
2011-07-31,9,Sunday,Morning Rush,55,128,183,30.05
2011-07-31,10,Sunday,Mid-Day,91,163,254,35.83
2011-07-31,11,Sunday,Mid-Day,112,163,275,40.73
2011-07-31,12,Sunday,Mid-Day,146,192,338,43.2
2011-07-31,13,Sunday,Mid-Day,142,152,294,48.3
2011-07-31,14,Sunday,Mid-Day,130,196,326,39.88
2011-07-31,15,Sunday,Mid-Day,109,184,293,37.2
2011-07-31,16,Sunday,Evening Rush,98,208,306,32.03
2011-07-31,17,Sunday,Evening Rush,114,206,320,35.63
2011-07-31,18,Sunday,Evening Rush,91,213,304,29.93
2011-07-31,19,Sunday,Evening Rush,87,187,274,31.75
2011-07-31,20,Sunday,Night,70,205,275,25.45
2011-07-31,21,Sunday,Night,68,96,164,41.46
2011-07-31,22,Sunday,Night,25,71,96,26.04
2011-07-31,23,Sunday,Night,14,56,70,20.0
2011-08-01,0,Monday,Early Morning,7,22,29,24.14
2011-08-01,1,Monday,Early Morning,5,12,17,29.41
2011-08-01,2,Monday,Early Morning,4,7,11,36.36
2011-08-01,3,Monday,Early Morning,0,4,4,0.0
2011-08-01,4,Monday,Early Morning,2,2,4,50.0
2011-08-01,5,Monday,Early Morning,2,24,26,7.69
2011-08-01,6,Monday,Morning Rush,3,97,100,3.0
2011-08-01,7,Monday,Morning Rush,24,258,282,8.51
2011-08-01,8,Monday,Morning Rush,35,347,382,9.16
2011-08-01,9,Monday,Morning Rush,27,139,166,16.27
2011-08-01,10,Monday,Mid-Day,27,70,97,27.84
2011-08-01,11,Monday,Mid-Day,53,66,119,44.54
2011-08-01,12,Monday,Mid-Day,53,115,168,31.55
2011-08-01,13,Monday,Mid-Day,38,112,150,25.33
2011-08-01,14,Monday,Mid-Day,37,86,123,30.08
2011-08-01,15,Monday,Mid-Day,52,77,129,40.31
2011-08-01,16,Monday,Evening Rush,34,197,231,14.72
2011-08-01,17,Monday,Evening Rush,69,445,514,13.42
2011-08-01,18,Monday,Evening Rush,68,475,543,12.52
2011-08-01,19,Monday,Evening Rush,63,350,413,15.25
2011-08-01,20,Monday,Night,49,256,305,16.07
2011-08-01,21,Monday,Night,42,178,220,19.09
2011-08-01,22,Monday,Night,21,116,137,15.33
2011-08-01,23,Monday,Night,14,82,96,14.58
2011-08-02,0,Tuesday,Early Morning,11,18,29,37.93
2011-08-02,1,Tuesday,Early Morning,4,8,12,33.33
2011-08-02,2,Tuesday,Early Morning,2,6,8,25.0
2011-08-02,3,Tuesday,Early Morning,0,5,5,0.0
2011-08-02,4,Tuesday,Early Morning,0,10,10,0.0
2011-08-02,5,Tuesday,Early Morning,4,17,21,19.05
2011-08-02,6,Tuesday,Morning Rush,12,105,117,10.26
2011-08-02,7,Tuesday,Morning Rush,15,320,335,4.48
2011-08-02,8,Tuesday,Morning Rush,37,398,435,8.51
2011-08-02,9,Tuesday,Morning Rush,31,182,213,14.55
2011-08-02,10,Tuesday,Mid-Day,50,90,140,35.71
2011-08-02,11,Tuesday,Mid-Day,32,96,128,25.0
2011-08-02,12,Tuesday,Mid-Day,45,112,157,28.66
2011-08-02,13,Tuesday,Mid-Day,50,153,203,24.63
2011-08-02,14,Tuesday,Mid-Day,45,114,159,28.3
2011-08-02,15,Tuesday,Mid-Day,48,120,168,28.57
2011-08-02,16,Tuesday,Evening Rush,58,216,274,21.17
2011-08-02,17,Tuesday,Evening Rush,63,493,556,11.33
2011-08-02,18,Tuesday,Evening Rush,65,491,556,11.69
2011-08-02,19,Tuesday,Evening Rush,85,369,454,18.72
2011-08-02,20,Tuesday,Night,40,248,288,13.89
2011-08-02,21,Tuesday,Night,53,201,254,20.87
2011-08-02,22,Tuesday,Night,22,169,191,11.52
2011-08-02,23,Tuesday,Night,29,103,132,21.97
2011-08-03,0,Wednesday,Early Morning,11,32,43,25.58
2011-08-03,1,Wednesday,Early Morning,7,9,16,43.75
2011-08-03,2,Wednesday,Early Morning,2,9,11,18.18
2011-08-03,3,Wednesday,Early Morning,0,4,4,0.0
2011-08-03,4,Wednesday,Early Morning,0,7,7,0.0
2011-08-03,5,Wednesday,Early Morning,2,22,24,8.33
2011-08-03,6,Wednesday,Morning Rush,9,101,110,8.18
2011-08-03,7,Wednesday,Morning Rush,19,252,271,7.01
2011-08-03,8,Wednesday,Morning Rush,29,408,437,6.64
2011-08-03,9,Wednesday,Morning Rush,23,172,195,11.79
2011-08-03,10,Wednesday,Mid-Day,9,59,68,13.24
2011-08-03,11,Wednesday,Mid-Day,29,93,122,23.77
2011-08-03,12,Wednesday,Mid-Day,19,142,161,11.8
2011-08-03,13,Wednesday,Mid-Day,37,107,144,25.69
2011-08-03,14,Wednesday,Mid-Day,43,104,147,29.25
2011-08-03,15,Wednesday,Mid-Day,31,87,118,26.27
2011-08-03,16,Wednesday,Evening Rush,21,129,150,14.0
2011-08-03,17,Wednesday,Evening Rush,47,378,425,11.06
2011-08-03,18,Wednesday,Evening Rush,49,443,492,9.96
2011-08-03,19,Wednesday,Evening Rush,51,270,321,15.89
2011-08-03,20,Wednesday,Night,7,80,87,8.05
2011-08-03,21,Wednesday,Night,7,81,88,7.95
2011-08-03,22,Wednesday,Night,11,66,77,14.29
2011-08-03,23,Wednesday,Night,4,52,56,7.14
2011-08-04,0,Thursday,Early Morning,2,15,17,11.76
2011-08-04,1,Thursday,Early Morning,3,14,17,17.65
2011-08-04,2,Thursday,Early Morning,2,5,7,28.57
2011-08-04,3,Thursday,Early Morning,0,3,3,0.0
2011-08-04,4,Thursday,Early Morning,0,7,7,0.0
2011-08-04,5,Thursday,Early Morning,3,17,20,15.0
2011-08-04,6,Thursday,Morning Rush,7,90,97,7.22
2011-08-04,7,Thursday,Morning Rush,11,271,282,3.9
2011-08-04,8,Thursday,Morning Rush,29,369,398,7.29
2011-08-04,9,Thursday,Morning Rush,25,162,187,13.37
2011-08-04,10,Thursday,Mid-Day,24,89,113,21.24
2011-08-04,11,Thursday,Mid-Day,37,112,149,24.83
2011-08-04,12,Thursday,Mid-Day,53,152,205,25.85
2011-08-04,13,Thursday,Mid-Day,63,142,205,30.73
2011-08-04,14,Thursday,Mid-Day,53,114,167,31.74
2011-08-04,15,Thursday,Mid-Day,50,115,165,30.3
2011-08-04,16,Thursday,Evening Rush,70,220,290,24.14
2011-08-04,17,Thursday,Evening Rush,91,464,555,16.4
2011-08-04,18,Thursday,Evening Rush,88,435,523,16.83
2011-08-04,19,Thursday,Evening Rush,65,301,366,17.76
2011-08-04,20,Thursday,Night,41,245,286,14.34
2011-08-04,21,Thursday,Night,25,186,211,11.85
2011-08-04,22,Thursday,Night,33,141,174,18.97
2011-08-04,23,Thursday,Night,24,108,132,18.18
2011-08-05,0,Friday,Early Morning,13,41,54,24.07
2011-08-05,1,Friday,Early Morning,3,16,19,15.79
2011-08-05,2,Friday,Early Morning,5,14,19,26.32
2011-08-05,3,Friday,Early Morning,0,6,6,0.0
2011-08-05,4,Friday,Early Morning,1,6,7,14.29
2011-08-05,5,Friday,Early Morning,0,16,16,0.0
2011-08-05,6,Friday,Morning Rush,7,94,101,6.93
2011-08-05,7,Friday,Morning Rush,23,247,270,8.52
2011-08-05,8,Friday,Morning Rush,39,415,454,8.59
2011-08-05,9,Friday,Morning Rush,43,183,226,19.03
2011-08-05,10,Friday,Mid-Day,50,113,163,30.67
2011-08-05,11,Friday,Mid-Day,44,103,147,29.93
2011-08-05,12,Friday,Mid-Day,57,159,216,26.39
2011-08-05,13,Friday,Mid-Day,40,164,204,19.61
2011-08-05,14,Friday,Mid-Day,81,164,245,33.06
2011-08-05,15,Friday,Mid-Day,50,160,210,23.81
2011-08-05,16,Friday,Evening Rush,76,254,330,23.03
2011-08-05,17,Friday,Evening Rush,84,466,550,15.27
2011-08-05,18,Friday,Evening Rush,105,361,466,22.53
2011-08-05,19,Friday,Evening Rush,90,282,372,24.19
2011-08-05,20,Friday,Night,70,221,291,24.05
2011-08-05,21,Friday,Night,54,119,173,31.21
2011-08-05,22,Friday,Night,51,137,188,27.13
2011-08-05,23,Friday,Night,37,102,139,26.62
2011-08-06,0,Saturday,Early Morning,29,104,133,21.8
2011-08-06,1,Saturday,Early Morning,17,50,67,25.37
2011-08-06,2,Saturday,Early Morning,14,39,53,26.42
2011-08-06,3,Saturday,Early Morning,14,28,42,33.33
2011-08-06,4,Saturday,Early Morning,5,5,10,50.0
2011-08-06,5,Saturday,Early Morning,2,4,6,33.33
2011-08-06,6,Saturday,Morning Rush,5,22,27,18.52
2011-08-06,7,Saturday,Morning Rush,14,49,63,22.22
2011-08-06,8,Saturday,Morning Rush,27,94,121,22.31
2011-08-06,9,Saturday,Morning Rush,60,155,215,27.91
2011-08-06,10,Saturday,Mid-Day,91,199,290,31.38
2011-08-06,11,Saturday,Mid-Day,138,211,349,39.54
2011-08-06,12,Saturday,Mid-Day,130,252,382,34.03
2011-08-06,13,Saturday,Mid-Day,176,265,441,39.91
2011-08-06,14,Saturday,Mid-Day,176,204,380,46.32
2011-08-06,15,Saturday,Mid-Day,130,232,362,35.91
2011-08-06,16,Saturday,Evening Rush,155,188,343,45.19
2011-08-06,17,Saturday,Evening Rush,61,88,149,40.94
2011-08-06,18,Saturday,Evening Rush,81,130,211,38.39
2011-08-06,19,Saturday,Evening Rush,57,114,171,33.33
2011-08-06,20,Saturday,Night,58,79,137,42.34
2011-08-06,21,Saturday,Night,28,86,114,24.56
2011-08-06,22,Saturday,Night,24,96,120,20.0
2011-08-06,23,Saturday,Night,29,79,108,26.85
2011-08-07,0,Sunday,Early Morning,14,66,80,17.5
2011-08-07,1,Sunday,Early Morning,10,63,73,13.7
2011-08-07,2,Sunday,Early Morning,18,48,66,27.27
2011-08-07,3,Sunday,Early Morning,9,23,32,28.13
2011-08-07,4,Sunday,Early Morning,1,5,6,16.67
2011-08-07,5,Sunday,Early Morning,1,4,5,20.0
2011-08-07,6,Sunday,Morning Rush,3,10,13,23.08
2011-08-07,7,Sunday,Morning Rush,11,28,39,28.21
2011-08-07,8,Sunday,Morning Rush,23,66,89,25.84
2011-08-07,9,Sunday,Morning Rush,82,102,184,44.57
2011-08-07,10,Sunday,Mid-Day,88,178,266,33.08
2011-08-07,11,Sunday,Mid-Day,113,156,269,42.01
2011-08-07,12,Sunday,Mid-Day,161,209,370,43.51
2011-08-07,13,Sunday,Mid-Day,118,206,324,36.42
2011-08-07,14,Sunday,Mid-Day,130,192,322,40.37
2011-08-07,15,Sunday,Mid-Day,118,208,326,36.2
2011-08-07,16,Sunday,Evening Rush,74,119,193,38.34
2011-08-07,17,Sunday,Evening Rush,63,131,194,32.47
2011-08-07,18,Sunday,Evening Rush,74,155,229,32.31
2011-08-07,19,Sunday,Evening Rush,68,160,228,29.82
2011-08-07,20,Sunday,Night,50,133,183,27.32
2011-08-07,21,Sunday,Night,36,100,136,26.47
2011-08-07,22,Sunday,Night,21,82,103,20.39
2011-08-07,23,Sunday,Night,12,43,55,21.82
2011-08-08,0,Monday,Early Morning,13,17,30,43.33
2011-08-08,1,Monday,Early Morning,4,8,12,33.33
2011-08-08,2,Monday,Early Morning,4,3,7,57.14
2011-08-08,3,Monday,Early Morning,1,0,1,100.0
2011-08-08,4,Monday,Early Morning,2,8,10,20.0
2011-08-08,5,Monday,Early Morning,1,14,15,6.67
2011-08-08,6,Monday,Morning Rush,8,87,95,8.42
2011-08-08,7,Monday,Morning Rush,18,249,267,6.74
2011-08-08,8,Monday,Morning Rush,29,320,349,8.31
2011-08-08,9,Monday,Morning Rush,37,146,183,20.22
2011-08-08,10,Monday,Mid-Day,62,62,124,50.0
2011-08-08,11,Monday,Mid-Day,90,89,179,50.28
2011-08-08,12,Monday,Mid-Day,48,134,182,26.37
2011-08-08,13,Monday,Mid-Day,43,108,151,28.48
2011-08-08,14,Monday,Mid-Day,41,109,150,27.33
2011-08-08,15,Monday,Mid-Day,40,86,126,31.75
2011-08-08,16,Monday,Evening Rush,64,218,282,22.7
2011-08-08,17,Monday,Evening Rush,67,460,527,12.71
2011-08-08,18,Monday,Evening Rush,64,465,529,12.1
2011-08-08,19,Monday,Evening Rush,64,352,416,15.38
2011-08-08,20,Monday,Night,71,215,286,24.83
2011-08-08,21,Monday,Night,30,156,186,16.13
2011-08-08,22,Monday,Night,26,121,147,17.69
2011-08-08,23,Monday,Night,19,53,72,26.39
2011-08-09,0,Tuesday,Early Morning,10,25,35,28.57
2011-08-09,1,Tuesday,Early Morning,5,9,14,35.71
2011-08-09,2,Tuesday,Early Morning,9,3,12,75.0
2011-08-09,3,Tuesday,Early Morning,0,3,3,0.0
2011-08-09,4,Tuesday,Early Morning,1,6,7,14.29
2011-08-09,5,Tuesday,Early Morning,5,25,30,16.67
2011-08-09,6,Tuesday,Morning Rush,6,95,101,5.94
2011-08-09,7,Tuesday,Morning Rush,30,313,343,8.75
2011-08-09,8,Tuesday,Morning Rush,40,352,392,10.2
2011-08-09,9,Tuesday,Morning Rush,34,141,175,19.43
2011-08-09,10,Tuesday,Mid-Day,55,89,144,38.19
2011-08-09,11,Tuesday,Mid-Day,61,88,149,40.94
2011-08-09,12,Tuesday,Mid-Day,60,125,185,32.43
2011-08-09,13,Tuesday,Mid-Day,48,127,175,27.43
2011-08-09,14,Tuesday,Mid-Day,53,95,148,35.81
2011-08-09,15,Tuesday,Mid-Day,58,106,164,35.37
2011-08-09,16,Tuesday,Evening Rush,57,228,285,20.0
2011-08-09,17,Tuesday,Evening Rush,79,453,532,14.85
2011-08-09,18,Tuesday,Evening Rush,97,488,585,16.58
2011-08-09,19,Tuesday,Evening Rush,69,302,371,18.6
2011-08-09,20,Tuesday,Night,34,258,292,11.64
2011-08-09,21,Tuesday,Night,46,184,230,20.0
2011-08-09,22,Tuesday,Night,28,127,155,18.06
2011-08-09,23,Tuesday,Night,22,53,75,29.33
2011-08-10,0,Wednesday,Early Morning,19,18,37,51.35
2011-08-10,1,Wednesday,Early Morning,7,10,17,41.18
2011-08-10,2,Wednesday,Early Morning,1,10,11,9.09
2011-08-10,3,Wednesday,Early Morning,1,3,4,25.0
2011-08-10,4,Wednesday,Early Morning,1,4,5,20.0
2011-08-10,5,Wednesday,Early Morning,2,30,32,6.25
2011-08-10,6,Wednesday,Morning Rush,9,110,119,7.56
2011-08-10,7,Wednesday,Morning Rush,16,289,305,5.25
2011-08-10,8,Wednesday,Morning Rush,38,361,399,9.52
2011-08-10,9,Wednesday,Morning Rush,32,148,180,17.78
2011-08-10,10,Wednesday,Mid-Day,41,72,113,36.28
2011-08-10,11,Wednesday,Mid-Day,54,95,149,36.24
2011-08-10,12,Wednesday,Mid-Day,74,166,240,30.83
2011-08-10,13,Wednesday,Mid-Day,41,150,191,21.47
2011-08-10,14,Wednesday,Mid-Day,62,116,178,34.83
2011-08-10,15,Wednesday,Mid-Day,53,141,194,27.32
2011-08-10,16,Wednesday,Evening Rush,76,206,282,26.95
2011-08-10,17,Wednesday,Evening Rush,71,513,584,12.16
2011-08-10,18,Wednesday,Evening Rush,70,489,559,12.52
2011-08-10,19,Wednesday,Evening Rush,79,334,413,19.13
2011-08-10,20,Wednesday,Night,59,253,312,18.91
2011-08-10,21,Wednesday,Night,47,162,209,22.49
2011-08-10,22,Wednesday,Night,17,122,139,12.23
2011-08-10,23,Wednesday,Night,14,94,108,12.96
2011-08-11,0,Thursday,Early Morning,6,40,46,13.04
2011-08-11,1,Thursday,Early Morning,9,17,26,34.62
2011-08-11,2,Thursday,Early Morning,3,8,11,27.27
2011-08-11,3,Thursday,Early Morning,2,7,9,22.22
2011-08-11,4,Thursday,Early Morning,1,4,5,20.0
2011-08-11,5,Thursday,Early Morning,2,23,25,8.0
2011-08-11,6,Thursday,Morning Rush,5,101,106,4.72
2011-08-11,7,Thursday,Morning Rush,15,292,307,4.89
2011-08-11,8,Thursday,Morning Rush,29,361,390,7.44
2011-08-11,9,Thursday,Morning Rush,31,166,197,15.74
2011-08-11,10,Thursday,Mid-Day,36,96,132,27.27
2011-08-11,11,Thursday,Mid-Day,59,128,187,31.55
2011-08-11,12,Thursday,Mid-Day,50,164,214,23.36
2011-08-11,13,Thursday,Mid-Day,51,166,217,23.5
2011-08-11,14,Thursday,Mid-Day,39,103,142,27.46
2011-08-11,15,Thursday,Mid-Day,52,126,178,29.21
2011-08-11,16,Thursday,Evening Rush,57,241,298,19.13
2011-08-11,17,Thursday,Evening Rush,96,486,582,16.49
2011-08-11,18,Thursday,Evening Rush,74,497,571,12.96
2011-08-11,19,Thursday,Evening Rush,48,323,371,12.94
2011-08-11,20,Thursday,Night,56,232,288,19.44
2011-08-11,21,Thursday,Night,35,171,206,16.99
2011-08-11,22,Thursday,Night,34,123,157,21.66
2011-08-11,23,Thursday,Night,22,105,127,17.32
2011-08-12,0,Friday,Early Morning,12,53,65,18.46
2011-08-12,1,Friday,Early Morning,4,19,23,17.39
2011-08-12,2,Friday,Early Morning,0,15,15,0.0
2011-08-12,3,Friday,Early Morning,0,9,9,0.0
2011-08-12,4,Friday,Early Morning,0,5,5,0.0
2011-08-12,5,Friday,Early Morning,2,24,26,7.69
2011-08-12,6,Friday,Morning Rush,3,73,76,3.95
2011-08-12,7,Friday,Morning Rush,17,247,264,6.44
2011-08-12,8,Friday,Morning Rush,29,397,426,6.81
2011-08-12,9,Friday,Morning Rush,27,178,205,13.17
2011-08-12,10,Friday,Mid-Day,44,86,130,33.85
2011-08-12,11,Friday,Mid-Day,48,108,156,30.77
2011-08-12,12,Friday,Mid-Day,55,167,222,24.77
2011-08-12,13,Friday,Mid-Day,74,179,253,29.25
2011-08-12,14,Friday,Mid-Day,51,135,186,27.42
2011-08-12,15,Friday,Mid-Day,59,190,249,23.69
2011-08-12,16,Friday,Evening Rush,68,266,334,20.36
2011-08-12,17,Friday,Evening Rush,93,423,516,18.02
2011-08-12,18,Friday,Evening Rush,89,376,465,19.14
2011-08-12,19,Friday,Evening Rush,101,284,385,26.23
2011-08-12,20,Friday,Night,77,210,287,26.83
2011-08-12,21,Friday,Night,73,153,226,32.3
2011-08-12,22,Friday,Night,74,157,231,32.03
2011-08-12,23,Friday,Night,51,100,151,33.77
2011-08-13,0,Saturday,Early Morning,15,69,84,17.86
2011-08-13,1,Saturday,Early Morning,13,64,77,16.88
2011-08-13,2,Saturday,Early Morning,16,58,74,21.62
2011-08-13,3,Saturday,Early Morning,9,18,27,33.33
2011-08-13,4,Saturday,Early Morning,5,5,10,50.0
2011-08-13,5,Saturday,Early Morning,3,15,18,16.67
2011-08-13,6,Saturday,Morning Rush,3,19,22,13.64
2011-08-13,7,Saturday,Morning Rush,10,34,44,22.73
2011-08-13,8,Saturday,Morning Rush,28,90,118,23.73
2011-08-13,9,Saturday,Morning Rush,70,138,208,33.65
2011-08-13,10,Saturday,Mid-Day,97,163,260,37.31
2011-08-13,11,Saturday,Mid-Day,122,192,314,38.85
2011-08-13,12,Saturday,Mid-Day,175,246,421,41.57
2011-08-13,13,Saturday,Mid-Day,61,92,153,39.87
2011-08-13,14,Saturday,Mid-Day,113,146,259,43.63
2011-08-13,15,Saturday,Mid-Day,150,208,358,41.9
2011-08-13,16,Saturday,Evening Rush,148,133,281,52.67
2011-08-13,17,Saturday,Evening Rush,97,172,269,36.06
2011-08-13,18,Saturday,Evening Rush,123,169,292,42.12
2011-08-13,19,Saturday,Evening Rush,67,170,237,28.27
2011-08-13,20,Saturday,Night,78,105,183,42.62
2011-08-13,21,Saturday,Night,40,127,167,23.95
2011-08-13,22,Saturday,Night,36,118,154,23.38
2011-08-13,23,Saturday,Night,25,95,120,20.83
2011-08-14,0,Sunday,Early Morning,19,71,90,21.11
2011-08-14,1,Sunday,Early Morning,16,57,73,21.92
2011-08-14,2,Sunday,Early Morning,13,49,62,20.97
2011-08-14,3,Sunday,Early Morning,5,22,27,18.52
2011-08-14,4,Sunday,Early Morning,1,2,3,33.33
2011-08-14,5,Sunday,Early Morning,1,9,10,10.0
2011-08-14,6,Sunday,Morning Rush,2,4,6,33.33
2011-08-14,7,Sunday,Morning Rush,4,20,24,16.67
2011-08-14,8,Sunday,Morning Rush,20,21,41,48.78
2011-08-14,9,Sunday,Morning Rush,27,76,103,26.21
2011-08-14,10,Sunday,Mid-Day,67,116,183,36.61
2011-08-14,11,Sunday,Mid-Day,81,117,198,40.91
2011-08-14,12,Sunday,Mid-Day,98,183,281,34.88
2011-08-14,13,Sunday,Mid-Day,144,233,377,38.2
2011-08-14,14,Sunday,Mid-Day,126,244,370,34.05
2011-08-14,15,Sunday,Mid-Day,128,203,331,38.67
2011-08-14,16,Sunday,Evening Rush,116,176,292,39.73
2011-08-14,17,Sunday,Evening Rush,133,196,329,40.43
2011-08-14,18,Sunday,Evening Rush,125,222,347,36.02
2011-08-14,19,Sunday,Evening Rush,75,184,259,28.96
2011-08-14,20,Sunday,Night,67,126,193,34.72
2011-08-14,21,Sunday,Night,51,104,155,32.9
2011-08-14,22,Sunday,Night,14,25,39,35.9
2011-08-14,23,Sunday,Night,5,22,27,18.52
2011-08-15,0,Monday,Early Morning,7,18,25,28.0
2011-08-15,1,Monday,Early Morning,1,9,10,10.0
2011-08-15,2,Monday,Early Morning,0,3,3,0.0
2011-08-15,3,Monday,Early Morning,1,6,7,14.29
2011-08-15,4,Monday,Early Morning,1,4,5,20.0
2011-08-15,5,Monday,Early Morning,3,14,17,17.65
2011-08-15,6,Monday,Morning Rush,3,87,90,3.33
2011-08-15,7,Monday,Morning Rush,10,248,258,3.88
2011-08-15,8,Monday,Morning Rush,29,326,355,8.17
2011-08-15,9,Monday,Morning Rush,52,170,222,23.42
2011-08-15,10,Monday,Mid-Day,54,87,141,38.3
2011-08-15,11,Monday,Mid-Day,41,112,153,26.8
2011-08-15,12,Monday,Mid-Day,62,116,178,34.83
2011-08-15,13,Monday,Mid-Day,53,140,193,27.46
2011-08-15,14,Monday,Mid-Day,56,95,151,37.09
2011-08-15,15,Monday,Mid-Day,49,133,182,26.92
2011-08-15,16,Monday,Evening Rush,58,225,283,20.49
2011-08-15,17,Monday,Evening Rush,59,471,530,11.13
2011-08-15,18,Monday,Evening Rush,70,413,483,14.49
2011-08-15,19,Monday,Evening Rush,54,343,397,13.6
2011-08-15,20,Monday,Night,45,240,285,15.79
2011-08-15,21,Monday,Night,34,150,184,18.48
2011-08-15,22,Monday,Night,22,76,98,22.45
2011-08-15,23,Monday,Night,11,77,88,12.5
2011-08-16,0,Tuesday,Early Morning,8,23,31,25.81
2011-08-16,1,Tuesday,Early Morning,4,12,16,25.0
2011-08-16,2,Tuesday,Early Morning,1,3,4,25.0
2011-08-16,3,Tuesday,Early Morning,1,5,6,16.67
2011-08-16,4,Tuesday,Early Morning,0,5,5,0.0
2011-08-16,5,Tuesday,Early Morning,1,29,30,3.33
2011-08-16,6,Tuesday,Morning Rush,4,115,119,3.36
2011-08-16,7,Tuesday,Morning Rush,18,328,346,5.2
2011-08-16,8,Tuesday,Morning Rush,24,417,441,5.44
2011-08-16,9,Tuesday,Morning Rush,27,171,198,13.64
2011-08-16,10,Tuesday,Mid-Day,28,83,111,25.23
2011-08-16,11,Tuesday,Mid-Day,40,110,150,26.67
2011-08-16,12,Tuesday,Mid-Day,42,120,162,25.93
2011-08-16,13,Tuesday,Mid-Day,45,147,192,23.44
2011-08-16,14,Tuesday,Mid-Day,65,117,182,35.71
2011-08-16,15,Tuesday,Mid-Day,36,123,159,22.64
2011-08-16,16,Tuesday,Evening Rush,55,248,303,18.15
2011-08-16,17,Tuesday,Evening Rush,75,525,600,12.5
2011-08-16,18,Tuesday,Evening Rush,54,516,570,9.47
2011-08-16,19,Tuesday,Evening Rush,56,320,376,14.89
2011-08-16,20,Tuesday,Night,48,232,280,17.14
2011-08-16,21,Tuesday,Night,38,177,215,17.67
2011-08-16,22,Tuesday,Night,31,121,152,20.39
2011-08-16,23,Tuesday,Night,20,57,77,25.97
2011-08-17,0,Wednesday,Early Morning,8,16,24,33.33
2011-08-17,1,Wednesday,Early Morning,2,12,14,14.29
2011-08-17,2,Wednesday,Early Morning,0,6,6,0.0
2011-08-17,3,Wednesday,Early Morning,1,4,5,20.0
2011-08-17,4,Wednesday,Early Morning,0,5,5,0.0
2011-08-17,5,Wednesday,Early Morning,0,28,28,0.0
2011-08-17,6,Wednesday,Morning Rush,4,101,105,3.81
2011-08-17,7,Wednesday,Morning Rush,12,296,308,3.9
2011-08-17,8,Wednesday,Morning Rush,35,452,487,7.19
2011-08-17,9,Wednesday,Morning Rush,31,178,209,14.83
2011-08-17,10,Wednesday,Mid-Day,27,91,118,22.88
2011-08-17,11,Wednesday,Mid-Day,20,108,128,15.63
2011-08-17,12,Wednesday,Mid-Day,26,163,189,13.76
2011-08-17,13,Wednesday,Mid-Day,38,138,176,21.59
2011-08-17,14,Wednesday,Mid-Day,54,138,192,28.13
2011-08-17,15,Wednesday,Mid-Day,42,117,159,26.42
2011-08-17,16,Wednesday,Evening Rush,62,238,300,20.67
2011-08-17,17,Wednesday,Evening Rush,46,506,552,8.33
2011-08-17,18,Wednesday,Evening Rush,86,470,556,15.47
2011-08-17,19,Wednesday,Evening Rush,50,297,347,14.41
2011-08-17,20,Wednesday,Night,37,243,280,13.21
2011-08-17,21,Wednesday,Night,38,192,230,16.52
2011-08-17,22,Wednesday,Night,29,142,171,16.96
2011-08-17,23,Wednesday,Night,20,85,105,19.05
2011-08-18,0,Thursday,Early Morning,18,38,56,32.14
2011-08-18,1,Thursday,Early Morning,13,11,24,54.17
2011-08-18,2,Thursday,Early Morning,2,4,6,33.33
2011-08-18,3,Thursday,Early Morning,0,6,6,0.0
2011-08-18,4,Thursday,Early Morning,0,9,9,0.0
2011-08-18,5,Thursday,Early Morning,0,27,27,0.0
2011-08-18,6,Thursday,Morning Rush,6,97,103,5.83
2011-08-18,7,Thursday,Morning Rush,19,289,308,6.17
2011-08-18,8,Thursday,Morning Rush,27,393,420,6.43
2011-08-18,9,Thursday,Morning Rush,42,186,228,18.42
2011-08-18,10,Thursday,Mid-Day,37,92,129,28.68
2011-08-18,11,Thursday,Mid-Day,44,97,141,31.21
2011-08-18,12,Thursday,Mid-Day,34,139,173,19.65
2011-08-18,13,Thursday,Mid-Day,33,154,187,17.65
2011-08-18,14,Thursday,Mid-Day,67,115,182,36.81
2011-08-18,15,Thursday,Mid-Day,56,118,174,32.18
2011-08-18,16,Thursday,Evening Rush,49,196,245,20.0
2011-08-18,17,Thursday,Evening Rush,44,365,409,10.76
2011-08-18,18,Thursday,Evening Rush,48,226,274,17.52
2011-08-18,19,Thursday,Evening Rush,26,115,141,18.44
2011-08-18,20,Thursday,Night,24,141,165,14.55
2011-08-18,21,Thursday,Night,12,137,149,8.05
2011-08-18,22,Thursday,Night,18,117,135,13.33
2011-08-18,23,Thursday,Night,20,94,114,17.54
2011-08-19,0,Friday,Early Morning,9,53,62,14.52
2011-08-19,1,Friday,Early Morning,1,19,20,5.0
2011-08-19,2,Friday,Early Morning,0,8,8,0.0
2011-08-19,3,Friday,Early Morning,2,1,3,66.67
2011-08-19,4,Friday,Early Morning,1,7,8,12.5
2011-08-19,5,Friday,Early Morning,1,16,17,5.88
2011-08-19,6,Friday,Morning Rush,2,91,93,2.15
2011-08-19,7,Friday,Morning Rush,12,251,263,4.56
2011-08-19,8,Friday,Morning Rush,30,368,398,7.54
2011-08-19,9,Friday,Morning Rush,31,187,218,14.22
2011-08-19,10,Friday,Mid-Day,57,108,165,34.55
2011-08-19,11,Friday,Mid-Day,45,120,165,27.27
2011-08-19,12,Friday,Mid-Day,54,168,222,24.32
2011-08-19,13,Friday,Mid-Day,63,169,232,27.16
2011-08-19,14,Friday,Mid-Day,78,142,220,35.45
2011-08-19,15,Friday,Mid-Day,66,156,222,29.73
2011-08-19,16,Friday,Evening Rush,66,261,327,20.18
2011-08-19,17,Friday,Evening Rush,85,442,527,16.13
2011-08-19,18,Friday,Evening Rush,88,337,425,20.71
2011-08-19,19,Friday,Evening Rush,33,132,165,20.0
2011-08-19,20,Friday,Night,12,46,58,20.69
2011-08-19,21,Friday,Night,18,89,107,16.82
2011-08-19,22,Friday,Night,25,97,122,20.49
2011-08-19,23,Friday,Night,18,88,106,16.98
2011-08-20,0,Saturday,Early Morning,21,107,128,16.41
2011-08-20,1,Saturday,Early Morning,12,35,47,25.53
2011-08-20,2,Saturday,Early Morning,10,59,69,14.49
2011-08-20,3,Saturday,Early Morning,9,42,51,17.65
2011-08-20,4,Saturday,Early Morning,1,6,7,14.29
2011-08-20,5,Saturday,Early Morning,0,8,8,0.0
2011-08-20,6,Saturday,Morning Rush,6,18,24,25.0
2011-08-20,7,Saturday,Morning Rush,8,36,44,18.18
2011-08-20,8,Saturday,Morning Rush,27,106,133,20.3
2011-08-20,9,Saturday,Morning Rush,51,139,190,26.84
2011-08-20,10,Saturday,Mid-Day,114,192,306,37.25
2011-08-20,11,Saturday,Mid-Day,115,223,338,34.02
2011-08-20,12,Saturday,Mid-Day,156,253,409,38.14
2011-08-20,13,Saturday,Mid-Day,158,220,378,41.8
2011-08-20,14,Saturday,Mid-Day,147,228,375,39.2
2011-08-20,15,Saturday,Mid-Day,175,215,390,44.87
2011-08-20,16,Saturday,Evening Rush,151,222,373,40.48
2011-08-20,17,Saturday,Evening Rush,180,203,383,47.0
2011-08-20,18,Saturday,Evening Rush,169,225,394,42.89
2011-08-20,19,Saturday,Evening Rush,109,182,291,37.46
2011-08-20,20,Saturday,Night,78,170,248,31.45
2011-08-20,21,Saturday,Night,81,144,225,36.0
2011-08-20,22,Saturday,Night,77,146,223,34.53
2011-08-20,23,Saturday,Night,59,98,157,37.58
2011-08-21,0,Sunday,Early Morning,6,68,74,8.11
2011-08-21,1,Sunday,Early Morning,17,69,86,19.77
2011-08-21,2,Sunday,Early Morning,13,51,64,20.31
2011-08-21,3,Sunday,Early Morning,25,26,51,49.02
2011-08-21,4,Sunday,Early Morning,1,5,6,16.67
2011-08-21,5,Sunday,Early Morning,0,8,8,0.0
2011-08-21,6,Sunday,Morning Rush,4,10,14,28.57
2011-08-21,7,Sunday,Morning Rush,12,19,31,38.71
2011-08-21,8,Sunday,Morning Rush,30,62,92,32.61
2011-08-21,9,Sunday,Morning Rush,80,151,231,34.63
2011-08-21,10,Sunday,Mid-Day,97,177,274,35.4
2011-08-21,11,Sunday,Mid-Day,132,181,313,42.17
2011-08-21,12,Sunday,Mid-Day,135,239,374,36.1
2011-08-21,13,Sunday,Mid-Day,94,216,310,30.32
2011-08-21,14,Sunday,Mid-Day,78,157,235,33.19
2011-08-21,15,Sunday,Mid-Day,17,51,68,25.0
2011-08-21,16,Sunday,Evening Rush,97,161,258,37.6
2011-08-21,17,Sunday,Evening Rush,91,179,270,33.7
2011-08-21,18,Sunday,Evening Rush,96,215,311,30.87
2011-08-21,19,Sunday,Evening Rush,81,201,282,28.72
2011-08-21,20,Sunday,Night,41,140,181,22.65
2011-08-21,21,Sunday,Night,45,93,138,32.61
2011-08-21,22,Sunday,Night,37,97,134,27.61
2011-08-21,23,Sunday,Night,20,48,68,29.41
2011-08-22,0,Monday,Early Morning,18,22,40,45.0
2011-08-22,1,Monday,Early Morning,8,13,21,38.1
2011-08-22,2,Monday,Early Morning,2,6,8,25.0
2011-08-22,3,Monday,Early Morning,0,5,5,0.0
2011-08-22,4,Monday,Early Morning,2,10,12,16.67
2011-08-22,5,Monday,Early Morning,1,23,24,4.17
2011-08-22,6,Monday,Morning Rush,6,106,112,5.36
2011-08-22,7,Monday,Morning Rush,11,270,281,3.91
2011-08-22,8,Monday,Morning Rush,20,331,351,5.7
2011-08-22,9,Monday,Morning Rush,36,151,187,19.25
2011-08-22,10,Monday,Mid-Day,36,85,121,29.75
2011-08-22,11,Monday,Mid-Day,46,85,131,35.11
2011-08-22,12,Monday,Mid-Day,54,153,207,26.09
2011-08-22,13,Monday,Mid-Day,47,158,205,22.93
2011-08-22,14,Monday,Mid-Day,88,137,225,39.11
2011-08-22,15,Monday,Mid-Day,72,127,199,36.18
2011-08-22,16,Monday,Evening Rush,66,254,320,20.63
2011-08-22,17,Monday,Evening Rush,82,509,591,13.87
2011-08-22,18,Monday,Evening Rush,72,537,609,11.82
2011-08-22,19,Monday,Evening Rush,66,350,416,15.87
2011-08-22,20,Monday,Night,21,247,268,7.84
2011-08-22,21,Monday,Night,28,180,208,13.46
2011-08-22,22,Monday,Night,32,121,153,20.92
2011-08-22,23,Monday,Night,19,45,64,29.69
2011-08-23,0,Tuesday,Early Morning,13,22,35,37.14
2011-08-23,1,Tuesday,Early Morning,6,13,19,31.58
2011-08-23,2,Tuesday,Early Morning,2,4,6,33.33
2011-08-23,3,Tuesday,Early Morning,2,4,6,33.33
2011-08-23,4,Tuesday,Early Morning,0,5,5,0.0
2011-08-23,5,Tuesday,Early Morning,1,35,36,2.78
2011-08-23,6,Tuesday,Morning Rush,3,111,114,2.63
2011-08-23,7,Tuesday,Morning Rush,11,333,344,3.2
2011-08-23,8,Tuesday,Morning Rush,43,461,504,8.53
2011-08-23,9,Tuesday,Morning Rush,34,191,225,15.11
2011-08-23,10,Tuesday,Mid-Day,56,92,148,37.84
2011-08-23,11,Tuesday,Mid-Day,62,124,186,33.33
2011-08-23,12,Tuesday,Mid-Day,60,177,237,25.32
2011-08-23,13,Tuesday,Mid-Day,70,164,234,29.91
2011-08-23,14,Tuesday,Mid-Day,149,502,651,22.89
2011-08-23,15,Tuesday,Mid-Day,178,423,601,29.62
2011-08-23,16,Tuesday,Evening Rush,133,311,444,29.95
2011-08-23,17,Tuesday,Evening Rush,133,339,472,28.18
2011-08-23,18,Tuesday,Evening Rush,98,421,519,18.88
2011-08-23,19,Tuesday,Evening Rush,70,297,367,19.07
2011-08-23,20,Tuesday,Night,54,206,260,20.77
2011-08-23,21,Tuesday,Night,38,173,211,18.01
2011-08-23,22,Tuesday,Night,46,145,191,24.08
2011-08-23,23,Tuesday,Night,19,61,80,23.75
2011-08-24,0,Wednesday,Early Morning,9,29,38,23.68
2011-08-24,1,Wednesday,Early Morning,7,17,24,29.17
2011-08-24,2,Wednesday,Early Morning,2,4,6,33.33
2011-08-24,3,Wednesday,Early Morning,0,1,1,0.0
2011-08-24,4,Wednesday,Early Morning,0,7,7,0.0
2011-08-24,5,Wednesday,Early Morning,1,26,27,3.7
2011-08-24,6,Wednesday,Morning Rush,3,105,108,2.78
2011-08-24,7,Wednesday,Morning Rush,11,297,308,3.57
2011-08-24,8,Wednesday,Morning Rush,32,436,468,6.84
2011-08-24,9,Wednesday,Morning Rush,44,169,213,20.66
2011-08-24,10,Wednesday,Mid-Day,51,95,146,34.93
2011-08-24,11,Wednesday,Mid-Day,57,128,185,30.81
2011-08-24,12,Wednesday,Mid-Day,60,175,235,25.53
2011-08-24,13,Wednesday,Mid-Day,56,180,236,23.73
2011-08-24,14,Wednesday,Mid-Day,77,127,204,37.75
2011-08-24,15,Wednesday,Mid-Day,63,141,204,30.88
2011-08-24,16,Wednesday,Evening Rush,49,222,271,18.08
2011-08-24,17,Wednesday,Evening Rush,83,484,567,14.64
2011-08-24,18,Wednesday,Evening Rush,102,519,621,16.43
2011-08-24,19,Wednesday,Evening Rush,93,347,440,21.14
2011-08-24,20,Wednesday,Night,45,289,334,13.47
2011-08-24,21,Wednesday,Night,47,189,236,19.92
2011-08-24,22,Wednesday,Night,41,140,181,22.65
2011-08-24,23,Wednesday,Night,16,54,70,22.86
2011-08-25,0,Thursday,Early Morning,11,41,52,21.15
2011-08-25,1,Thursday,Early Morning,4,11,15,26.67
2011-08-25,2,Thursday,Early Morning,3,2,5,60.0
2011-08-25,3,Thursday,Early Morning,2,2,4,50.0
2011-08-25,4,Thursday,Early Morning,1,6,7,14.29
2011-08-25,5,Thursday,Early Morning,1,25,26,3.85
2011-08-25,6,Thursday,Morning Rush,1,101,102,0.98
2011-08-25,7,Thursday,Morning Rush,17,296,313,5.43
2011-08-25,8,Thursday,Morning Rush,23,461,484,4.75
2011-08-25,9,Thursday,Morning Rush,21,141,162,12.96
2011-08-25,10,Thursday,Mid-Day,37,105,142,26.06
2011-08-25,11,Thursday,Mid-Day,39,112,151,25.83
2011-08-25,12,Thursday,Mid-Day,9,32,41,21.95
2011-08-25,13,Thursday,Mid-Day,7,30,37,18.92
2011-08-25,14,Thursday,Mid-Day,27,86,113,23.89
2011-08-25,15,Thursday,Mid-Day,28,104,132,21.21
2011-08-25,16,Thursday,Evening Rush,16,105,121,13.22
2011-08-25,17,Thursday,Evening Rush,28,284,312,8.97
2011-08-25,18,Thursday,Evening Rush,31,377,408,7.6
2011-08-25,19,Thursday,Evening Rush,31,241,272,11.4
2011-08-25,20,Thursday,Night,33,192,225,14.67
2011-08-25,21,Thursday,Night,29,158,187,15.51
2011-08-25,22,Thursday,Night,21,126,147,14.29
2011-08-25,23,Thursday,Night,15,69,84,17.86
2011-08-26,0,Friday,Early Morning,9,42,51,17.65
2011-08-26,1,Friday,Early Morning,10,13,23,43.48
2011-08-26,2,Friday,Early Morning,4,16,20,20.0
2011-08-26,3,Friday,Early Morning,3,8,11,27.27
2011-08-26,4,Friday,Early Morning,2,6,8,25.0
2011-08-26,5,Friday,Early Morning,3,23,26,11.54
2011-08-26,6,Friday,Morning Rush,5,100,105,4.76
2011-08-26,7,Friday,Morning Rush,3,263,266,1.13
2011-08-26,8,Friday,Morning Rush,17,387,404,4.21
2011-08-26,9,Friday,Morning Rush,39,191,230,16.96
2011-08-26,10,Friday,Mid-Day,34,89,123,27.64
2011-08-26,11,Friday,Mid-Day,63,151,214,29.44
2011-08-26,12,Friday,Mid-Day,70,173,243,28.81
2011-08-26,13,Friday,Mid-Day,72,165,237,30.38
2011-08-26,14,Friday,Mid-Day,55,164,219,25.11
2011-08-26,15,Friday,Mid-Day,53,196,249,21.29
2011-08-26,16,Friday,Evening Rush,50,293,343,14.58
2011-08-26,17,Friday,Evening Rush,56,433,489,11.45
2011-08-26,18,Friday,Evening Rush,40,370,410,9.76
2011-08-26,19,Friday,Evening Rush,55,235,290,18.97
2011-08-26,20,Friday,Night,39,183,222,17.57
2011-08-26,21,Friday,Night,38,152,190,20.0
2011-08-26,22,Friday,Night,26,126,152,17.11
2011-08-26,23,Friday,Night,22,114,136,16.18
2011-08-27,0,Saturday,Early Morning,33,112,145,22.76
2011-08-27,1,Saturday,Early Morning,13,51,64,20.31
2011-08-27,2,Saturday,Early Morning,18,59,77,23.38
2011-08-27,3,Saturday,Early Morning,8,22,30,26.67
2011-08-27,4,Saturday,Early Morning,1,3,4,25.0
2011-08-27,5,Saturday,Early Morning,1,11,12,8.33
2011-08-27,6,Saturday,Morning Rush,3,15,18,16.67
2011-08-27,7,Saturday,Morning Rush,2,26,28,7.14
2011-08-27,8,Saturday,Morning Rush,14,62,76,18.42
2011-08-27,9,Saturday,Morning Rush,28,128,156,17.95
2011-08-27,10,Saturday,Mid-Day,51,154,205,24.88
2011-08-27,11,Saturday,Mid-Day,15,73,88,17.05
2011-08-27,12,Saturday,Mid-Day,11,65,76,14.47
2011-08-27,13,Saturday,Mid-Day,10,33,43,23.26
2011-08-27,14,Saturday,Mid-Day,4,19,23,17.39
2011-08-27,15,Saturday,Mid-Day,2,28,30,6.67
2011-08-27,16,Saturday,Evening Rush,10,14,24,41.67
2011-08-27,17,Saturday,Evening Rush,2,14,16,12.5
2011-08-28,7,Sunday,Morning Rush,0,1,1,0.0
2011-08-28,8,Sunday,Morning Rush,2,6,8,25.0
2011-08-28,9,Sunday,Morning Rush,7,46,53,13.21
2011-08-28,10,Sunday,Mid-Day,27,115,142,19.01
2011-08-28,11,Sunday,Mid-Day,59,178,237,24.89
2011-08-28,12,Sunday,Mid-Day,88,218,306,28.76
2011-08-28,13,Sunday,Mid-Day,129,302,431,29.93
2011-08-28,14,Sunday,Mid-Day,157,290,447,35.12
2011-08-28,15,Sunday,Mid-Day,155,314,469,33.05
2011-08-28,16,Sunday,Evening Rush,196,295,491,39.92
2011-08-28,17,Sunday,Evening Rush,145,253,398,36.43
2011-08-28,18,Sunday,Evening Rush,145,257,402,36.07
2011-08-28,19,Sunday,Evening Rush,140,247,387,36.18
2011-08-28,20,Sunday,Night,64,150,214,29.91
2011-08-28,21,Sunday,Night,60,126,186,32.26
2011-08-28,22,Sunday,Night,25,73,98,25.51
2011-08-28,23,Sunday,Night,16,48,64,25.0
2011-08-29,0,Monday,Early Morning,13,21,34,38.24
2011-08-29,1,Monday,Early Morning,5,15,20,25.0
2011-08-29,2,Monday,Early Morning,8,5,13,61.54
2011-08-29,3,Monday,Early Morning,1,5,6,16.67
2011-08-29,4,Monday,Early Morning,0,3,3,0.0
2011-08-29,5,Monday,Early Morning,0,17,17,0.0
2011-08-29,6,Monday,Morning Rush,3,99,102,2.94
2011-08-29,7,Monday,Morning Rush,11,273,284,3.87
2011-08-29,8,Monday,Morning Rush,20,384,404,4.95
2011-08-29,9,Monday,Morning Rush,22,166,188,11.7
2011-08-29,10,Monday,Mid-Day,42,73,115,36.52
2011-08-29,11,Monday,Mid-Day,38,100,138,27.54
2011-08-29,12,Monday,Mid-Day,48,159,207,23.19
2011-08-29,13,Monday,Mid-Day,48,170,218,22.02
2011-08-29,14,Monday,Mid-Day,55,127,182,30.22
2011-08-29,15,Monday,Mid-Day,56,164,220,25.45
2011-08-29,16,Monday,Evening Rush,56,226,282,19.86
2011-08-29,17,Monday,Evening Rush,67,524,591,11.34
2011-08-29,18,Monday,Evening Rush,60,487,547,10.97
2011-08-29,19,Monday,Evening Rush,50,317,367,13.62
2011-08-29,20,Monday,Night,50,227,277,18.05
2011-08-29,21,Monday,Night,34,168,202,16.83
2011-08-29,22,Monday,Night,23,119,142,16.2
2011-08-29,23,Monday,Night,19,56,75,25.33
2011-08-30,0,Tuesday,Early Morning,10,17,27,37.04
2011-08-30,1,Tuesday,Early Morning,6,7,13,46.15
2011-08-30,2,Tuesday,Early Morning,2,8,10,20.0
2011-08-30,3,Tuesday,Early Morning,2,2,4,50.0
2011-08-30,4,Tuesday,Early Morning,0,6,6,0.0
2011-08-30,5,Tuesday,Early Morning,1,27,28,3.57
2011-08-30,6,Tuesday,Morning Rush,4,115,119,3.36
2011-08-30,7,Tuesday,Morning Rush,19,338,357,5.32
2011-08-30,8,Tuesday,Morning Rush,34,459,493,6.9
2011-08-30,9,Tuesday,Morning Rush,38,180,218,17.43
2011-08-30,10,Tuesday,Mid-Day,28,109,137,20.44
2011-08-30,11,Tuesday,Mid-Day,60,115,175,34.29
2011-08-30,12,Tuesday,Mid-Day,65,172,237,27.43
2011-08-30,13,Tuesday,Mid-Day,59,170,229,25.76
2011-08-30,14,Tuesday,Mid-Day,58,151,209,27.75
2011-08-30,15,Tuesday,Mid-Day,34,162,196,17.35
2011-08-30,16,Tuesday,Evening Rush,42,295,337,12.46
2011-08-30,17,Tuesday,Evening Rush,62,549,611,10.15
2011-08-30,18,Tuesday,Evening Rush,60,516,576,10.42
2011-08-30,19,Tuesday,Evening Rush,68,397,465,14.62
2011-08-30,20,Tuesday,Night,39,259,298,13.09
2011-08-30,21,Tuesday,Night,43,180,223,19.28
2011-08-30,22,Tuesday,Night,22,121,143,15.38
2011-08-30,23,Tuesday,Night,19,74,93,20.43
2011-08-31,0,Wednesday,Early Morning,8,24,32,25.0
2011-08-31,1,Wednesday,Early Morning,2,13,15,13.33
2011-08-31,2,Wednesday,Early Morning,1,5,6,16.67
2011-08-31,3,Wednesday,Early Morning,2,4,6,33.33
2011-08-31,4,Wednesday,Early Morning,0,5,5,0.0
2011-08-31,5,Wednesday,Early Morning,2,25,27,7.41
2011-08-31,6,Wednesday,Morning Rush,4,107,111,3.6
2011-08-31,7,Wednesday,Morning Rush,12,316,328,3.66
2011-08-31,8,Wednesday,Morning Rush,27,440,467,5.78
2011-08-31,9,Wednesday,Morning Rush,27,217,244,11.07
2011-08-31,10,Wednesday,Mid-Day,33,105,138,23.91
2011-08-31,11,Wednesday,Mid-Day,28,143,171,16.37
2011-08-31,12,Wednesday,Mid-Day,68,192,260,26.15
2011-08-31,13,Wednesday,Mid-Day,39,182,221,17.65
2011-08-31,14,Wednesday,Mid-Day,48,148,196,24.49
2011-08-31,15,Wednesday,Mid-Day,34,138,172,19.77
2011-08-31,16,Wednesday,Evening Rush,46,263,309,14.89
2011-08-31,17,Wednesday,Evening Rush,83,525,608,13.65
2011-08-31,18,Wednesday,Evening Rush,70,495,565,12.39
2011-08-31,19,Wednesday,Evening Rush,53,393,446,11.88
2011-08-31,20,Wednesday,Night,30,259,289,10.38
2011-08-31,21,Wednesday,Night,27,174,201,13.43
2011-08-31,22,Wednesday,Night,20,137,157,12.74
2011-08-31,23,Wednesday,Night,24,60,84,28.57
2011-09-01,0,Thursday,Early Morning,18,33,51,35.29
2011-09-01,1,Thursday,Early Morning,7,14,21,33.33
2011-09-01,2,Thursday,Early Morning,14,11,25,56.0
2011-09-01,3,Thursday,Early Morning,7,7,14,50.0
2011-09-01,4,Thursday,Early Morning,0,7,7,0.0
2011-09-01,5,Thursday,Early Morning,1,22,23,4.35
2011-09-01,6,Thursday,Morning Rush,2,103,105,1.9
2011-09-01,7,Thursday,Morning Rush,7,335,342,2.05
2011-09-01,8,Thursday,Morning Rush,31,467,498,6.22
2011-09-01,9,Thursday,Morning Rush,29,178,207,14.01
2011-09-01,10,Thursday,Mid-Day,46,92,138,33.33
2011-09-01,11,Thursday,Mid-Day,51,141,192,26.56
2011-09-01,12,Thursday,Mid-Day,64,165,229,27.95
2011-09-01,13,Thursday,Mid-Day,50,169,219,22.83
2011-09-01,14,Thursday,Mid-Day,54,144,198,27.27
2011-09-01,15,Thursday,Mid-Day,39,135,174,22.41
2011-09-01,16,Thursday,Evening Rush,55,253,308,17.86
2011-09-01,17,Thursday,Evening Rush,61,567,628,9.71
2011-09-01,18,Thursday,Evening Rush,69,462,531,12.99
2011-09-01,19,Thursday,Evening Rush,79,364,443,17.83
2011-09-01,20,Thursday,Night,33,247,280,11.79
2011-09-01,21,Thursday,Night,17,160,177,9.6
2011-09-01,22,Thursday,Night,34,145,179,18.99
2011-09-01,23,Thursday,Night,15,111,126,11.9
2011-09-02,0,Friday,Early Morning,6,58,64,9.38
2011-09-02,1,Friday,Early Morning,4,28,32,12.5
2011-09-02,2,Friday,Early Morning,9,11,20,45.0
2011-09-02,3,Friday,Early Morning,4,4,8,50.0
2011-09-02,4,Friday,Early Morning,2,2,4,50.0
2011-09-02,5,Friday,Early Morning,0,20,20,0.0
2011-09-02,6,Friday,Morning Rush,3,73,76,3.95
2011-09-02,7,Friday,Morning Rush,6,253,259,2.32
2011-09-02,8,Friday,Morning Rush,22,434,456,4.82
2011-09-02,9,Friday,Morning Rush,30,190,220,13.64
2011-09-02,10,Friday,Mid-Day,34,106,140,24.29
2011-09-02,11,Friday,Mid-Day,51,141,192,26.56
2011-09-02,12,Friday,Mid-Day,82,178,260,31.54
2011-09-02,13,Friday,Mid-Day,72,207,279,25.81
2011-09-02,14,Friday,Mid-Day,75,208,283,26.5
2011-09-02,15,Friday,Mid-Day,69,277,346,19.94
2011-09-02,16,Friday,Evening Rush,82,299,381,21.52
2011-09-02,17,Friday,Evening Rush,78,377,455,17.14
2011-09-02,18,Friday,Evening Rush,50,305,355,14.08
2011-09-02,19,Friday,Evening Rush,67,220,287,23.34
2011-09-02,20,Friday,Night,38,158,196,19.39
2011-09-02,21,Friday,Night,28,121,149,18.79
2011-09-02,22,Friday,Night,33,114,147,22.45
2011-09-02,23,Friday,Night,30,68,98,30.61
2011-09-03,0,Saturday,Early Morning,22,65,87,25.29
2011-09-03,1,Saturday,Early Morning,17,57,74,22.97
2011-09-03,2,Saturday,Early Morning,15,26,41,36.59
2011-09-03,3,Saturday,Early Morning,17,18,35,48.57
2011-09-03,4,Saturday,Early Morning,3,4,7,42.86
2011-09-03,5,Saturday,Early Morning,3,9,12,25.0
2011-09-03,6,Saturday,Morning Rush,4,19,23,17.39
2011-09-03,7,Saturday,Morning Rush,5,33,38,13.16
2011-09-03,8,Saturday,Morning Rush,24,65,89,26.97
2011-09-03,9,Saturday,Morning Rush,83,118,201,41.29
2011-09-03,10,Saturday,Mid-Day,90,168,258,34.88
2011-09-03,11,Saturday,Mid-Day,66,128,194,34.02
2011-09-03,12,Saturday,Mid-Day,97,160,257,37.74
2011-09-03,13,Saturday,Mid-Day,153,200,353,43.34
2011-09-03,14,Saturday,Mid-Day,204,176,380,53.68
2011-09-03,15,Saturday,Mid-Day,187,201,388,48.2
2011-09-03,16,Saturday,Evening Rush,186,188,374,49.73
2011-09-03,17,Saturday,Evening Rush,170,201,371,45.82
2011-09-03,18,Saturday,Evening Rush,160,179,339,47.2
2011-09-03,19,Saturday,Evening Rush,147,148,295,49.83
2011-09-03,20,Saturday,Night,99,120,219,45.21
2011-09-03,21,Saturday,Night,71,93,164,43.29
2011-09-03,22,Saturday,Night,66,96,162,40.74
2011-09-03,23,Saturday,Night,46,77,123,37.4
2011-09-04,0,Sunday,Early Morning,33,76,109,30.28
2011-09-04,1,Sunday,Early Morning,37,38,75,49.33
2011-09-04,2,Sunday,Early Morning,17,43,60,28.33
2011-09-04,3,Sunday,Early Morning,20,23,43,46.51
2011-09-04,4,Sunday,Early Morning,0,4,4,0.0
2011-09-04,5,Sunday,Early Morning,1,5,6,16.67
2011-09-04,6,Sunday,Morning Rush,0,3,3,0.0
2011-09-04,7,Sunday,Morning Rush,10,20,30,33.33
2011-09-04,8,Sunday,Morning Rush,21,49,70,30.0
2011-09-04,9,Sunday,Morning Rush,87,102,189,46.03
2011-09-04,10,Sunday,Mid-Day,150,147,297,50.51
2011-09-04,11,Sunday,Mid-Day,174,163,337,51.63
2011-09-04,12,Sunday,Mid-Day,214,221,435,49.2
2011-09-04,13,Sunday,Mid-Day,245,174,419,58.47
2011-09-04,14,Sunday,Mid-Day,205,156,361,56.79
2011-09-04,15,Sunday,Mid-Day,218,192,410,53.17
2011-09-04,16,Sunday,Evening Rush,196,141,337,58.16
2011-09-04,17,Sunday,Evening Rush,204,172,376,54.26
2011-09-04,18,Sunday,Evening Rush,187,169,356,52.53
2011-09-04,19,Sunday,Evening Rush,178,150,328,54.27
2011-09-04,20,Sunday,Night,104,125,229,45.41
2011-09-04,21,Sunday,Night,104,103,207,50.24
2011-09-04,22,Sunday,Night,70,85,155,45.16
2011-09-04,23,Sunday,Night,46,58,104,44.23
2011-09-05,0,Monday,Early Morning,31,66,97,31.96
2011-09-05,1,Monday,Early Morning,19,35,54,35.19
2011-09-05,2,Monday,Early Morning,17,22,39,43.59
2011-09-05,3,Monday,Early Morning,4,12,16,25.0
2011-09-05,4,Monday,Early Morning,3,5,8,37.5
2011-09-05,5,Monday,Early Morning,2,4,6,33.33
2011-09-05,6,Monday,Morning Rush,6,5,11,54.55
2011-09-05,7,Monday,Morning Rush,11,30,41,26.83
2011-09-05,8,Monday,Morning Rush,45,56,101,44.55
2011-09-05,9,Monday,Morning Rush,63,89,152,41.45
2011-09-05,10,Monday,Mid-Day,107,137,244,43.85
2011-09-05,11,Monday,Mid-Day,101,207,308,32.79
2011-09-05,12,Monday,Mid-Day,141,212,353,39.94
2011-09-05,13,Monday,Mid-Day,154,235,389,39.59
2011-09-05,14,Monday,Mid-Day,145,212,357,40.62
2011-09-05,15,Monday,Mid-Day,111,142,253,43.87
2011-09-05,16,Monday,Evening Rush,92,192,284,32.39
2011-09-05,17,Monday,Evening Rush,37,77,114,32.46
2011-09-05,18,Monday,Evening Rush,31,92,123,25.2
2011-09-05,19,Monday,Evening Rush,52,123,175,29.71
2011-09-05,20,Monday,Night,26,56,82,31.71
2011-09-05,21,Monday,Night,20,40,60,33.33
2011-09-05,22,Monday,Night,15,49,64,23.44
2011-09-05,23,Monday,Night,3,17,20,15.0
2011-09-06,0,Tuesday,Early Morning,1,7,8,12.5
2011-09-06,2,Tuesday,Early Morning,0,2,2,0.0
2011-09-06,3,Tuesday,Early Morning,1,0,1,100.0
2011-09-06,4,Tuesday,Early Morning,1,3,4,25.0
2011-09-06,5,Tuesday,Early Morning,1,20,21,4.76
2011-09-06,6,Tuesday,Morning Rush,0,72,72,0.0
2011-09-06,7,Tuesday,Morning Rush,6,166,172,3.49
2011-09-06,8,Tuesday,Morning Rush,15,349,364,4.12
2011-09-06,9,Tuesday,Morning Rush,18,167,185,9.73
2011-09-06,10,Tuesday,Mid-Day,16,90,106,15.09
2011-09-06,11,Tuesday,Mid-Day,11,78,89,12.36
2011-09-06,12,Tuesday,Mid-Day,16,51,67,23.88
2011-09-06,13,Tuesday,Mid-Day,5,24,29,17.24
2011-09-06,14,Tuesday,Mid-Day,3,21,24,12.5
2011-09-06,15,Tuesday,Mid-Day,18,71,89,20.22
2011-09-06,16,Tuesday,Evening Rush,11,95,106,10.38
2011-09-06,17,Tuesday,Evening Rush,15,276,291,5.15
2011-09-06,18,Tuesday,Evening Rush,22,351,373,5.9
2011-09-06,19,Tuesday,Evening Rush,12,269,281,4.27
2011-09-06,20,Tuesday,Night,13,150,163,7.98
2011-09-06,21,Tuesday,Night,12,109,121,9.92
2011-09-06,22,Tuesday,Night,5,79,84,5.95
2011-09-06,23,Tuesday,Night,2,56,58,3.45
2011-09-07,0,Wednesday,Early Morning,1,12,13,7.69
2011-09-07,1,Wednesday,Early Morning,2,3,5,40.0
2011-09-07,2,Wednesday,Early Morning,2,4,6,33.33
2011-09-07,3,Wednesday,Early Morning,1,1,2,50.0
2011-09-07,4,Wednesday,Early Morning,0,4,4,0.0
2011-09-07,5,Wednesday,Early Morning,1,15,16,6.25
2011-09-07,6,Wednesday,Morning Rush,1,74,75,1.33
2011-09-07,7,Wednesday,Morning Rush,3,83,86,3.49
2011-09-07,8,Wednesday,Morning Rush,9,319,328,2.74
2011-09-07,9,Wednesday,Morning Rush,14,176,190,7.37
2011-09-07,10,Wednesday,Mid-Day,3,63,66,4.55
2011-09-07,11,Wednesday,Mid-Day,1,9,10,10.0
2011-09-07,12,Wednesday,Mid-Day,1,21,22,4.55
2011-09-07,13,Wednesday,Mid-Day,2,9,11,18.18
2011-09-07,14,Wednesday,Mid-Day,1,24,25,4.0
2011-09-07,15,Wednesday,Mid-Day,3,55,58,5.17
2011-09-07,16,Wednesday,Evening Rush,7,137,144,4.86
2011-09-07,17,Wednesday,Evening Rush,21,264,285,7.37
2011-09-07,18,Wednesday,Evening Rush,18,219,237,7.59
2011-09-07,19,Wednesday,Evening Rush,14,212,226,6.19
2011-09-07,20,Wednesday,Night,3,93,96,3.13
2011-09-07,21,Wednesday,Night,4,34,38,10.53
2011-09-07,22,Wednesday,Night,3,26,29,10.34
2011-09-07,23,Wednesday,Night,3,21,24,12.5
2011-09-08,0,Thursday,Early Morning,3,11,14,21.43
2011-09-08,1,Thursday,Early Morning,0,4,4,0.0
2011-09-08,3,Thursday,Early Morning,0,2,2,0.0
2011-09-08,4,Thursday,Early Morning,0,3,3,0.0
2011-09-08,5,Thursday,Early Morning,1,13,14,7.14
2011-09-08,6,Thursday,Morning Rush,1,55,56,1.79
2011-09-08,7,Thursday,Morning Rush,7,172,179,3.91
2011-09-08,8,Thursday,Morning Rush,7,188,195,3.59
2011-09-08,9,Thursday,Morning Rush,4,65,69,5.8
2011-09-08,10,Thursday,Mid-Day,8,57,65,12.31
2011-09-08,11,Thursday,Mid-Day,16,82,98,16.33
2011-09-08,12,Thursday,Mid-Day,17,85,102,16.67
2011-09-08,13,Thursday,Mid-Day,14,112,126,11.11
2011-09-08,14,Thursday,Mid-Day,15,105,120,12.5
2011-09-08,15,Thursday,Mid-Day,24,115,139,17.27
2011-09-08,16,Thursday,Evening Rush,5,151,156,3.21
2011-09-08,17,Thursday,Evening Rush,11,102,113,9.73
2011-09-08,18,Thursday,Evening Rush,2,66,68,2.94
2011-09-08,19,Thursday,Evening Rush,1,51,52,1.92
2011-09-08,20,Thursday,Night,6,83,89,6.74
2011-09-08,21,Thursday,Night,6,76,82,7.32
2011-09-08,22,Thursday,Night,5,65,70,7.14
2011-09-08,23,Thursday,Night,0,26,26,0.0
2011-09-09,0,Friday,Early Morning,1,15,16,6.25
2011-09-09,1,Friday,Early Morning,0,8,8,0.0
2011-09-09,2,Friday,Early Morning,1,7,8,12.5
2011-09-09,3,Friday,Early Morning,1,1,2,50.0
2011-09-09,4,Friday,Early Morning,0,3,3,0.0
2011-09-09,5,Friday,Early Morning,0,14,14,0.0
2011-09-09,6,Friday,Morning Rush,3,54,57,5.26
2011-09-09,7,Friday,Morning Rush,4,104,108,3.7
2011-09-09,8,Friday,Morning Rush,12,276,288,4.17
2011-09-09,9,Friday,Morning Rush,5,131,136,3.68
2011-09-09,10,Friday,Mid-Day,2,27,29,6.9
2011-09-09,11,Friday,Mid-Day,6,66,72,8.33
2011-09-09,12,Friday,Mid-Day,4,71,75,5.33
2011-09-09,13,Friday,Mid-Day,14,108,122,11.48
2011-09-09,14,Friday,Mid-Day,29,119,148,19.59
2011-09-09,15,Friday,Mid-Day,27,161,188,14.36
2011-09-09,16,Friday,Evening Rush,41,244,285,14.39
2011-09-09,17,Friday,Evening Rush,54,451,505,10.69
2011-09-09,18,Friday,Evening Rush,33,377,410,8.05
2011-09-09,19,Friday,Evening Rush,33,316,349,9.46
2011-09-09,20,Friday,Night,30,180,210,14.29
2011-09-09,21,Friday,Night,49,154,203,24.14
2011-09-09,22,Friday,Night,33,127,160,20.63
2011-09-09,23,Friday,Night,35,113,148,23.65
2011-09-10,0,Saturday,Early Morning,32,84,116,27.59
2011-09-10,1,Saturday,Early Morning,16,67,83,19.28
2011-09-10,2,Saturday,Early Morning,18,46,64,28.13
2011-09-10,3,Saturday,Early Morning,8,29,37,21.62
2011-09-10,4,Saturday,Early Morning,3,4,7,42.86
2011-09-10,5,Saturday,Early Morning,2,6,8,25.0
2011-09-10,6,Saturday,Morning Rush,0,6,6,0.0
2011-09-10,7,Saturday,Morning Rush,9,43,52,17.31
2011-09-10,8,Saturday,Morning Rush,16,103,119,13.45
2011-09-10,9,Saturday,Morning Rush,39,168,207,18.84
2011-09-10,10,Saturday,Mid-Day,85,233,318,26.73
2011-09-10,11,Saturday,Mid-Day,108,252,360,30.0
2011-09-10,12,Saturday,Mid-Day,144,260,404,35.64
2011-09-10,13,Saturday,Mid-Day,131,239,370,35.41
2011-09-10,14,Saturday,Mid-Day,129,230,359,35.93
2011-09-10,15,Saturday,Mid-Day,217,263,480,45.21
2011-09-10,16,Saturday,Evening Rush,170,261,431,39.44
2011-09-10,17,Saturday,Evening Rush,185,275,460,40.22
2011-09-10,18,Saturday,Evening Rush,119,241,360,33.06
2011-09-10,19,Saturday,Evening Rush,101,214,315,32.06
2011-09-10,20,Saturday,Night,78,167,245,31.84
2011-09-10,21,Saturday,Night,59,171,230,25.65
2011-09-10,22,Saturday,Night,49,126,175,28.0
2011-09-10,23,Saturday,Night,32,107,139,23.02
2011-09-11,0,Sunday,Early Morning,29,79,108,26.85
2011-09-11,1,Sunday,Early Morning,22,66,88,25.0
2011-09-11,2,Sunday,Early Morning,16,60,76,21.05
2011-09-11,3,Sunday,Early Morning,15,30,45,33.33
2011-09-11,4,Sunday,Early Morning,3,6,9,33.33
2011-09-11,5,Sunday,Early Morning,15,24,39,38.46
2011-09-11,6,Sunday,Morning Rush,4,16,20,20.0
2011-09-11,7,Sunday,Morning Rush,9,28,37,24.32
2011-09-11,8,Sunday,Morning Rush,25,69,94,26.6
2011-09-11,9,Sunday,Morning Rush,59,168,227,25.99
2011-09-11,10,Sunday,Mid-Day,120,214,334,35.93
2011-09-11,11,Sunday,Mid-Day,144,258,402,35.82
2011-09-11,12,Sunday,Mid-Day,113,298,411,27.49
2011-09-11,13,Sunday,Mid-Day,119,231,350,34.0
2011-09-11,14,Sunday,Mid-Day,120,222,342,35.09
2011-09-11,15,Sunday,Mid-Day,134,270,404,33.17
2011-09-11,16,Sunday,Evening Rush,180,303,483,37.27
2011-09-11,17,Sunday,Evening Rush,152,228,380,40.0
2011-09-11,18,Sunday,Evening Rush,110,229,339,32.45
2011-09-11,19,Sunday,Evening Rush,101,232,333,30.33
2011-09-11,20,Sunday,Night,65,161,226,28.76
2011-09-11,21,Sunday,Night,45,114,159,28.3
2011-09-11,22,Sunday,Night,21,74,95,22.11
2011-09-11,23,Sunday,Night,12,33,45,26.67
2011-09-12,0,Monday,Early Morning,5,11,16,31.25
2011-09-12,1,Monday,Early Morning,1,11,12,8.33
2011-09-12,2,Monday,Early Morning,2,0,2,100.0
2011-09-12,4,Monday,Early Morning,0,4,4,0.0
2011-09-12,5,Monday,Early Morning,1,23,24,4.17
2011-09-12,6,Monday,Morning Rush,1,108,109,0.92
2011-09-12,7,Monday,Morning Rush,12,300,312,3.85
2011-09-12,8,Monday,Morning Rush,26,382,408,6.37
2011-09-12,9,Monday,Morning Rush,21,155,176,11.93
2011-09-12,10,Monday,Mid-Day,40,89,129,31.01
2011-09-12,11,Monday,Mid-Day,34,131,165,20.61
2011-09-12,12,Monday,Mid-Day,37,147,184,20.11
2011-09-12,13,Monday,Mid-Day,43,120,163,26.38
2011-09-12,14,Monday,Mid-Day,60,129,189,31.75
2011-09-12,15,Monday,Mid-Day,60,152,212,28.3
2011-09-12,16,Monday,Evening Rush,60,238,298,20.13
2011-09-12,17,Monday,Evening Rush,75,515,590,12.71
2011-09-12,18,Monday,Evening Rush,56,515,571,9.81
2011-09-12,19,Monday,Evening Rush,63,373,436,14.45
2011-09-12,20,Monday,Night,41,258,299,13.71
2011-09-12,21,Monday,Night,29,166,195,14.87
2011-09-12,22,Monday,Night,16,134,150,10.67
2011-09-12,23,Monday,Night,7,62,69,10.14
2011-09-13,0,Tuesday,Early Morning,7,19,26,26.92
2011-09-13,1,Tuesday,Early Morning,4,6,10,40.0
2011-09-13,2,Tuesday,Early Morning,2,0,2,100.0
2011-09-13,3,Tuesday,Early Morning,2,2,4,50.0
2011-09-13,4,Tuesday,Early Morning,2,6,8,25.0
2011-09-13,5,Tuesday,Early Morning,1,19,20,5.0
2011-09-13,6,Tuesday,Morning Rush,6,116,122,4.92
2011-09-13,7,Tuesday,Morning Rush,14,348,362,3.87
2011-09-13,8,Tuesday,Morning Rush,26,399,425,6.12
2011-09-13,9,Tuesday,Morning Rush,35,179,214,16.36
2011-09-13,10,Tuesday,Mid-Day,42,93,135,31.11
2011-09-13,11,Tuesday,Mid-Day,33,120,153,21.57
2011-09-13,12,Tuesday,Mid-Day,43,144,187,22.99
2011-09-13,13,Tuesday,Mid-Day,48,136,184,26.09
2011-09-13,14,Tuesday,Mid-Day,51,139,190,26.84
2011-09-13,15,Tuesday,Mid-Day,35,145,180,19.44
2011-09-13,16,Tuesday,Evening Rush,41,251,292,14.04
2011-09-13,17,Tuesday,Evening Rush,72,507,579,12.44
2011-09-13,18,Tuesday,Evening Rush,67,472,539,12.43
2011-09-13,19,Tuesday,Evening Rush,55,341,396,13.89
2011-09-13,20,Tuesday,Night,31,241,272,11.4
2011-09-13,21,Tuesday,Night,45,200,245,18.37
2011-09-13,22,Tuesday,Night,24,120,144,16.67
2011-09-13,23,Tuesday,Night,15,59,74,20.27
2011-09-14,0,Wednesday,Early Morning,5,28,33,15.15
2011-09-14,1,Wednesday,Early Morning,1,7,8,12.5
2011-09-14,2,Wednesday,Early Morning,1,4,5,20.0
2011-09-14,3,Wednesday,Early Morning,1,7,8,12.5
2011-09-14,4,Wednesday,Early Morning,1,8,9,11.11
2011-09-14,5,Wednesday,Early Morning,1,30,31,3.23
2011-09-14,6,Wednesday,Morning Rush,7,138,145,4.83
2011-09-14,7,Wednesday,Morning Rush,20,350,370,5.41
2011-09-14,8,Wednesday,Morning Rush,33,396,429,7.69
2011-09-14,9,Wednesday,Morning Rush,19,183,202,9.41
2011-09-14,10,Wednesday,Mid-Day,27,115,142,19.01
2011-09-14,11,Wednesday,Mid-Day,43,121,164,26.22
2011-09-14,12,Wednesday,Mid-Day,56,156,212,26.42
2011-09-14,13,Wednesday,Mid-Day,39,139,178,21.91
2011-09-14,14,Wednesday,Mid-Day,19,105,124,15.32
2011-09-14,15,Wednesday,Mid-Day,30,146,176,17.05
2011-09-14,16,Wednesday,Evening Rush,36,241,277,13.0
2011-09-14,17,Wednesday,Evening Rush,87,512,599,14.52
2011-09-14,18,Wednesday,Evening Rush,83,503,586,14.16
2011-09-14,19,Wednesday,Evening Rush,44,337,381,11.55
2011-09-14,20,Wednesday,Night,40,221,261,15.33
2011-09-14,21,Wednesday,Night,24,189,213,11.27
2011-09-14,22,Wednesday,Night,20,140,160,12.5
2011-09-14,23,Wednesday,Night,10,62,72,13.89
2011-09-15,0,Thursday,Early Morning,3,34,37,8.11
2011-09-15,1,Thursday,Early Morning,0,20,20,0.0
2011-09-15,2,Thursday,Early Morning,0,5,5,0.0
2011-09-15,3,Thursday,Early Morning,3,5,8,37.5
2011-09-15,4,Thursday,Early Morning,2,5,7,28.57
2011-09-15,5,Thursday,Early Morning,1,30,31,3.23
2011-09-15,6,Thursday,Morning Rush,5,119,124,4.03
2011-09-15,7,Thursday,Morning Rush,17,321,338,5.03
2011-09-15,8,Thursday,Morning Rush,27,364,391,6.91
2011-09-15,9,Thursday,Morning Rush,23,186,209,11.0
2011-09-15,10,Thursday,Mid-Day,25,96,121,20.66
2011-09-15,11,Thursday,Mid-Day,39,120,159,24.53
2011-09-15,12,Thursday,Mid-Day,31,148,179,17.32
2011-09-15,13,Thursday,Mid-Day,38,151,189,20.11
2011-09-15,14,Thursday,Mid-Day,36,134,170,21.18
2011-09-15,15,Thursday,Mid-Day,25,110,135,18.52
2011-09-15,16,Thursday,Evening Rush,29,193,222,13.06
2011-09-15,17,Thursday,Evening Rush,31,230,261,11.88
2011-09-15,18,Thursday,Evening Rush,22,222,244,9.02
2011-09-15,19,Thursday,Evening Rush,20,212,232,8.62
2011-09-15,20,Thursday,Night,25,223,248,10.08
2011-09-15,21,Thursday,Night,11,134,145,7.59
2011-09-15,22,Thursday,Night,7,108,115,6.09
2011-09-15,23,Thursday,Night,8,61,69,11.59
2011-09-16,0,Friday,Early Morning,5,43,48,10.42
2011-09-16,1,Friday,Early Morning,7,19,26,26.92
2011-09-16,2,Friday,Early Morning,3,7,10,30.0
2011-09-16,3,Friday,Early Morning,2,4,6,33.33
2011-09-16,4,Friday,Early Morning,1,3,4,25.0
2011-09-16,5,Friday,Early Morning,2,30,32,6.25
2011-09-16,6,Friday,Morning Rush,6,87,93,6.45
2011-09-16,7,Friday,Morning Rush,16,283,299,5.35
2011-09-16,8,Friday,Morning Rush,23,386,409,5.62
2011-09-16,9,Friday,Morning Rush,21,189,210,10.0
2011-09-16,10,Friday,Mid-Day,36,104,140,25.71
2011-09-16,11,Friday,Mid-Day,40,139,179,22.35
2011-09-16,12,Friday,Mid-Day,39,212,251,15.54
2011-09-16,13,Friday,Mid-Day,55,168,223,24.66
2011-09-16,14,Friday,Mid-Day,49,176,225,21.78
2011-09-16,15,Friday,Mid-Day,38,165,203,18.72
2011-09-16,16,Friday,Evening Rush,67,291,358,18.72
2011-09-16,17,Friday,Evening Rush,86,480,566,15.19
2011-09-16,18,Friday,Evening Rush,55,427,482,11.41
2011-09-16,19,Friday,Evening Rush,59,256,315,18.73
2011-09-16,20,Friday,Night,41,184,225,18.22
2011-09-16,21,Friday,Night,39,124,163,23.93
2011-09-16,22,Friday,Night,32,135,167,19.16
2011-09-16,23,Friday,Night,20,106,126,15.87
2011-09-17,0,Saturday,Early Morning,28,80,108,25.93
2011-09-17,1,Saturday,Early Morning,28,52,80,35.0
2011-09-17,2,Saturday,Early Morning,18,61,79,22.78
2011-09-17,3,Saturday,Early Morning,7,21,28,25.0
2011-09-17,4,Saturday,Early Morning,1,4,5,20.0
2011-09-17,5,Saturday,Early Morning,2,3,5,40.0
2011-09-17,6,Saturday,Morning Rush,5,17,22,22.73
2011-09-17,7,Saturday,Morning Rush,4,33,37,10.81
2011-09-17,8,Saturday,Morning Rush,27,81,108,25.0
2011-09-17,9,Saturday,Morning Rush,32,145,177,18.08
2011-09-17,10,Saturday,Mid-Day,72,177,249,28.92
2011-09-17,11,Saturday,Mid-Day,119,248,367,32.43
2011-09-17,12,Saturday,Mid-Day,115,257,372,30.91
2011-09-17,13,Saturday,Mid-Day,124,225,349,35.53
2011-09-17,14,Saturday,Mid-Day,123,174,297,41.41
2011-09-17,15,Saturday,Mid-Day,148,206,354,41.81
2011-09-17,16,Saturday,Evening Rush,116,189,305,38.03
2011-09-17,17,Saturday,Evening Rush,141,218,359,39.28
2011-09-17,18,Saturday,Evening Rush,95,234,329,28.88
2011-09-17,19,Saturday,Evening Rush,70,186,256,27.34
2011-09-17,20,Saturday,Night,43,133,176,24.43
2011-09-17,21,Saturday,Night,49,121,170,28.82
2011-09-17,22,Saturday,Night,31,112,143,21.68
2011-09-17,23,Saturday,Night,36,100,136,26.47
2011-09-18,0,Sunday,Early Morning,24,88,112,21.43
2011-09-18,1,Sunday,Early Morning,13,66,79,16.46
2011-09-18,2,Sunday,Early Morning,21,68,89,23.6
2011-09-18,3,Sunday,Early Morning,11,25,36,30.56
2011-09-18,4,Sunday,Early Morning,1,0,1,100.0
2011-09-18,5,Sunday,Early Morning,1,5,6,16.67
2011-09-18,6,Sunday,Morning Rush,2,10,12,16.67
2011-09-18,7,Sunday,Morning Rush,15,29,44,34.09
2011-09-18,8,Sunday,Morning Rush,16,53,69,23.19
2011-09-18,9,Sunday,Morning Rush,46,94,140,32.86
2011-09-18,10,Sunday,Mid-Day,82,178,260,31.54
2011-09-18,11,Sunday,Mid-Day,116,201,317,36.59
2011-09-18,12,Sunday,Mid-Day,135,229,364,37.09
2011-09-18,13,Sunday,Mid-Day,162,214,376,43.09
2011-09-18,14,Sunday,Mid-Day,127,184,311,40.84
2011-09-18,15,Sunday,Mid-Day,132,233,365,36.16
2011-09-18,16,Sunday,Evening Rush,134,235,369,36.31
2011-09-18,17,Sunday,Evening Rush,95,230,325,29.23
2011-09-18,18,Sunday,Evening Rush,66,223,289,22.84
2011-09-18,19,Sunday,Evening Rush,54,191,245,22.04
2011-09-18,20,Sunday,Night,44,136,180,24.44
2011-09-18,21,Sunday,Night,37,110,147,25.17
2011-09-18,22,Sunday,Night,9,75,84,10.71
2011-09-18,23,Sunday,Night,10,44,54,18.52
2011-09-19,0,Monday,Early Morning,14,23,37,37.84
2011-09-19,1,Monday,Early Morning,3,7,10,30.0
2011-09-19,2,Monday,Early Morning,6,7,13,46.15
2011-09-19,3,Monday,Early Morning,1,4,5,20.0
2011-09-19,4,Monday,Early Morning,2,6,8,25.0
2011-09-19,5,Monday,Early Morning,2,26,28,7.14
2011-09-19,6,Monday,Morning Rush,6,107,113,5.31
2011-09-19,7,Monday,Morning Rush,20,312,332,6.02
2011-09-19,8,Monday,Morning Rush,29,391,420,6.9
2011-09-19,9,Monday,Morning Rush,32,183,215,14.88
2011-09-19,10,Monday,Mid-Day,21,84,105,20.0
2011-09-19,11,Monday,Mid-Day,41,98,139,29.5
2011-09-19,12,Monday,Mid-Day,51,138,189,26.98
2011-09-19,13,Monday,Mid-Day,53,124,177,29.94
2011-09-19,14,Monday,Mid-Day,45,143,188,23.94
2011-09-19,15,Monday,Mid-Day,44,143,187,23.53
2011-09-19,16,Monday,Evening Rush,55,208,263,20.91
2011-09-19,17,Monday,Evening Rush,85,483,568,14.96
2011-09-19,18,Monday,Evening Rush,56,484,540,10.37
2011-09-19,19,Monday,Evening Rush,41,333,374,10.96
2011-09-19,20,Monday,Night,27,204,231,11.69
2011-09-19,21,Monday,Night,19,181,200,9.5
2011-09-19,22,Monday,Night,25,104,129,19.38
2011-09-19,23,Monday,Night,13,55,68,19.12
2011-09-20,0,Tuesday,Early Morning,4,21,25,16.0
2011-09-20,1,Tuesday,Early Morning,3,11,14,21.43
2011-09-20,2,Tuesday,Early Morning,1,4,5,20.0
2011-09-20,3,Tuesday,Early Morning,0,3,3,0.0
2011-09-20,4,Tuesday,Early Morning,2,4,6,33.33
2011-09-20,5,Tuesday,Early Morning,1,21,22,4.55
2011-09-20,6,Tuesday,Morning Rush,3,111,114,2.63
2011-09-20,7,Tuesday,Morning Rush,23,306,329,6.99
2011-09-20,8,Tuesday,Morning Rush,13,196,209,6.22
2011-09-20,9,Tuesday,Morning Rush,5,64,69,7.25
2011-09-20,10,Tuesday,Mid-Day,4,26,30,13.33
2011-09-20,11,Tuesday,Mid-Day,8,48,56,14.29
2011-09-20,12,Tuesday,Mid-Day,13,47,60,21.67
2011-09-20,13,Tuesday,Mid-Day,22,81,103,21.36
2011-09-20,14,Tuesday,Mid-Day,27,85,112,24.11
2011-09-20,15,Tuesday,Mid-Day,34,158,192,17.71
2011-09-20,16,Tuesday,Evening Rush,23,241,264,8.71
2011-09-20,17,Tuesday,Evening Rush,66,445,511,12.92
2011-09-20,18,Tuesday,Evening Rush,39,453,492,7.93
2011-09-20,19,Tuesday,Evening Rush,43,294,337,12.76
2011-09-20,20,Tuesday,Night,41,212,253,16.21
2011-09-20,21,Tuesday,Night,29,177,206,14.08
2011-09-20,22,Tuesday,Night,23,125,148,15.54
2011-09-20,23,Tuesday,Night,11,70,81,13.58
2011-09-21,0,Wednesday,Early Morning,7,20,27,25.93
2011-09-21,1,Wednesday,Early Morning,0,17,17,0.0
2011-09-21,2,Wednesday,Early Morning,1,5,6,16.67
2011-09-21,3,Wednesday,Early Morning,0,6,6,0.0
2011-09-21,4,Wednesday,Early Morning,2,5,7,28.57
2011-09-21,5,Wednesday,Early Morning,1,30,31,3.23
2011-09-21,6,Wednesday,Morning Rush,5,112,117,4.27
2011-09-21,7,Wednesday,Morning Rush,18,312,330,5.45
2011-09-21,8,Wednesday,Morning Rush,18,444,462,3.9
2011-09-21,9,Wednesday,Morning Rush,21,187,208,10.1
2011-09-21,10,Wednesday,Mid-Day,30,103,133,22.56
2011-09-21,11,Wednesday,Mid-Day,42,138,180,23.33
2011-09-21,12,Wednesday,Mid-Day,42,151,193,21.76
2011-09-21,13,Wednesday,Mid-Day,37,144,181,20.44
2011-09-21,14,Wednesday,Mid-Day,40,139,179,22.35
2011-09-21,15,Wednesday,Mid-Day,43,142,185,23.24
2011-09-21,16,Wednesday,Evening Rush,51,230,281,18.15
2011-09-21,17,Wednesday,Evening Rush,61,475,536,11.38
2011-09-21,18,Wednesday,Evening Rush,24,384,408,5.88
2011-09-21,19,Wednesday,Evening Rush,30,253,283,10.6
2011-09-21,20,Wednesday,Night,11,149,160,6.88
2011-09-21,21,Wednesday,Night,25,175,200,12.5
2011-09-21,22,Wednesday,Night,15,112,127,11.81
2011-09-21,23,Wednesday,Night,15,80,95,15.79
2011-09-22,0,Thursday,Early Morning,11,30,41,26.83
2011-09-22,1,Thursday,Early Morning,5,6,11,45.45
2011-09-22,2,Thursday,Early Morning,2,8,10,20.0
2011-09-22,3,Thursday,Early Morning,5,7,12,41.67
2011-09-22,4,Thursday,Early Morning,0,2,2,0.0
2011-09-22,5,Thursday,Early Morning,2,28,30,6.67
2011-09-22,6,Thursday,Morning Rush,7,94,101,6.93
2011-09-22,7,Thursday,Morning Rush,16,295,311,5.14
2011-09-22,8,Thursday,Morning Rush,26,389,415,6.27
2011-09-22,9,Thursday,Morning Rush,35,168,203,17.24
2011-09-22,10,Thursday,Mid-Day,19,101,120,15.83
2011-09-22,11,Thursday,Mid-Day,23,142,165,13.94
2011-09-22,12,Thursday,Mid-Day,25,151,176,14.2
2011-09-22,13,Thursday,Mid-Day,38,155,193,19.69
2011-09-22,14,Thursday,Mid-Day,41,142,183,22.4
2011-09-22,15,Thursday,Mid-Day,32,149,181,17.68
2011-09-22,16,Thursday,Evening Rush,39,262,301,12.96
2011-09-22,17,Thursday,Evening Rush,50,513,563,8.88
2011-09-22,18,Thursday,Evening Rush,50,501,551,9.07
2011-09-22,19,Thursday,Evening Rush,32,388,420,7.62
2011-09-22,20,Thursday,Night,35,250,285,12.28
2011-09-22,21,Thursday,Night,27,194,221,12.22
2011-09-22,22,Thursday,Night,21,166,187,11.23
2011-09-22,23,Thursday,Night,14,99,113,12.39
2011-09-23,0,Friday,Early Morning,11,41,52,21.15
2011-09-23,1,Friday,Early Morning,2,29,31,6.45
2011-09-23,2,Friday,Early Morning,6,14,20,30.0
2011-09-23,3,Friday,Early Morning,3,5,8,37.5
2011-09-23,4,Friday,Early Morning,6,7,13,46.15
2011-09-23,5,Friday,Early Morning,2,20,22,9.09
2011-09-23,6,Friday,Morning Rush,5,99,104,4.81
2011-09-23,7,Friday,Morning Rush,14,240,254,5.51
2011-09-23,8,Friday,Morning Rush,20,297,317,6.31
2011-09-23,9,Friday,Morning Rush,3,108,111,2.7
2011-09-23,10,Friday,Mid-Day,7,28,35,20.0
2011-09-23,11,Friday,Mid-Day,1,20,21,4.76
2011-09-23,12,Friday,Mid-Day,1,28,29,3.45
2011-09-23,13,Friday,Mid-Day,7,27,34,20.59
2011-09-23,14,Friday,Mid-Day,3,21,24,12.5
2011-09-23,15,Friday,Mid-Day,9,52,61,14.75
2011-09-23,16,Friday,Evening Rush,5,51,56,8.93
2011-09-23,17,Friday,Evening Rush,13,86,99,13.13
2011-09-23,18,Friday,Evening Rush,14,220,234,5.98
2011-09-23,19,Friday,Evening Rush,16,232,248,6.45
2011-09-23,20,Friday,Night,21,158,179,11.73
2011-09-23,21,Friday,Night,17,121,138,12.32
2011-09-23,22,Friday,Night,31,126,157,19.75
2011-09-23,23,Friday,Night,41,107,148,27.7
2011-09-24,0,Saturday,Early Morning,7,86,93,7.53
2011-09-24,1,Saturday,Early Morning,18,61,79,22.78
2011-09-24,2,Saturday,Early Morning,14,54,68,20.59
2011-09-24,3,Saturday,Early Morning,4,27,31,12.9
2011-09-24,4,Saturday,Early Morning,1,7,8,12.5
2011-09-24,5,Saturday,Early Morning,2,3,5,40.0
2011-09-24,6,Saturday,Morning Rush,6,12,18,33.33
2011-09-24,7,Saturday,Morning Rush,12,34,46,26.09
2011-09-24,8,Saturday,Morning Rush,19,102,121,15.7
2011-09-24,9,Saturday,Morning Rush,41,134,175,23.43
2011-09-24,10,Saturday,Mid-Day,90,203,293,30.72
2011-09-24,11,Saturday,Mid-Day,118,268,386,30.57
2011-09-24,12,Saturday,Mid-Day,141,266,407,34.64
2011-09-24,13,Saturday,Mid-Day,170,290,460,36.96
2011-09-24,14,Saturday,Mid-Day,164,226,390,42.05
2011-09-24,15,Saturday,Mid-Day,168,284,452,37.17
2011-09-24,16,Saturday,Evening Rush,167,282,449,37.19
2011-09-24,17,Saturday,Evening Rush,180,246,426,42.25
2011-09-24,18,Saturday,Evening Rush,157,243,400,39.25
2011-09-24,19,Saturday,Evening Rush,77,231,308,25.0
2011-09-24,20,Saturday,Night,77,166,243,31.69
2011-09-24,21,Saturday,Night,66,156,222,29.73
2011-09-24,22,Saturday,Night,50,143,193,25.91
2011-09-24,23,Saturday,Night,27,123,150,18.0
2011-09-25,0,Sunday,Early Morning,37,136,173,21.39
2011-09-25,1,Sunday,Early Morning,31,93,124,25.0
2011-09-25,2,Sunday,Early Morning,27,79,106,25.47
2011-09-25,3,Sunday,Early Morning,20,39,59,33.9
2011-09-25,4,Sunday,Early Morning,3,5,8,37.5
2011-09-25,5,Sunday,Early Morning,1,2,3,33.33
2011-09-25,6,Sunday,Morning Rush,4,13,17,23.53
2011-09-25,7,Sunday,Morning Rush,15,23,38,39.47
2011-09-25,8,Sunday,Morning Rush,27,59,86,31.4
2011-09-25,9,Sunday,Morning Rush,55,100,155,35.48
2011-09-25,10,Sunday,Mid-Day,85,190,275,30.91
2011-09-25,11,Sunday,Mid-Day,131,230,361,36.29
2011-09-25,12,Sunday,Mid-Day,143,270,413,34.62
2011-09-25,13,Sunday,Mid-Day,122,247,369,33.06
2011-09-25,14,Sunday,Mid-Day,116,231,347,33.43
2011-09-25,15,Sunday,Mid-Day,119,234,353,33.71
2011-09-25,16,Sunday,Evening Rush,144,320,464,31.03
2011-09-25,17,Sunday,Evening Rush,145,275,420,34.52
2011-09-25,18,Sunday,Evening Rush,125,279,404,30.94
2011-09-25,19,Sunday,Evening Rush,87,242,329,26.44
2011-09-25,20,Sunday,Night,51,135,186,27.42
2011-09-25,21,Sunday,Night,24,113,137,17.52
2011-09-25,22,Sunday,Night,20,84,104,19.23
2011-09-25,23,Sunday,Night,12,67,79,15.19
2011-09-26,0,Monday,Early Morning,6,23,29,20.69
2011-09-26,1,Monday,Early Morning,3,14,17,17.65
2011-09-26,2,Monday,Early Morning,4,4,8,50.0
2011-09-26,3,Monday,Early Morning,0,5,5,0.0
2011-09-26,4,Monday,Early Morning,2,4,6,33.33
2011-09-26,5,Monday,Early Morning,0,25,25,0.0
2011-09-26,6,Monday,Morning Rush,6,107,113,5.31
2011-09-26,7,Monday,Morning Rush,17,315,332,5.12
2011-09-26,8,Monday,Morning Rush,29,326,355,8.17
2011-09-26,9,Monday,Morning Rush,44,161,205,21.46
2011-09-26,10,Monday,Mid-Day,37,117,154,24.03
2011-09-26,11,Monday,Mid-Day,43,116,159,27.04
2011-09-26,12,Monday,Mid-Day,48,161,209,22.97
2011-09-26,13,Monday,Mid-Day,48,139,187,25.67
2011-09-26,14,Monday,Mid-Day,44,110,154,28.57
2011-09-26,15,Monday,Mid-Day,52,157,209,24.88
2011-09-26,16,Monday,Evening Rush,74,239,313,23.64
2011-09-26,17,Monday,Evening Rush,61,509,570,10.7
2011-09-26,18,Monday,Evening Rush,63,490,553,11.39
2011-09-26,19,Monday,Evening Rush,36,347,383,9.4
2011-09-26,20,Monday,Night,24,227,251,9.56
2011-09-26,21,Monday,Night,18,164,182,9.89
2011-09-26,22,Monday,Night,14,122,136,10.29
2011-09-26,23,Monday,Night,11,64,75,14.67
2011-09-27,0,Tuesday,Early Morning,9,28,37,24.32
2011-09-27,1,Tuesday,Early Morning,4,6,10,40.0
2011-09-27,2,Tuesday,Early Morning,7,4,11,63.64
2011-09-27,3,Tuesday,Early Morning,5,5,10,50.0
2011-09-27,4,Tuesday,Early Morning,5,3,8,62.5
2011-09-27,5,Tuesday,Early Morning,0,24,24,0.0
2011-09-27,6,Tuesday,Morning Rush,8,116,124,6.45
2011-09-27,7,Tuesday,Morning Rush,15,234,249,6.02
2011-09-27,8,Tuesday,Morning Rush,27,400,427,6.32
2011-09-27,9,Tuesday,Morning Rush,20,173,193,10.36
2011-09-27,10,Tuesday,Mid-Day,21,101,122,17.21
2011-09-27,11,Tuesday,Mid-Day,26,97,123,21.14
2011-09-27,12,Tuesday,Mid-Day,33,129,162,20.37
2011-09-27,13,Tuesday,Mid-Day,29,122,151,19.21
2011-09-27,14,Tuesday,Mid-Day,29,123,152,19.08
2011-09-27,15,Tuesday,Mid-Day,35,170,205,17.07
2011-09-27,16,Tuesday,Evening Rush,33,225,258,12.79
2011-09-27,17,Tuesday,Evening Rush,50,480,530,9.43
2011-09-27,18,Tuesday,Evening Rush,31,325,356,8.71
2011-09-27,19,Tuesday,Evening Rush,26,294,320,8.13
2011-09-27,20,Tuesday,Night,17,221,238,7.14
2011-09-27,21,Tuesday,Night,17,179,196,8.67
2011-09-27,22,Tuesday,Night,19,102,121,15.7
2011-09-27,23,Tuesday,Night,11,82,93,11.83
2011-09-28,0,Wednesday,Early Morning,7,29,36,19.44
2011-09-28,1,Wednesday,Early Morning,1,13,14,7.14
2011-09-28,2,Wednesday,Early Morning,0,9,9,0.0
2011-09-28,3,Wednesday,Early Morning,0,3,3,0.0
2011-09-28,4,Wednesday,Early Morning,1,3,4,25.0
2011-09-28,5,Wednesday,Early Morning,2,20,22,9.09
2011-09-28,6,Wednesday,Morning Rush,3,111,114,2.63
2011-09-28,7,Wednesday,Morning Rush,8,177,185,4.32
2011-09-28,8,Wednesday,Morning Rush,17,270,287,5.92
2011-09-28,9,Wednesday,Morning Rush,14,141,155,9.03
2011-09-28,10,Wednesday,Mid-Day,20,109,129,15.5
2011-09-28,11,Wednesday,Mid-Day,24,127,151,15.89
2011-09-28,12,Wednesday,Mid-Day,25,159,184,13.59
2011-09-28,13,Wednesday,Mid-Day,24,138,162,14.81
2011-09-28,14,Wednesday,Mid-Day,25,145,170,14.71
2011-09-28,15,Wednesday,Mid-Day,35,146,181,19.34
2011-09-28,16,Wednesday,Evening Rush,39,241,280,13.93
2011-09-28,17,Wednesday,Evening Rush,64,527,591,10.83
2011-09-28,18,Wednesday,Evening Rush,65,459,524,12.4
2011-09-28,19,Wednesday,Evening Rush,57,315,372,15.32
2011-09-28,20,Wednesday,Night,11,91,102,10.78
2011-09-28,21,Wednesday,Night,7,67,74,9.46
2011-09-28,22,Wednesday,Night,19,68,87,21.84
2011-09-28,23,Wednesday,Night,12,59,71,16.9
2011-09-29,0,Thursday,Early Morning,7,33,40,17.5
2011-09-29,1,Thursday,Early Morning,3,20,23,13.04
2011-09-29,2,Thursday,Early Morning,0,2,2,0.0
2011-09-29,3,Thursday,Early Morning,0,8,8,0.0
2011-09-29,4,Thursday,Early Morning,2,5,7,28.57
2011-09-29,5,Thursday,Early Morning,0,22,22,0.0
2011-09-29,6,Thursday,Morning Rush,5,106,111,4.5
2011-09-29,7,Thursday,Morning Rush,14,269,283,4.95
2011-09-29,8,Thursday,Morning Rush,29,402,431,6.73
2011-09-29,9,Thursday,Morning Rush,27,198,225,12.0
2011-09-29,10,Thursday,Mid-Day,24,103,127,18.9
2011-09-29,11,Thursday,Mid-Day,36,122,158,22.78
2011-09-29,12,Thursday,Mid-Day,38,157,195,19.49
2011-09-29,13,Thursday,Mid-Day,36,175,211,17.06
2011-09-29,14,Thursday,Mid-Day,33,134,167,19.76
2011-09-29,15,Thursday,Mid-Day,42,185,227,18.5
2011-09-29,16,Thursday,Evening Rush,64,227,291,21.99
2011-09-29,17,Thursday,Evening Rush,62,527,589,10.53
2011-09-29,18,Thursday,Evening Rush,84,500,584,14.38
2011-09-29,19,Thursday,Evening Rush,36,348,384,9.38
2011-09-29,20,Thursday,Night,39,234,273,14.29
2011-09-29,21,Thursday,Night,30,195,225,13.33
2011-09-29,22,Thursday,Night,25,150,175,14.29
2011-09-29,23,Thursday,Night,17,64,81,20.99
2011-09-30,0,Friday,Early Morning,7,53,60,11.67
2011-09-30,1,Friday,Early Morning,5,18,23,21.74
2011-09-30,2,Friday,Early Morning,6,9,15,40.0
2011-09-30,3,Friday,Early Morning,0,3,3,0.0
2011-09-30,4,Friday,Early Morning,2,6,8,25.0
2011-09-30,5,Friday,Early Morning,3,23,26,11.54
2011-09-30,6,Friday,Morning Rush,0,98,98,0.0
2011-09-30,7,Friday,Morning Rush,14,283,297,4.71
2011-09-30,8,Friday,Morning Rush,31,425,456,6.8
2011-09-30,9,Friday,Morning Rush,23,214,237,9.7
2011-09-30,10,Friday,Mid-Day,46,122,168,27.38
2011-09-30,11,Friday,Mid-Day,49,168,217,22.58
2011-09-30,12,Friday,Mid-Day,59,195,254,23.23
2011-09-30,13,Friday,Mid-Day,72,194,266,27.07
2011-09-30,14,Friday,Mid-Day,93,173,266,34.96
2011-09-30,15,Friday,Mid-Day,52,193,245,21.22
2011-09-30,16,Friday,Evening Rush,62,298,360,17.22
2011-09-30,17,Friday,Evening Rush,94,497,591,15.91
2011-09-30,18,Friday,Evening Rush,62,449,511,12.13
2011-09-30,19,Friday,Evening Rush,42,332,374,11.23
2011-09-30,20,Friday,Night,28,202,230,12.17
2011-09-30,21,Friday,Night,27,179,206,13.11
2011-09-30,22,Friday,Night,30,129,159,18.87
2011-09-30,23,Friday,Night,23,109,132,17.42
2011-10-01,0,Saturday,Early Morning,24,106,130,18.46
2011-10-01,1,Saturday,Early Morning,11,47,58,18.97
2011-10-01,2,Saturday,Early Morning,21,46,67,31.34
2011-10-01,3,Saturday,Early Morning,8,17,25,32.0
2011-10-01,4,Saturday,Early Morning,2,6,8,25.0
2011-10-01,5,Saturday,Early Morning,1,4,5,20.0
2011-10-01,6,Saturday,Morning Rush,4,15,19,21.05
2011-10-01,7,Saturday,Morning Rush,6,30,36,16.67
2011-10-01,8,Saturday,Morning Rush,9,58,67,13.43
2011-10-01,9,Saturday,Morning Rush,17,112,129,13.18
2011-10-01,10,Saturday,Mid-Day,21,100,121,17.36
2011-10-01,11,Saturday,Mid-Day,30,102,132,22.73
2011-10-01,12,Saturday,Mid-Day,28,130,158,17.72
2011-10-01,13,Saturday,Mid-Day,27,98,125,21.6
2011-10-01,14,Saturday,Mid-Day,33,147,180,18.33
2011-10-01,15,Saturday,Mid-Day,41,154,195,21.03
2011-10-01,16,Saturday,Evening Rush,58,165,223,26.01
2011-10-01,17,Saturday,Evening Rush,58,170,228,25.44
2011-10-01,18,Saturday,Evening Rush,23,117,140,16.43
2011-10-01,19,Saturday,Evening Rush,27,99,126,21.43
2011-10-01,20,Saturday,Night,8,58,66,12.12
2011-10-01,21,Saturday,Night,3,53,56,5.36
2011-10-01,22,Saturday,Night,12,58,70,17.14
2011-10-01,23,Saturday,Night,8,57,65,12.31
2011-10-02,0,Sunday,Early Morning,4,43,47,8.51
2011-10-02,1,Sunday,Early Morning,1,23,24,4.17
2011-10-02,2,Sunday,Early Morning,3,27,30,10.0
2011-10-02,3,Sunday,Early Morning,4,5,9,44.44
2011-10-02,4,Sunday,Early Morning,4,3,7,57.14
2011-10-02,5,Sunday,Early Morning,0,7,7,0.0
2011-10-02,6,Sunday,Morning Rush,2,13,15,13.33
2011-10-02,7,Sunday,Morning Rush,5,24,29,17.24
2011-10-02,8,Sunday,Morning Rush,14,50,64,21.88
2011-10-02,9,Sunday,Morning Rush,19,96,115,16.52
2011-10-02,10,Sunday,Mid-Day,60,188,248,24.19
2011-10-02,11,Sunday,Mid-Day,74,218,292,25.34
2011-10-02,12,Sunday,Mid-Day,78,243,321,24.3
2011-10-02,13,Sunday,Mid-Day,84,224,308,27.27
2011-10-02,14,Sunday,Mid-Day,61,195,256,23.83
2011-10-02,15,Sunday,Mid-Day,29,144,173,16.76
2011-10-02,16,Sunday,Evening Rush,44,162,206,21.36
2011-10-02,17,Sunday,Evening Rush,32,135,167,19.16
2011-10-02,18,Sunday,Evening Rush,16,158,174,9.2
2011-10-02,19,Sunday,Evening Rush,34,128,162,20.99
2011-10-02,20,Sunday,Night,16,71,87,18.39
2011-10-02,21,Sunday,Night,17,71,88,19.32
2011-10-02,22,Sunday,Night,9,55,64,14.06
2011-10-02,23,Sunday,Night,6,19,25,24.0
2011-10-03,0,Monday,Early Morning,3,13,16,18.75
2011-10-03,1,Monday,Early Morning,1,5,6,16.67
2011-10-03,2,Monday,Early Morning,0,4,4,0.0
2011-10-03,3,Monday,Early Morning,1,6,7,14.29
2011-10-03,4,Monday,Early Morning,2,6,8,25.0
2011-10-03,5,Monday,Early Morning,4,17,21,19.05
2011-10-03,6,Monday,Morning Rush,3,91,94,3.19
2011-10-03,7,Monday,Morning Rush,8,241,249,3.21
2011-10-03,8,Monday,Morning Rush,13,359,372,3.49
2011-10-03,9,Monday,Morning Rush,12,141,153,7.84
2011-10-03,10,Monday,Mid-Day,19,82,101,18.81
2011-10-03,11,Monday,Mid-Day,26,100,126,20.63
2011-10-03,12,Monday,Mid-Day,29,118,147,19.73
2011-10-03,13,Monday,Mid-Day,16,102,118,13.56
2011-10-03,14,Monday,Mid-Day,26,94,120,21.67
2011-10-03,15,Monday,Mid-Day,22,79,101,21.78
2011-10-03,16,Monday,Evening Rush,16,202,218,7.34
2011-10-03,17,Monday,Evening Rush,40,455,495,8.08
2011-10-03,18,Monday,Evening Rush,28,384,412,6.8
2011-10-03,19,Monday,Evening Rush,15,300,315,4.76
2011-10-03,20,Monday,Night,13,191,204,6.37
2011-10-03,21,Monday,Night,10,128,138,7.25
2011-10-03,22,Monday,Night,12,79,91,13.19
2011-10-03,23,Monday,Night,11,43,54,20.37
2011-10-04,0,Tuesday,Early Morning,5,22,27,18.52
2011-10-04,1,Tuesday,Early Morning,1,8,9,11.11
2011-10-04,2,Tuesday,Early Morning,1,2,3,33.33
2011-10-04,3,Tuesday,Early Morning,3,3,6,50.0
2011-10-04,4,Tuesday,Early Morning,3,4,7,42.86
2011-10-04,5,Tuesday,Early Morning,2,25,27,7.41
2011-10-04,6,Tuesday,Morning Rush,3,109,112,2.68
2011-10-04,7,Tuesday,Morning Rush,11,298,309,3.56
2011-10-04,8,Tuesday,Morning Rush,28,372,400,7.0
2011-10-04,9,Tuesday,Morning Rush,19,168,187,10.16
2011-10-04,10,Tuesday,Mid-Day,19,107,126,15.08
2011-10-04,11,Tuesday,Mid-Day,22,102,124,17.74
2011-10-04,12,Tuesday,Mid-Day,39,160,199,19.6
2011-10-04,13,Tuesday,Mid-Day,20,153,173,11.56
2011-10-04,14,Tuesday,Mid-Day,27,156,183,14.75
2011-10-04,15,Tuesday,Mid-Day,28,166,194,14.43
2011-10-04,16,Tuesday,Evening Rush,36,273,309,11.65
2011-10-04,17,Tuesday,Evening Rush,55,530,585,9.4
2011-10-04,18,Tuesday,Evening Rush,68,456,524,12.98
2011-10-04,19,Tuesday,Evening Rush,35,310,345,10.14
2011-10-04,20,Tuesday,Night,25,236,261,9.58
2011-10-04,21,Tuesday,Night,22,144,166,13.25
2011-10-04,22,Tuesday,Night,8,106,114,7.02
2011-10-04,23,Tuesday,Night,6,60,66,9.09
2011-10-05,0,Wednesday,Early Morning,7,36,43,16.28
2011-10-05,1,Wednesday,Early Morning,4,7,11,36.36
2011-10-05,2,Wednesday,Early Morning,1,2,3,33.33
2011-10-05,3,Wednesday,Early Morning,1,5,6,16.67
2011-10-05,4,Wednesday,Early Morning,1,4,5,20.0
2011-10-05,5,Wednesday,Early Morning,3,29,32,9.38
2011-10-05,6,Wednesday,Morning Rush,5,112,117,4.27
2011-10-05,7,Wednesday,Morning Rush,9,292,301,2.99
2011-10-05,8,Wednesday,Morning Rush,26,441,467,5.57
2011-10-05,9,Wednesday,Morning Rush,32,187,219,14.61
2011-10-05,10,Wednesday,Mid-Day,30,103,133,22.56
2011-10-05,11,Wednesday,Mid-Day,32,138,170,18.82
2011-10-05,12,Wednesday,Mid-Day,34,180,214,15.89
2011-10-05,13,Wednesday,Mid-Day,30,189,219,13.7
2011-10-05,14,Wednesday,Mid-Day,34,156,190,17.89
2011-10-05,15,Wednesday,Mid-Day,35,147,182,19.23
2011-10-05,16,Wednesday,Evening Rush,37,245,282,13.12
2011-10-05,17,Wednesday,Evening Rush,66,525,591,11.17
2011-10-05,18,Wednesday,Evening Rush,57,536,593,9.61
2011-10-05,19,Wednesday,Evening Rush,40,334,374,10.7
2011-10-05,20,Wednesday,Night,18,228,246,7.32
2011-10-05,21,Wednesday,Night,28,173,201,13.93
2011-10-05,22,Wednesday,Night,20,134,154,12.99
2011-10-05,23,Wednesday,Night,9,64,73,12.33
2011-10-06,0,Thursday,Early Morning,6,34,40,15.0
2011-10-06,1,Thursday,Early Morning,5,17,22,22.73
2011-10-06,2,Thursday,Early Morning,2,8,10,20.0
2011-10-06,3,Thursday,Early Morning,1,4,5,20.0
2011-10-06,4,Thursday,Early Morning,0,5,5,0.0
2011-10-06,5,Thursday,Early Morning,0,24,24,0.0
2011-10-06,6,Thursday,Morning Rush,4,110,114,3.51
2011-10-06,7,Thursday,Morning Rush,15,287,302,4.97
2011-10-06,8,Thursday,Morning Rush,20,437,457,4.38
2011-10-06,9,Thursday,Morning Rush,20,188,208,9.62
2011-10-06,10,Thursday,Mid-Day,24,105,129,18.6
2011-10-06,11,Thursday,Mid-Day,29,115,144,20.14
2011-10-06,12,Thursday,Mid-Day,46,180,226,20.35
2011-10-06,13,Thursday,Mid-Day,33,158,191,17.28
2011-10-06,14,Thursday,Mid-Day,56,139,195,28.72
2011-10-06,15,Thursday,Mid-Day,62,157,219,28.31
2011-10-06,16,Thursday,Evening Rush,51,272,323,15.79
2011-10-06,17,Thursday,Evening Rush,63,505,568,11.09
2011-10-06,18,Thursday,Evening Rush,59,479,538,10.97
2011-10-06,19,Thursday,Evening Rush,38,305,343,11.08
2011-10-06,20,Thursday,Night,29,231,260,11.15
2011-10-06,21,Thursday,Night,34,161,195,17.44
2011-10-06,22,Thursday,Night,24,124,148,16.22
2011-10-06,23,Thursday,Night,18,81,99,18.18
2011-10-07,0,Friday,Early Morning,19,48,67,28.36
2011-10-07,1,Friday,Early Morning,3,25,28,10.71
2011-10-07,2,Friday,Early Morning,0,5,5,0.0
2011-10-07,3,Friday,Early Morning,1,9,10,10.0
2011-10-07,4,Friday,Early Morning,0,5,5,0.0
2011-10-07,5,Friday,Early Morning,3,24,27,11.11
2011-10-07,6,Friday,Morning Rush,3,84,87,3.45
2011-10-07,7,Friday,Morning Rush,5,237,242,2.07
2011-10-07,8,Friday,Morning Rush,31,386,417,7.43
2011-10-07,9,Friday,Morning Rush,34,207,241,14.11
2011-10-07,10,Friday,Mid-Day,48,126,174,27.59
2011-10-07,11,Friday,Mid-Day,80,150,230,34.78
2011-10-07,12,Friday,Mid-Day,61,174,235,25.96
2011-10-07,13,Friday,Mid-Day,95,210,305,31.15
2011-10-07,14,Friday,Mid-Day,77,179,256,30.08
2011-10-07,15,Friday,Mid-Day,68,202,270,25.19
2011-10-07,16,Friday,Evening Rush,73,346,419,17.42
2011-10-07,17,Friday,Evening Rush,101,462,563,17.94
2011-10-07,18,Friday,Evening Rush,94,371,465,20.22
2011-10-07,19,Friday,Evening Rush,51,243,294,17.35
2011-10-07,20,Friday,Night,30,167,197,15.23
2011-10-07,21,Friday,Night,22,144,166,13.25
2011-10-07,22,Friday,Night,27,119,146,18.49
2011-10-07,23,Friday,Night,23,113,136,16.91
2011-10-08,0,Saturday,Early Morning,17,72,89,19.1
2011-10-08,1,Saturday,Early Morning,14,51,65,21.54
2011-10-08,2,Saturday,Early Morning,4,41,45,8.89
2011-10-08,3,Saturday,Early Morning,4,16,20,20.0
2011-10-08,4,Saturday,Early Morning,3,7,10,30.0
2011-10-08,5,Saturday,Early Morning,1,7,8,12.5
2011-10-08,6,Saturday,Morning Rush,6,16,22,27.27
2011-10-08,7,Saturday,Morning Rush,27,46,73,36.99
2011-10-08,8,Saturday,Morning Rush,14,89,103,13.59
2011-10-08,9,Saturday,Morning Rush,54,163,217,24.88
2011-10-08,10,Saturday,Mid-Day,120,217,337,35.61
2011-10-08,11,Saturday,Mid-Day,176,221,397,44.33
2011-10-08,12,Saturday,Mid-Day,191,255,446,42.83
2011-10-08,13,Saturday,Mid-Day,256,229,485,52.78
2011-10-08,14,Saturday,Mid-Day,251,214,465,53.98
2011-10-08,15,Saturday,Mid-Day,262,234,496,52.82
2011-10-08,16,Saturday,Evening Rush,221,230,451,49.0
2011-10-08,17,Saturday,Evening Rush,174,219,393,44.27
2011-10-08,18,Saturday,Evening Rush,135,224,359,37.6
2011-10-08,19,Saturday,Evening Rush,76,172,248,30.65
2011-10-08,20,Saturday,Night,78,124,202,38.61
2011-10-08,21,Saturday,Night,54,133,187,28.88
2011-10-08,22,Saturday,Night,45,104,149,30.2
2011-10-08,23,Saturday,Night,52,90,142,36.62
2011-10-09,0,Sunday,Early Morning,46,83,129,35.66
2011-10-09,1,Sunday,Early Morning,15,63,78,19.23
2011-10-09,2,Sunday,Early Morning,20,35,55,36.36
2011-10-09,3,Sunday,Early Morning,10,20,30,33.33
2011-10-09,4,Sunday,Early Morning,7,7,14,50.0
2011-10-09,5,Sunday,Early Morning,1,14,15,6.67
2011-10-09,6,Sunday,Morning Rush,7,14,21,33.33
2011-10-09,7,Sunday,Morning Rush,18,26,44,40.91
2011-10-09,8,Sunday,Morning Rush,25,82,107,23.36
2011-10-09,9,Sunday,Morning Rush,66,119,185,35.68
2011-10-09,10,Sunday,Mid-Day,155,210,365,42.47
2011-10-09,11,Sunday,Mid-Day,189,234,423,44.68
2011-10-09,12,Sunday,Mid-Day,212,243,455,46.59
2011-10-09,13,Sunday,Mid-Day,225,193,418,53.83
2011-10-09,14,Sunday,Mid-Day,272,228,500,54.4
2011-10-09,15,Sunday,Mid-Day,198,209,407,48.65
2011-10-09,16,Sunday,Evening Rush,223,247,470,47.45
2011-10-09,17,Sunday,Evening Rush,208,230,438,47.49
2011-10-09,18,Sunday,Evening Rush,186,228,414,44.93
2011-10-09,19,Sunday,Evening Rush,116,186,302,38.41
2011-10-09,20,Sunday,Night,59,134,193,30.57
2011-10-09,21,Sunday,Night,53,120,173,30.64
2011-10-09,22,Sunday,Night,48,104,152,31.58
2011-10-09,23,Sunday,Night,38,85,123,30.89
2011-10-10,0,Monday,Early Morning,11,42,53,20.75
2011-10-10,1,Monday,Early Morning,4,30,34,11.76
2011-10-10,2,Monday,Early Morning,4,15,19,21.05
2011-10-10,3,Monday,Early Morning,2,9,11,18.18
2011-10-10,4,Monday,Early Morning,2,4,6,33.33
2011-10-10,5,Monday,Early Morning,2,19,21,9.52
2011-10-10,6,Monday,Morning Rush,5,39,44,11.36
2011-10-10,7,Monday,Morning Rush,12,102,114,10.53
2011-10-10,8,Monday,Morning Rush,27,227,254,10.63
2011-10-10,9,Monday,Morning Rush,58,161,219,26.48
2011-10-10,10,Monday,Mid-Day,107,158,265,40.38
2011-10-10,11,Monday,Mid-Day,139,183,322,43.17
2011-10-10,12,Monday,Mid-Day,164,201,365,44.93
2011-10-10,13,Monday,Mid-Day,146,219,365,40.0
2011-10-10,14,Monday,Mid-Day,147,223,370,39.73
2011-10-10,15,Monday,Mid-Day,130,254,384,33.85
2011-10-10,16,Monday,Evening Rush,154,248,402,38.31
2011-10-10,17,Monday,Evening Rush,125,334,459,27.23
2011-10-10,18,Monday,Evening Rush,108,365,473,22.83
2011-10-10,19,Monday,Evening Rush,69,267,336,20.54
2011-10-10,20,Monday,Night,37,188,225,16.44
2011-10-10,21,Monday,Night,27,148,175,15.43
2011-10-10,22,Monday,Night,22,104,126,17.46
2011-10-10,23,Monday,Night,12,63,75,16.0
2011-10-11,0,Tuesday,Early Morning,14,16,30,46.67
2011-10-11,1,Tuesday,Early Morning,2,9,11,18.18
2011-10-11,2,Tuesday,Early Morning,1,4,5,20.0
2011-10-11,3,Tuesday,Early Morning,2,1,3,66.67
2011-10-11,4,Tuesday,Early Morning,0,5,5,0.0
2011-10-11,5,Tuesday,Early Morning,0,20,20,0.0
2011-10-11,6,Tuesday,Morning Rush,9,114,123,7.32
2011-10-11,7,Tuesday,Morning Rush,19,333,352,5.4
2011-10-11,8,Tuesday,Morning Rush,31,375,406,7.64
2011-10-11,9,Tuesday,Morning Rush,40,195,235,17.02
2011-10-11,10,Tuesday,Mid-Day,38,111,149,25.5
2011-10-11,11,Tuesday,Mid-Day,31,92,123,25.2
2011-10-11,12,Tuesday,Mid-Day,51,130,181,28.18
2011-10-11,13,Tuesday,Mid-Day,42,138,180,23.33
2011-10-11,14,Tuesday,Mid-Day,54,117,171,31.58
2011-10-11,15,Tuesday,Mid-Day,36,139,175,20.57
2011-10-11,16,Tuesday,Evening Rush,63,257,320,19.69
2011-10-11,17,Tuesday,Evening Rush,70,534,604,11.59
2011-10-11,18,Tuesday,Evening Rush,46,493,539,8.53
2011-10-11,19,Tuesday,Evening Rush,33,285,318,10.38
2011-10-11,20,Tuesday,Night,31,203,234,13.25
2011-10-11,21,Tuesday,Night,17,158,175,9.71
2011-10-11,22,Tuesday,Night,27,120,147,18.37
2011-10-11,23,Tuesday,Night,10,47,57,17.54
2011-10-12,0,Wednesday,Early Morning,2,23,25,8.0
2011-10-12,1,Wednesday,Early Morning,2,8,10,20.0
2011-10-12,2,Wednesday,Early Morning,0,2,2,0.0
2011-10-12,3,Wednesday,Early Morning,0,2,2,0.0
2011-10-12,4,Wednesday,Early Morning,1,6,7,14.29
2011-10-12,5,Wednesday,Early Morning,0,22,22,0.0
2011-10-12,6,Wednesday,Morning Rush,5,107,112,4.46
2011-10-12,7,Wednesday,Morning Rush,15,244,259,5.79
2011-10-12,8,Wednesday,Morning Rush,27,377,404,6.68
2011-10-12,9,Wednesday,Morning Rush,14,183,197,7.11
2011-10-12,10,Wednesday,Mid-Day,15,98,113,13.27
2011-10-12,11,Wednesday,Mid-Day,18,102,120,15.0
2011-10-12,12,Wednesday,Mid-Day,9,53,62,14.52
2011-10-12,13,Wednesday,Mid-Day,25,76,101,24.75
2011-10-12,14,Wednesday,Mid-Day,8,70,78,10.26
2011-10-12,15,Wednesday,Mid-Day,3,42,45,6.67
2011-10-12,16,Wednesday,Evening Rush,5,50,55,9.09
2011-10-12,17,Wednesday,Evening Rush,16,235,251,6.37
2011-10-12,18,Wednesday,Evening Rush,11,161,172,6.4
2011-10-12,19,Wednesday,Evening Rush,7,102,109,6.42
2011-10-12,20,Wednesday,Night,9,81,90,10.0
2011-10-12,21,Wednesday,Night,9,74,83,10.84
2011-10-12,22,Wednesday,Night,3,40,43,6.98
2011-10-12,23,Wednesday,Night,13,41,54,24.07
2011-10-13,0,Thursday,Early Morning,1,14,15,6.67
2011-10-13,1,Thursday,Early Morning,3,9,12,25.0
2011-10-13,2,Thursday,Early Morning,0,4,4,0.0
2011-10-13,3,Thursday,Early Morning,2,4,6,33.33
2011-10-13,4,Thursday,Early Morning,2,5,7,28.57
2011-10-13,5,Thursday,Early Morning,1,16,17,5.88
2011-10-13,6,Thursday,Morning Rush,1,51,52,1.92
2011-10-13,7,Thursday,Morning Rush,5,76,81,6.17
2011-10-13,8,Thursday,Morning Rush,10,199,209,4.78
2011-10-13,9,Thursday,Morning Rush,3,106,109,2.75
2011-10-13,10,Thursday,Mid-Day,16,53,69,23.19
2011-10-13,11,Thursday,Mid-Day,8,76,84,9.52
2011-10-13,12,Thursday,Mid-Day,10,95,105,9.52
2011-10-13,13,Thursday,Mid-Day,20,142,162,12.35
2011-10-13,14,Thursday,Mid-Day,22,111,133,16.54
2011-10-13,15,Thursday,Mid-Day,27,128,155,17.42
2011-10-13,16,Thursday,Evening Rush,36,240,276,13.04
2011-10-13,17,Thursday,Evening Rush,47,432,479,9.81
2011-10-13,18,Thursday,Evening Rush,20,248,268,7.46
2011-10-13,19,Thursday,Evening Rush,18,187,205,8.78
2011-10-13,20,Thursday,Night,15,166,181,8.29
2011-10-13,21,Thursday,Night,8,115,123,6.5
2011-10-13,22,Thursday,Night,13,101,114,11.4
2011-10-13,23,Thursday,Night,2,45,47,4.26
2011-10-14,0,Friday,Early Morning,10,29,39,25.64
2011-10-14,1,Friday,Early Morning,8,16,24,33.33
2011-10-14,2,Friday,Early Morning,0,6,6,0.0
2011-10-14,3,Friday,Early Morning,1,6,7,14.29
2011-10-14,4,Friday,Early Morning,0,8,8,0.0
2011-10-14,5,Friday,Early Morning,0,17,17,0.0
2011-10-14,6,Friday,Morning Rush,4,90,94,4.26
2011-10-14,7,Friday,Morning Rush,10,137,147,6.8
2011-10-14,8,Friday,Morning Rush,23,186,209,11.0
2011-10-14,9,Friday,Morning Rush,16,164,180,8.89
2011-10-14,10,Friday,Mid-Day,17,108,125,13.6
2011-10-14,11,Friday,Mid-Day,11,76,87,12.64
2011-10-14,12,Friday,Mid-Day,13,62,75,17.33
2011-10-14,13,Friday,Mid-Day,18,114,132,13.64
2011-10-14,14,Friday,Mid-Day,37,119,156,23.72
2011-10-14,15,Friday,Mid-Day,61,169,230,26.52
2011-10-14,16,Friday,Evening Rush,80,264,344,23.26
2011-10-14,17,Friday,Evening Rush,55,426,481,11.43
2011-10-14,18,Friday,Evening Rush,62,361,423,14.66
2011-10-14,19,Friday,Evening Rush,27,221,248,10.89
2011-10-14,20,Friday,Night,19,177,196,9.69
2011-10-14,21,Friday,Night,22,156,178,12.36
2011-10-14,22,Friday,Night,20,123,143,13.99
2011-10-14,23,Friday,Night,15,80,95,15.79
2011-10-15,0,Saturday,Early Morning,18,88,106,16.98
2011-10-15,1,Saturday,Early Morning,9,64,73,12.33
2011-10-15,2,Saturday,Early Morning,17,39,56,30.36
2011-10-15,3,Saturday,Early Morning,5,18,23,21.74
2011-10-15,4,Saturday,Early Morning,0,6,6,0.0
2011-10-15,5,Saturday,Early Morning,1,6,7,14.29
2011-10-15,6,Saturday,Morning Rush,5,15,20,25.0
2011-10-15,7,Saturday,Morning Rush,17,40,57,29.82
2011-10-15,8,Saturday,Morning Rush,24,101,125,19.2
2011-10-15,9,Saturday,Morning Rush,50,157,207,24.15
2011-10-15,10,Saturday,Mid-Day,115,207,322,35.71
2011-10-15,11,Saturday,Mid-Day,153,221,374,40.91
2011-10-15,12,Saturday,Mid-Day,195,261,456,42.76
2011-10-15,13,Saturday,Mid-Day,171,223,394,43.4
2011-10-15,14,Saturday,Mid-Day,242,230,472,51.27
2011-10-15,15,Saturday,Mid-Day,166,211,377,44.03
2011-10-15,16,Saturday,Evening Rush,179,264,443,40.41
2011-10-15,17,Saturday,Evening Rush,177,264,441,40.14
2011-10-15,18,Saturday,Evening Rush,121,251,372,32.53
2011-10-15,19,Saturday,Evening Rush,61,177,238,25.63
2011-10-15,20,Saturday,Night,42,137,179,23.46
2011-10-15,21,Saturday,Night,53,115,168,31.55
2011-10-15,22,Saturday,Night,45,121,166,27.11
2011-10-15,23,Saturday,Night,33,102,135,24.44
2011-10-16,0,Sunday,Early Morning,22,85,107,20.56
2011-10-16,1,Sunday,Early Morning,13,64,77,16.88
2011-10-16,2,Sunday,Early Morning,13,52,65,20.0
2011-10-16,3,Sunday,Early Morning,11,31,42,26.19
2011-10-16,4,Sunday,Early Morning,5,7,12,41.67
2011-10-16,5,Sunday,Early Morning,1,6,7,14.29
2011-10-16,6,Sunday,Morning Rush,3,7,10,30.0
2011-10-16,7,Sunday,Morning Rush,9,39,48,18.75
2011-10-16,8,Sunday,Morning Rush,28,71,99,28.28
2011-10-16,9,Sunday,Morning Rush,39,151,190,20.53
2011-10-16,10,Sunday,Mid-Day,121,226,347,34.87
2011-10-16,11,Sunday,Mid-Day,159,218,377,42.18
2011-10-16,12,Sunday,Mid-Day,167,277,444,37.61
2011-10-16,13,Sunday,Mid-Day,169,269,438,38.58
2011-10-16,14,Sunday,Mid-Day,204,258,462,44.16
2011-10-16,15,Sunday,Mid-Day,182,230,412,44.17
2011-10-16,16,Sunday,Evening Rush,177,289,466,37.98
2011-10-16,17,Sunday,Evening Rush,152,253,405,37.53
2011-10-16,18,Sunday,Evening Rush,102,226,328,31.1
2011-10-16,19,Sunday,Evening Rush,52,181,233,22.32
2011-10-16,20,Sunday,Night,49,129,178,27.53
2011-10-16,21,Sunday,Night,14,88,102,13.73
2011-10-16,22,Sunday,Night,42,88,130,32.31
2011-10-16,23,Sunday,Night,14,48,62,22.58
2011-10-17,0,Monday,Early Morning,12,25,37,32.43
2011-10-17,1,Monday,Early Morning,2,15,17,11.76
2011-10-17,2,Monday,Early Morning,4,3,7,57.14
2011-10-17,3,Monday,Early Morning,0,2,2,0.0
2011-10-17,4,Monday,Early Morning,2,3,5,40.0
2011-10-17,5,Monday,Early Morning,1,28,29,3.45
2011-10-17,6,Monday,Morning Rush,7,107,114,6.14
2011-10-17,7,Monday,Morning Rush,10,299,309,3.24
2011-10-17,8,Monday,Morning Rush,33,381,414,7.97
2011-10-17,9,Monday,Morning Rush,26,180,206,12.62
2011-10-17,10,Monday,Mid-Day,43,92,135,31.85
2011-10-17,11,Monday,Mid-Day,35,131,166,21.08
2011-10-17,12,Monday,Mid-Day,39,166,205,19.02
2011-10-17,13,Monday,Mid-Day,49,156,205,23.9
2011-10-17,14,Monday,Mid-Day,44,122,166,26.51
2011-10-17,15,Monday,Mid-Day,66,142,208,31.73
2011-10-17,16,Monday,Evening Rush,64,238,302,21.19
2011-10-17,17,Monday,Evening Rush,80,540,620,12.9
2011-10-17,18,Monday,Evening Rush,49,469,518,9.46
2011-10-17,19,Monday,Evening Rush,45,288,333,13.51
2011-10-17,20,Monday,Night,40,189,229,17.47
2011-10-17,21,Monday,Night,36,141,177,20.34
2011-10-17,22,Monday,Night,16,88,104,15.38
2011-10-17,23,Monday,Night,10,52,62,16.13
2011-10-18,0,Tuesday,Early Morning,8,23,31,25.81
2011-10-18,1,Tuesday,Early Morning,4,7,11,36.36
2011-10-18,2,Tuesday,Early Morning,1,4,5,20.0
2011-10-18,3,Tuesday,Early Morning,0,1,1,0.0
2011-10-18,4,Tuesday,Early Morning,0,4,4,0.0
2011-10-18,5,Tuesday,Early Morning,2,19,21,9.52
2011-10-18,6,Tuesday,Morning Rush,4,105,109,3.67
2011-10-18,7,Tuesday,Morning Rush,15,326,341,4.4
2011-10-18,8,Tuesday,Morning Rush,25,474,499,5.01
2011-10-18,9,Tuesday,Morning Rush,29,198,227,12.78
2011-10-18,10,Tuesday,Mid-Day,27,75,102,26.47
2011-10-18,11,Tuesday,Mid-Day,35,112,147,23.81
2011-10-18,12,Tuesday,Mid-Day,42,159,201,20.9
2011-10-18,13,Tuesday,Mid-Day,48,171,219,21.92
2011-10-18,14,Tuesday,Mid-Day,32,137,169,18.93
2011-10-18,15,Tuesday,Mid-Day,66,139,205,32.2
2011-10-18,16,Tuesday,Evening Rush,58,246,304,19.08
2011-10-18,17,Tuesday,Evening Rush,72,553,625,11.52
2011-10-18,18,Tuesday,Evening Rush,58,512,570,10.18
2011-10-18,19,Tuesday,Evening Rush,31,286,317,9.78
2011-10-18,20,Tuesday,Night,23,204,227,10.13
2011-10-18,21,Tuesday,Night,28,178,206,13.59
2011-10-18,22,Tuesday,Night,22,115,137,16.06
2011-10-18,23,Tuesday,Night,7,63,70,10.0
2011-10-19,0,Wednesday,Early Morning,11,23,34,32.35
2011-10-19,1,Wednesday,Early Morning,7,9,16,43.75
2011-10-19,2,Wednesday,Early Morning,1,6,7,14.29
2011-10-19,4,Wednesday,Early Morning,0,3,3,0.0
2011-10-19,5,Wednesday,Early Morning,0,3,3,0.0
2011-10-19,6,Wednesday,Morning Rush,3,28,31,9.68
2011-10-19,7,Wednesday,Morning Rush,1,67,68,1.47
2011-10-19,8,Wednesday,Morning Rush,10,200,210,4.76
2011-10-19,9,Wednesday,Morning Rush,17,185,202,8.42
2011-10-19,10,Wednesday,Mid-Day,14,109,123,11.38
2011-10-19,11,Wednesday,Mid-Day,33,116,149,22.15
2011-10-19,12,Wednesday,Mid-Day,13,117,130,10.0
2011-10-19,13,Wednesday,Mid-Day,20,86,106,18.87
2011-10-19,14,Wednesday,Mid-Day,17,80,97,17.53
2011-10-19,15,Wednesday,Mid-Day,21,99,120,17.5
2011-10-19,16,Wednesday,Evening Rush,21,180,201,10.45
2011-10-19,17,Wednesday,Evening Rush,11,170,181,6.08
2011-10-19,18,Wednesday,Evening Rush,8,132,140,5.71
2011-10-19,19,Wednesday,Evening Rush,8,189,197,4.06
2011-10-19,20,Wednesday,Night,5,140,145,3.45
2011-10-19,21,Wednesday,Night,6,79,85,7.06
2011-10-19,22,Wednesday,Night,13,94,107,12.15
2011-10-19,23,Wednesday,Night,14,55,69,20.29
2011-10-20,0,Thursday,Early Morning,4,22,26,15.38
2011-10-20,1,Thursday,Early Morning,4,11,15,26.67
2011-10-20,2,Thursday,Early Morning,0,4,4,0.0
2011-10-20,3,Thursday,Early Morning,0,1,1,0.0
2011-10-20,4,Thursday,Early Morning,2,6,8,25.0
2011-10-20,5,Thursday,Early Morning,2,24,26,7.69
2011-10-20,6,Thursday,Morning Rush,5,87,92,5.43
2011-10-20,7,Thursday,Morning Rush,15,303,318,4.72
2011-10-20,8,Thursday,Morning Rush,17,409,426,3.99
2011-10-20,9,Thursday,Morning Rush,26,197,223,11.66
2011-10-20,10,Thursday,Mid-Day,25,105,130,19.23
2011-10-20,11,Thursday,Mid-Day,30,99,129,23.26
2011-10-20,12,Thursday,Mid-Day,28,171,199,14.07
2011-10-20,13,Thursday,Mid-Day,28,136,164,17.07
2011-10-20,14,Thursday,Mid-Day,38,117,155,24.52
2011-10-20,15,Thursday,Mid-Day,22,138,160,13.75
2011-10-20,16,Thursday,Evening Rush,31,203,234,13.25
2011-10-20,17,Thursday,Evening Rush,56,438,494,11.34
2011-10-20,18,Thursday,Evening Rush,39,430,469,8.32
2011-10-20,19,Thursday,Evening Rush,20,278,298,6.71
2011-10-20,20,Thursday,Night,34,207,241,14.11
2011-10-20,21,Thursday,Night,16,149,165,9.7
2011-10-20,22,Thursday,Night,22,106,128,17.19
2011-10-20,23,Thursday,Night,7,83,90,7.78
2011-10-21,0,Friday,Early Morning,8,42,50,16.0
2011-10-21,1,Friday,Early Morning,7,19,26,26.92
2011-10-21,2,Friday,Early Morning,6,12,18,33.33
2011-10-21,3,Friday,Early Morning,0,7,7,0.0
2011-10-21,4,Friday,Early Morning,0,6,6,0.0
2011-10-21,5,Friday,Early Morning,0,31,31,0.0
2011-10-21,6,Friday,Morning Rush,7,78,85,8.24
2011-10-21,7,Friday,Morning Rush,5,228,233,2.15
2011-10-21,8,Friday,Morning Rush,16,386,402,3.98
2011-10-21,9,Friday,Morning Rush,33,189,222,14.86
2011-10-21,10,Friday,Mid-Day,32,106,138,23.19
2011-10-21,11,Friday,Mid-Day,39,135,174,22.41
2011-10-21,12,Friday,Mid-Day,47,193,240,19.58
2011-10-21,13,Friday,Mid-Day,43,163,206,20.87
2011-10-21,14,Friday,Mid-Day,67,131,198,33.84
2011-10-21,15,Friday,Mid-Day,57,178,235,24.26
2011-10-21,16,Friday,Evening Rush,60,242,302,19.87
2011-10-21,17,Friday,Evening Rush,79,445,524,15.08
2011-10-21,18,Friday,Evening Rush,43,354,397,10.83
2011-10-21,19,Friday,Evening Rush,25,228,253,9.88
2011-10-21,20,Friday,Night,29,155,184,15.76
2011-10-21,21,Friday,Night,31,112,143,21.68
2011-10-21,22,Friday,Night,24,89,113,21.24
2011-10-21,23,Friday,Night,18,99,117,15.38
2011-10-22,0,Saturday,Early Morning,16,80,96,16.67
2011-10-22,1,Saturday,Early Morning,20,50,70,28.57
2011-10-22,2,Saturday,Early Morning,6,25,31,19.35
2011-10-22,3,Saturday,Early Morning,1,19,20,5.0
2011-10-22,4,Saturday,Early Morning,4,4,8,50.0
2011-10-22,5,Saturday,Early Morning,1,7,8,12.5
2011-10-22,6,Saturday,Morning Rush,1,17,18,5.56
2011-10-22,7,Saturday,Morning Rush,8,49,57,14.04
2011-10-22,8,Saturday,Morning Rush,26,88,114,22.81
2011-10-22,9,Saturday,Morning Rush,47,122,169,27.81
2011-10-22,10,Saturday,Mid-Day,87,149,236,36.86
2011-10-22,11,Saturday,Mid-Day,110,172,282,39.01
2011-10-22,12,Saturday,Mid-Day,132,211,343,38.48
2011-10-22,13,Saturday,Mid-Day,136,186,322,42.24
2011-10-22,14,Saturday,Mid-Day,133,177,310,42.9
2011-10-22,15,Saturday,Mid-Day,159,223,382,41.62
2011-10-22,16,Saturday,Evening Rush,169,190,359,47.08
2011-10-22,17,Saturday,Evening Rush,143,217,360,39.72
2011-10-22,18,Saturday,Evening Rush,111,224,335,33.13
2011-10-22,19,Saturday,Evening Rush,47,173,220,21.36
2011-10-22,20,Saturday,Night,48,111,159,30.19
2011-10-22,21,Saturday,Night,37,120,157,23.57
2011-10-22,22,Saturday,Night,30,114,144,20.83
2011-10-22,23,Saturday,Night,27,81,108,25.0
2011-10-23,0,Sunday,Early Morning,24,64,88,27.27
2011-10-23,1,Sunday,Early Morning,11,60,71,15.49
2011-10-23,2,Sunday,Early Morning,10,40,50,20.0
2011-10-23,3,Sunday,Early Morning,15,31,46,32.61
2011-10-23,4,Sunday,Early Morning,5,1,6,83.33
2011-10-23,5,Sunday,Early Morning,1,2,3,33.33
2011-10-23,6,Sunday,Morning Rush,0,12,12,0.0
2011-10-23,7,Sunday,Morning Rush,3,18,21,14.29
2011-10-23,8,Sunday,Morning Rush,32,56,88,36.36
2011-10-23,9,Sunday,Morning Rush,48,95,143,33.57
2011-10-23,10,Sunday,Mid-Day,104,185,289,35.99
2011-10-23,11,Sunday,Mid-Day,131,202,333,39.34
2011-10-23,12,Sunday,Mid-Day,164,249,413,39.71
2011-10-23,13,Sunday,Mid-Day,160,255,415,38.55
2011-10-23,14,Sunday,Mid-Day,192,216,408,47.06
2011-10-23,15,Sunday,Mid-Day,171,216,387,44.19
2011-10-23,16,Sunday,Evening Rush,188,217,405,46.42
2011-10-23,17,Sunday,Evening Rush,120,220,340,35.29
2011-10-23,18,Sunday,Evening Rush,88,196,284,30.99
2011-10-23,19,Sunday,Evening Rush,53,140,193,27.46
2011-10-23,20,Sunday,Night,32,112,144,22.22
2011-10-23,21,Sunday,Night,24,75,99,24.24
2011-10-23,22,Sunday,Night,25,69,94,26.6
2011-10-23,23,Sunday,Night,18,31,49,36.73
2011-10-24,0,Monday,Early Morning,6,26,32,18.75
2011-10-24,1,Monday,Early Morning,7,8,15,46.67
2011-10-24,2,Monday,Early Morning,1,6,7,14.29
2011-10-24,3,Monday,Early Morning,1,3,4,25.0
2011-10-24,4,Monday,Early Morning,1,5,6,16.67
2011-10-24,5,Monday,Early Morning,2,19,21,9.52
2011-10-24,6,Monday,Morning Rush,3,83,86,3.49
2011-10-24,7,Monday,Morning Rush,11,274,285,3.86
2011-10-24,8,Monday,Morning Rush,20,378,398,5.03
2011-10-24,9,Monday,Morning Rush,29,166,195,14.87
2011-10-24,10,Monday,Mid-Day,47,82,129,36.43
2011-10-24,11,Monday,Mid-Day,59,109,168,35.12
2011-10-24,12,Monday,Mid-Day,64,156,220,29.09
2011-10-24,13,Monday,Mid-Day,60,138,198,30.3
2011-10-24,14,Monday,Mid-Day,63,143,206,30.58
2011-10-24,15,Monday,Mid-Day,52,125,177,29.38
2011-10-24,16,Monday,Evening Rush,68,242,310,21.94
2011-10-24,17,Monday,Evening Rush,87,527,614,14.17
2011-10-24,18,Monday,Evening Rush,58,428,486,11.93
2011-10-24,19,Monday,Evening Rush,25,212,237,10.55
2011-10-24,20,Monday,Night,11,118,129,8.53
2011-10-24,21,Monday,Night,12,114,126,9.52
2011-10-24,22,Monday,Night,3,76,79,3.8
2011-10-24,23,Monday,Night,9,50,59,15.25
2011-10-25,0,Tuesday,Early Morning,4,26,30,13.33
2011-10-25,1,Tuesday,Early Morning,5,6,11,45.45
2011-10-25,2,Tuesday,Early Morning,2,3,5,40.0
2011-10-25,3,Tuesday,Early Morning,1,3,4,25.0
2011-10-25,4,Tuesday,Early Morning,0,5,5,0.0
2011-10-25,5,Tuesday,Early Morning,0,24,24,0.0
2011-10-25,6,Tuesday,Morning Rush,3,95,98,3.06
2011-10-25,7,Tuesday,Morning Rush,15,299,314,4.78
2011-10-25,8,Tuesday,Morning Rush,25,383,408,6.13
2011-10-25,9,Tuesday,Morning Rush,29,194,223,13.0
2011-10-25,10,Tuesday,Mid-Day,26,102,128,20.31
2011-10-25,11,Tuesday,Mid-Day,46,120,166,27.71
2011-10-25,12,Tuesday,Mid-Day,35,165,200,17.5
2011-10-25,13,Tuesday,Mid-Day,37,161,198,18.69
2011-10-25,14,Tuesday,Mid-Day,66,134,200,33.0
2011-10-25,15,Tuesday,Mid-Day,63,171,234,26.92
2011-10-25,16,Tuesday,Evening Rush,52,233,285,18.25
2011-10-25,17,Tuesday,Evening Rush,68,517,585,11.62
2011-10-25,18,Tuesday,Evening Rush,65,453,518,12.55
2011-10-25,19,Tuesday,Evening Rush,44,294,338,13.02
2011-10-25,20,Tuesday,Night,40,208,248,16.13
2011-10-25,21,Tuesday,Night,32,169,201,15.92
2011-10-25,22,Tuesday,Night,22,148,170,12.94
2011-10-25,23,Tuesday,Night,15,79,94,15.96
2011-10-26,0,Wednesday,Early Morning,4,28,32,12.5
2011-10-26,1,Wednesday,Early Morning,3,9,12,25.0
2011-10-26,2,Wednesday,Early Morning,2,1,3,66.67
2011-10-26,3,Wednesday,Early Morning,0,3,3,0.0
2011-10-26,4,Wednesday,Early Morning,0,5,5,0.0
2011-10-26,5,Wednesday,Early Morning,0,21,21,0.0
2011-10-26,6,Wednesday,Morning Rush,0,92,92,0.0
2011-10-26,7,Wednesday,Morning Rush,15,284,299,5.02
2011-10-26,8,Wednesday,Morning Rush,26,438,464,5.6
2011-10-26,9,Wednesday,Morning Rush,14,226,240,5.83
2011-10-26,10,Wednesday,Mid-Day,26,105,131,19.85
2011-10-26,11,Wednesday,Mid-Day,23,132,155,14.84
2011-10-26,12,Wednesday,Mid-Day,39,155,194,20.1
2011-10-26,13,Wednesday,Mid-Day,20,62,82,24.39
2011-10-26,14,Wednesday,Mid-Day,14,52,66,21.21
2011-10-26,15,Wednesday,Mid-Day,11,59,70,15.71
2011-10-26,16,Wednesday,Evening Rush,17,196,213,7.98
2011-10-26,17,Wednesday,Evening Rush,40,414,454,8.81
2011-10-26,18,Wednesday,Evening Rush,55,398,453,12.14
2011-10-26,19,Wednesday,Evening Rush,25,306,331,7.55
2011-10-26,20,Wednesday,Night,27,180,207,13.04
2011-10-26,21,Wednesday,Night,17,140,157,10.83
2011-10-26,22,Wednesday,Night,23,112,135,17.04
2011-10-26,23,Wednesday,Night,3,72,75,4.0
2011-10-27,0,Thursday,Early Morning,3,23,26,11.54
2011-10-27,1,Thursday,Early Morning,2,9,11,18.18
2011-10-27,2,Thursday,Early Morning,3,5,8,37.5
2011-10-27,3,Thursday,Early Morning,1,3,4,25.0
2011-10-27,4,Thursday,Early Morning,1,3,4,25.0
2011-10-27,5,Thursday,Early Morning,1,14,15,6.67
2011-10-27,6,Thursday,Morning Rush,4,42,46,8.7
2011-10-27,7,Thursday,Morning Rush,9,128,137,6.57
2011-10-27,8,Thursday,Morning Rush,12,304,316,3.8
2011-10-27,9,Thursday,Morning Rush,16,155,171,9.36
2011-10-27,10,Thursday,Mid-Day,10,52,62,16.13
2011-10-27,11,Thursday,Mid-Day,8,44,52,15.38
2011-10-27,12,Thursday,Mid-Day,8,45,53,15.09
2011-10-27,13,Thursday,Mid-Day,10,64,74,13.51
2011-10-27,14,Thursday,Mid-Day,16,76,92,17.39
2011-10-27,15,Thursday,Mid-Day,12,95,107,11.21
2011-10-27,16,Thursday,Evening Rush,14,193,207,6.76
2011-10-27,17,Thursday,Evening Rush,31,291,322,9.63
2011-10-27,18,Thursday,Evening Rush,14,226,240,5.83
2011-10-27,19,Thursday,Evening Rush,19,200,219,8.68
2011-10-27,20,Thursday,Night,11,171,182,6.04
2011-10-27,21,Thursday,Night,13,119,132,9.85
2011-10-27,22,Thursday,Night,14,97,111,12.61
2011-10-27,23,Thursday,Night,8,60,68,11.76
2011-10-28,0,Friday,Early Morning,4,40,44,9.09
2011-10-28,1,Friday,Early Morning,7,9,16,43.75
2011-10-28,2,Friday,Early Morning,1,3,4,25.0
2011-10-28,3,Friday,Early Morning,4,4,8,50.0
2011-10-28,4,Friday,Early Morning,5,5,10,50.0
2011-10-28,5,Friday,Early Morning,0,25,25,0.0
2011-10-28,6,Friday,Morning Rush,1,74,75,1.33
2011-10-28,7,Friday,Morning Rush,6,199,205,2.93
2011-10-28,8,Friday,Morning Rush,13,361,374,3.48
2011-10-28,9,Friday,Morning Rush,19,210,229,8.3
2011-10-28,10,Friday,Mid-Day,28,102,130,21.54
2011-10-28,11,Friday,Mid-Day,40,128,168,23.81
2011-10-28,12,Friday,Mid-Day,46,167,213,21.6
2011-10-28,13,Friday,Mid-Day,43,185,228,18.86
2011-10-28,14,Friday,Mid-Day,33,152,185,17.84
2011-10-28,15,Friday,Mid-Day,44,171,215,20.47
2011-10-28,16,Friday,Evening Rush,46,262,308,14.94
2011-10-28,17,Friday,Evening Rush,35,411,446,7.85
2011-10-28,18,Friday,Evening Rush,36,332,368,9.78
2011-10-28,19,Friday,Evening Rush,16,188,204,7.84
2011-10-28,20,Friday,Night,12,131,143,8.39
2011-10-28,21,Friday,Night,5,69,74,6.76
2011-10-28,22,Friday,Night,4,32,36,11.11
2011-10-28,23,Friday,Night,8,31,39,20.51
2011-10-29,0,Saturday,Early Morning,0,19,19,0.0
2011-10-29,1,Saturday,Early Morning,0,18,18,0.0
2011-10-29,2,Saturday,Early Morning,1,16,17,5.88
2011-10-29,3,Saturday,Early Morning,0,8,8,0.0
2011-10-29,4,Saturday,Early Morning,0,1,1,0.0
2011-10-29,5,Saturday,Early Morning,0,1,1,0.0
2011-10-29,6,Saturday,Morning Rush,4,1,5,80.0
2011-10-29,7,Saturday,Morning Rush,1,6,7,14.29
2011-10-29,8,Saturday,Morning Rush,4,16,20,20.0
2011-10-29,9,Saturday,Morning Rush,1,19,20,5.0
2011-10-29,10,Saturday,Mid-Day,0,12,12,0.0
2011-10-29,11,Saturday,Mid-Day,1,26,27,3.7
2011-10-29,12,Saturday,Mid-Day,6,44,50,12.0
2011-10-29,13,Saturday,Mid-Day,0,30,30,0.0
2011-10-29,14,Saturday,Mid-Day,0,29,29,0.0
2011-10-29,15,Saturday,Mid-Day,3,38,41,7.32
2011-10-29,16,Saturday,Evening Rush,3,19,22,13.64
2011-10-29,17,Saturday,Evening Rush,3,28,31,9.68
2011-10-29,18,Saturday,Evening Rush,6,37,43,13.95
2011-10-29,19,Saturday,Evening Rush,3,36,39,7.69
2011-10-29,20,Saturday,Night,7,40,47,14.89
2011-10-29,21,Saturday,Night,1,49,50,2.0
2011-10-29,22,Saturday,Night,10,44,54,18.52
2011-10-29,23,Saturday,Night,3,33,36,8.33
2011-10-30,0,Sunday,Early Morning,7,47,54,12.96
2011-10-30,1,Sunday,Early Morning,9,34,43,20.93
2011-10-30,2,Sunday,Early Morning,7,43,50,14.0
2011-10-30,3,Sunday,Early Morning,7,26,33,21.21
2011-10-30,4,Sunday,Early Morning,1,10,11,9.09
2011-10-30,5,Sunday,Early Morning,0,4,4,0.0
2011-10-30,6,Sunday,Morning Rush,2,8,10,20.0
2011-10-30,7,Sunday,Morning Rush,7,15,22,31.82
2011-10-30,8,Sunday,Morning Rush,20,60,80,25.0
2011-10-30,9,Sunday,Morning Rush,55,92,147,37.41
2011-10-30,10,Sunday,Mid-Day,53,125,178,29.78
2011-10-30,11,Sunday,Mid-Day,58,182,240,24.17
2011-10-30,12,Sunday,Mid-Day,85,229,314,27.07
2011-10-30,13,Sunday,Mid-Day,113,232,345,32.75
2011-10-30,14,Sunday,Mid-Day,91,209,300,30.33
2011-10-30,15,Sunday,Mid-Day,88,202,290,30.34
2011-10-30,16,Sunday,Evening Rush,107,213,320,33.44
2011-10-30,17,Sunday,Evening Rush,54,191,245,22.04
2011-10-30,18,Sunday,Evening Rush,51,162,213,23.94
2011-10-30,19,Sunday,Evening Rush,28,125,153,18.3
2011-10-30,20,Sunday,Night,18,74,92,19.57
2011-10-30,21,Sunday,Night,4,75,79,5.06
2011-10-30,22,Sunday,Night,13,58,71,18.31
2011-10-30,23,Sunday,Night,7,30,37,18.92
2011-10-31,0,Monday,Early Morning,3,20,23,13.04
2011-10-31,1,Monday,Early Morning,5,8,13,38.46
2011-10-31,2,Monday,Early Morning,0,3,3,0.0
2011-10-31,3,Monday,Early Morning,0,3,3,0.0
2011-10-31,4,Monday,Early Morning,1,5,6,16.67
2011-10-31,5,Monday,Early Morning,0,18,18,0.0
2011-10-31,6,Monday,Morning Rush,4,82,86,4.65
2011-10-31,7,Monday,Morning Rush,11,216,227,4.85
2011-10-31,8,Monday,Morning Rush,17,355,372,4.57
2011-10-31,9,Monday,Morning Rush,14,197,211,6.64
2011-10-31,10,Monday,Mid-Day,18,87,105,17.14
2011-10-31,11,Monday,Mid-Day,31,97,128,24.22
2011-10-31,12,Monday,Mid-Day,30,140,170,17.65
2011-10-31,13,Monday,Mid-Day,24,128,152,15.79
2011-10-31,14,Monday,Mid-Day,22,119,141,15.6
2011-10-31,15,Monday,Mid-Day,27,141,168,16.07
2011-10-31,16,Monday,Evening Rush,30,242,272,11.03
2011-10-31,17,Monday,Evening Rush,44,442,486,9.05
2011-10-31,18,Monday,Evening Rush,30,392,422,7.11
2011-10-31,19,Monday,Evening Rush,12,226,238,5.04
2011-10-31,20,Monday,Night,18,154,172,10.47
2011-10-31,21,Monday,Night,7,109,116,6.03
2011-10-31,22,Monday,Night,8,77,85,9.41
2011-10-31,23,Monday,Night,6,46,52,11.54
2011-11-01,0,Tuesday,Early Morning,3,18,21,14.29
2011-11-01,1,Tuesday,Early Morning,3,8,11,27.27
2011-11-01,2,Tuesday,Early Morning,1,3,4,25.0
2011-11-01,3,Tuesday,Early Morning,1,5,6,16.67
2011-11-01,4,Tuesday,Early Morning,1,7,8,12.5
2011-11-01,5,Tuesday,Early Morning,0,18,18,0.0
2011-11-01,6,Tuesday,Morning Rush,3,90,93,3.23
2011-11-01,7,Tuesday,Morning Rush,8,246,254,3.15
2011-11-01,8,Tuesday,Morning Rush,17,402,419,4.06
2011-11-01,9,Tuesday,Morning Rush,16,206,222,7.21
2011-11-01,10,Tuesday,Mid-Day,21,114,135,15.56
2011-11-01,11,Tuesday,Mid-Day,16,101,117,13.68
2011-11-01,12,Tuesday,Mid-Day,23,153,176,13.07
2011-11-01,13,Tuesday,Mid-Day,20,147,167,11.98
2011-11-01,14,Tuesday,Mid-Day,32,118,150,21.33
2011-11-01,15,Tuesday,Mid-Day,38,148,186,20.43
2011-11-01,16,Tuesday,Evening Rush,46,252,298,15.44
2011-11-01,17,Tuesday,Evening Rush,36,470,506,7.11
2011-11-01,18,Tuesday,Evening Rush,39,421,460,8.48
2011-11-01,19,Tuesday,Evening Rush,39,274,313,12.46
2011-11-01,20,Tuesday,Night,18,191,209,8.61
2011-11-01,21,Tuesday,Night,13,114,127,10.24
2011-11-01,22,Tuesday,Night,5,91,96,5.21
2011-11-01,23,Tuesday,Night,11,61,72,15.28
2011-11-02,0,Wednesday,Early Morning,0,19,19,0.0
2011-11-02,1,Wednesday,Early Morning,2,8,10,20.0
2011-11-02,2,Wednesday,Early Morning,0,2,2,0.0
2011-11-02,3,Wednesday,Early Morning,0,2,2,0.0
2011-11-02,4,Wednesday,Early Morning,0,4,4,0.0
2011-11-02,5,Wednesday,Early Morning,0,27,27,0.0
2011-11-02,6,Wednesday,Morning Rush,1,91,92,1.09
2011-11-02,7,Wednesday,Morning Rush,11,240,251,4.38
2011-11-02,8,Wednesday,Morning Rush,20,452,472,4.24
2011-11-02,9,Wednesday,Morning Rush,15,213,228,6.58
2011-11-02,10,Wednesday,Mid-Day,25,108,133,18.8
2011-11-02,11,Wednesday,Mid-Day,27,117,144,18.75
2011-11-02,12,Wednesday,Mid-Day,32,157,189,16.93
2011-11-02,13,Wednesday,Mid-Day,22,139,161,13.66
2011-11-02,14,Wednesday,Mid-Day,40,132,172,23.26
2011-11-02,15,Wednesday,Mid-Day,26,161,187,13.9
2011-11-02,16,Wednesday,Evening Rush,35,231,266,13.16
2011-11-02,17,Wednesday,Evening Rush,30,523,553,5.42
2011-11-02,18,Wednesday,Evening Rush,31,448,479,6.47
2011-11-02,19,Wednesday,Evening Rush,25,257,282,8.87
2011-11-02,20,Wednesday,Night,5,177,182,2.75
2011-11-02,21,Wednesday,Night,13,155,168,7.74
2011-11-02,22,Wednesday,Night,7,99,106,6.6
2011-11-02,23,Wednesday,Night,3,54,57,5.26
2011-11-03,0,Thursday,Early Morning,3,28,31,9.68
2011-11-03,1,Thursday,Early Morning,3,12,15,20.0
2011-11-03,2,Thursday,Early Morning,2,5,7,28.57
2011-11-03,3,Thursday,Early Morning,1,4,5,20.0
2011-11-03,4,Thursday,Early Morning,1,3,4,25.0
2011-11-03,5,Thursday,Early Morning,1,27,28,3.57
2011-11-03,6,Thursday,Morning Rush,3,96,99,3.03
2011-11-03,7,Thursday,Morning Rush,12,280,292,4.11
2011-11-03,8,Thursday,Morning Rush,8,394,402,1.99
2011-11-03,9,Thursday,Morning Rush,9,155,164,5.49
2011-11-03,10,Thursday,Mid-Day,12,98,110,10.91
2011-11-03,11,Thursday,Mid-Day,12,108,120,10.0
2011-11-03,12,Thursday,Mid-Day,17,162,179,9.5
2011-11-03,13,Thursday,Mid-Day,19,150,169,11.24
2011-11-03,14,Thursday,Mid-Day,32,120,152,21.05
2011-11-03,15,Thursday,Mid-Day,24,138,162,14.81
2011-11-03,16,Thursday,Evening Rush,33,234,267,12.36
2011-11-03,17,Thursday,Evening Rush,33,465,498,6.63
2011-11-03,18,Thursday,Evening Rush,24,409,433,5.54
2011-11-03,19,Thursday,Evening Rush,18,234,252,7.14
2011-11-03,20,Thursday,Night,11,198,209,5.26
2011-11-03,21,Thursday,Night,4,140,144,2.78
2011-11-03,22,Thursday,Night,21,116,137,15.33
2011-11-03,23,Thursday,Night,15,80,95,15.79
2011-11-04,0,Friday,Early Morning,11,32,43,25.58
2011-11-04,1,Friday,Early Morning,1,16,17,5.88
2011-11-04,2,Friday,Early Morning,2,8,10,20.0
2011-11-04,3,Friday,Early Morning,1,7,8,12.5
2011-11-04,4,Friday,Early Morning,1,6,7,14.29
2011-11-04,5,Friday,Early Morning,0,23,23,0.0
2011-11-04,6,Friday,Morning Rush,2,64,66,3.03
2011-11-04,7,Friday,Morning Rush,10,235,245,4.08
2011-11-04,8,Friday,Morning Rush,8,387,395,2.03
2011-11-04,9,Friday,Morning Rush,15,239,254,5.91
2011-11-04,10,Friday,Mid-Day,19,115,134,14.18
2011-11-04,11,Friday,Mid-Day,34,128,162,20.99
2011-11-04,12,Friday,Mid-Day,44,153,197,22.34
2011-11-04,13,Friday,Mid-Day,33,161,194,17.01
2011-11-04,14,Friday,Mid-Day,54,147,201,26.87
2011-11-04,15,Friday,Mid-Day,45,192,237,18.99
2011-11-04,16,Friday,Evening Rush,53,237,290,18.28
2011-11-04,17,Friday,Evening Rush,42,438,480,8.75
2011-11-04,18,Friday,Evening Rush,35,339,374,9.36
2011-11-04,19,Friday,Evening Rush,14,182,196,7.14
2011-11-04,20,Friday,Night,15,171,186,8.06
2011-11-04,21,Friday,Night,8,115,123,6.5
2011-11-04,22,Friday,Night,6,109,115,5.22
2011-11-04,23,Friday,Night,17,72,89,19.1
2011-11-05,0,Saturday,Early Morning,4,48,52,7.69
2011-11-05,1,Saturday,Early Morning,5,57,62,8.06
2011-11-05,2,Saturday,Early Morning,7,24,31,22.58
2011-11-05,3,Saturday,Early Morning,0,8,8,0.0
2011-11-05,4,Saturday,Early Morning,3,5,8,37.5
2011-11-05,5,Saturday,Early Morning,0,2,2,0.0
2011-11-05,6,Saturday,Morning Rush,3,20,23,13.04
2011-11-05,7,Saturday,Morning Rush,3,31,34,8.82
2011-11-05,8,Saturday,Morning Rush,4,80,84,4.76
2011-11-05,9,Saturday,Morning Rush,30,111,141,21.28
2011-11-05,10,Saturday,Mid-Day,56,171,227,24.67
2011-11-05,11,Saturday,Mid-Day,69,169,238,28.99
2011-11-05,12,Saturday,Mid-Day,137,235,372,36.83
2011-11-05,13,Saturday,Mid-Day,148,207,355,41.69
2011-11-05,14,Saturday,Mid-Day,159,227,386,41.19
2011-11-05,15,Saturday,Mid-Day,141,202,343,41.11
2011-11-05,16,Saturday,Evening Rush,128,207,335,38.21
2011-11-05,17,Saturday,Evening Rush,100,234,334,29.94
2011-11-05,18,Saturday,Evening Rush,52,185,237,21.94
2011-11-05,19,Saturday,Evening Rush,45,159,204,22.06
2011-11-05,20,Saturday,Night,29,136,165,17.58
2011-11-05,21,Saturday,Night,19,99,118,16.1
2011-11-05,22,Saturday,Night,10,72,82,12.2
2011-11-05,23,Saturday,Night,4,81,85,4.71
2011-11-06,0,Sunday,Early Morning,10,65,75,13.33
2011-11-06,1,Sunday,Early Morning,11,104,115,9.57
2011-11-06,2,Sunday,Early Morning,6,23,29,20.69
2011-11-06,3,Sunday,Early Morning,5,4,9,55.56
2011-11-06,4,Sunday,Early Morning,0,6,6,0.0
2011-11-06,5,Sunday,Early Morning,0,5,5,0.0
2011-11-06,6,Sunday,Morning Rush,5,11,16,31.25
2011-11-06,7,Sunday,Morning Rush,4,24,28,14.29
2011-11-06,8,Sunday,Morning Rush,19,71,90,21.11
2011-11-06,9,Sunday,Morning Rush,36,134,170,21.18
2011-11-06,10,Sunday,Mid-Day,76,186,262,29.01
2011-11-06,11,Sunday,Mid-Day,104,216,320,32.5
2011-11-06,12,Sunday,Mid-Day,120,226,346,34.68
2011-11-06,13,Sunday,Mid-Day,105,209,314,33.44
2011-11-06,14,Sunday,Mid-Day,101,219,320,31.56
2011-11-06,15,Sunday,Mid-Day,96,210,306,31.37
2011-11-06,16,Sunday,Evening Rush,84,263,347,24.21
2011-11-06,17,Sunday,Evening Rush,71,185,256,27.73
2011-11-06,18,Sunday,Evening Rush,39,146,185,21.08
2011-11-06,19,Sunday,Evening Rush,21,130,151,13.91
2011-11-06,20,Sunday,Night,16,100,116,13.79
2011-11-06,21,Sunday,Night,11,77,88,12.5
2011-11-06,22,Sunday,Night,5,40,45,11.11
2011-11-06,23,Sunday,Night,7,43,50,14.0
2011-11-07,0,Monday,Early Morning,1,14,15,6.67
2011-11-07,1,Monday,Early Morning,2,6,8,25.0
2011-11-07,2,Monday,Early Morning,0,2,2,0.0
2011-11-07,3,Monday,Early Morning,0,3,3,0.0
2011-11-07,4,Monday,Early Morning,2,4,6,33.33
2011-11-07,5,Monday,Early Morning,1,25,26,3.85
2011-11-07,6,Monday,Morning Rush,2,97,99,2.02
2011-11-07,7,Monday,Morning Rush,6,305,311,1.93
2011-11-07,8,Monday,Morning Rush,13,397,410,3.17
2011-11-07,9,Monday,Morning Rush,18,156,174,10.34
2011-11-07,10,Monday,Mid-Day,28,95,123,22.76
2011-11-07,11,Monday,Mid-Day,28,100,128,21.88
2011-11-07,12,Monday,Mid-Day,21,158,179,11.73
2011-11-07,13,Monday,Mid-Day,32,157,189,16.93
2011-11-07,14,Monday,Mid-Day,30,115,145,20.69
2011-11-07,15,Monday,Mid-Day,38,132,170,22.35
2011-11-07,16,Monday,Evening Rush,40,255,295,13.56
2011-11-07,17,Monday,Evening Rush,39,489,528,7.39
2011-11-07,18,Monday,Evening Rush,18,407,425,4.24
2011-11-07,19,Monday,Evening Rush,20,280,300,6.67
2011-11-07,20,Monday,Night,17,187,204,8.33
2011-11-07,21,Monday,Night,10,129,139,7.19
2011-11-07,22,Monday,Night,6,102,108,5.56
2011-11-07,23,Monday,Night,1,47,48,2.08
2011-11-08,0,Tuesday,Early Morning,0,18,18,0.0
2011-11-08,1,Tuesday,Early Morning,3,8,11,27.27
2011-11-08,2,Tuesday,Early Morning,0,1,1,0.0
2011-11-08,3,Tuesday,Early Morning,0,3,3,0.0
2011-11-08,4,Tuesday,Early Morning,0,4,4,0.0
2011-11-08,5,Tuesday,Early Morning,1,17,18,5.56
2011-11-08,6,Tuesday,Morning Rush,3,96,99,3.03
2011-11-08,7,Tuesday,Morning Rush,7,316,323,2.17
2011-11-08,8,Tuesday,Morning Rush,11,455,466,2.36
2011-11-08,9,Tuesday,Morning Rush,14,177,191,7.33
2011-11-08,10,Tuesday,Mid-Day,25,104,129,19.38
2011-11-08,11,Tuesday,Mid-Day,21,126,147,14.29
2011-11-08,12,Tuesday,Mid-Day,28,175,203,13.79
2011-11-08,13,Tuesday,Mid-Day,31,165,196,15.82
2011-11-08,14,Tuesday,Mid-Day,32,129,161,19.88
2011-11-08,15,Tuesday,Mid-Day,33,155,188,17.55
2011-11-08,16,Tuesday,Evening Rush,39,250,289,13.49
2011-11-08,17,Tuesday,Evening Rush,40,459,499,8.02
2011-11-08,18,Tuesday,Evening Rush,30,432,462,6.49
2011-11-08,19,Tuesday,Evening Rush,14,264,278,5.04
2011-11-08,20,Tuesday,Night,12,169,181,6.63
2011-11-08,21,Tuesday,Night,16,166,182,8.79
2011-11-08,22,Tuesday,Night,13,95,108,12.04
2011-11-08,23,Tuesday,Night,3,45,48,6.25
2011-11-09,0,Wednesday,Early Morning,0,13,13,0.0
2011-11-09,1,Wednesday,Early Morning,0,10,10,0.0
2011-11-09,2,Wednesday,Early Morning,0,5,5,0.0
2011-11-09,3,Wednesday,Early Morning,0,4,4,0.0
2011-11-09,4,Wednesday,Early Morning,0,4,4,0.0
2011-11-09,5,Wednesday,Early Morning,0,28,28,0.0
2011-11-09,6,Wednesday,Morning Rush,0,98,98,0.0
2011-11-09,7,Wednesday,Morning Rush,0,300,300,0.0
2011-11-09,8,Wednesday,Morning Rush,19,437,456,4.17
2011-11-09,9,Wednesday,Morning Rush,22,197,219,10.05
2011-11-09,10,Wednesday,Mid-Day,16,89,105,15.24
2011-11-09,11,Wednesday,Mid-Day,21,131,152,13.82
2011-11-09,12,Wednesday,Mid-Day,24,156,180,13.33
2011-11-09,13,Wednesday,Mid-Day,31,136,167,18.56
2011-11-09,14,Wednesday,Mid-Day,26,153,179,14.53
2011-11-09,15,Wednesday,Mid-Day,21,130,151,13.91
2011-11-09,16,Wednesday,Evening Rush,24,257,281,8.54
2011-11-09,17,Wednesday,Evening Rush,27,458,485,5.57
2011-11-09,18,Wednesday,Evening Rush,21,387,408,5.15
2011-11-09,19,Wednesday,Evening Rush,12,292,304,3.95
2011-11-09,20,Wednesday,Night,18,201,219,8.22
2011-11-09,21,Wednesday,Night,9,152,161,5.59
2011-11-09,22,Wednesday,Night,9,105,114,7.89
2011-11-09,23,Wednesday,Night,5,61,66,7.58
2011-11-10,0,Thursday,Early Morning,0,24,24,0.0
2011-11-10,1,Thursday,Early Morning,1,10,11,9.09
2011-11-10,2,Thursday,Early Morning,0,5,5,0.0
2011-11-10,3,Thursday,Early Morning,0,11,11,0.0
2011-11-10,4,Thursday,Early Morning,1,2,3,33.33
2011-11-10,5,Thursday,Early Morning,1,22,23,4.35
2011-11-10,6,Thursday,Morning Rush,4,110,114,3.51
2011-11-10,7,Thursday,Morning Rush,6,266,272,2.21
2011-11-10,8,Thursday,Morning Rush,18,418,436,4.13
2011-11-10,9,Thursday,Morning Rush,23,188,211,10.9
2011-11-10,10,Thursday,Mid-Day,17,100,117,14.53
2011-11-10,11,Thursday,Mid-Day,9,99,108,8.33
2011-11-10,12,Thursday,Mid-Day,18,149,167,10.78
2011-11-10,13,Thursday,Mid-Day,9,87,96,9.38
2011-11-10,14,Thursday,Mid-Day,6,58,64,9.38
2011-11-10,15,Thursday,Mid-Day,5,57,62,8.06
2011-11-10,16,Thursday,Evening Rush,6,67,73,8.22
2011-11-10,17,Thursday,Evening Rush,9,168,177,5.08
2011-11-10,18,Thursday,Evening Rush,10,263,273,3.66
2011-11-10,19,Thursday,Evening Rush,19,192,211,9.0
2011-11-10,20,Thursday,Night,8,160,168,4.76
2011-11-10,21,Thursday,Night,6,130,136,4.41
2011-11-10,22,Thursday,Night,5,84,89,5.62
2011-11-10,23,Thursday,Night,9,73,82,10.98
2011-11-11,0,Friday,Early Morning,10,56,66,15.15
2011-11-11,1,Friday,Early Morning,3,16,19,15.79
2011-11-11,2,Friday,Early Morning,1,10,11,9.09
2011-11-11,3,Friday,Early Morning,0,6,6,0.0
2011-11-11,4,Friday,Early Morning,0,8,8,0.0
2011-11-11,5,Friday,Early Morning,0,13,13,0.0
2011-11-11,6,Friday,Morning Rush,0,46,46,0.0
2011-11-11,7,Friday,Morning Rush,5,116,121,4.13
2011-11-11,8,Friday,Morning Rush,9,249,258,3.49
2011-11-11,9,Friday,Morning Rush,15,186,201,7.46
2011-11-11,10,Friday,Mid-Day,38,162,200,19.0
2011-11-11,11,Friday,Mid-Day,20,150,170,11.76
2011-11-11,12,Friday,Mid-Day,41,198,239,17.15
2011-11-11,13,Friday,Mid-Day,57,179,236,24.15
2011-11-11,14,Friday,Mid-Day,64,183,247,25.91
2011-11-11,15,Friday,Mid-Day,29,187,216,13.43
2011-11-11,16,Friday,Evening Rush,49,189,238,20.59
2011-11-11,17,Friday,Evening Rush,24,286,310,7.74
2011-11-11,18,Friday,Evening Rush,23,185,208,11.06
2011-11-11,19,Friday,Evening Rush,17,182,199,8.54
2011-11-11,20,Friday,Night,12,97,109,11.01
2011-11-11,21,Friday,Night,4,79,83,4.82
2011-11-11,22,Friday,Night,13,78,91,14.29
2011-11-11,23,Friday,Night,6,67,73,8.22
2011-11-12,0,Saturday,Early Morning,12,52,64,18.75
2011-11-12,1,Saturday,Early Morning,9,45,54,16.67
2011-11-12,2,Saturday,Early Morning,7,39,46,15.22
2011-11-12,3,Saturday,Early Morning,4,13,17,23.53
2011-11-12,4,Saturday,Early Morning,0,7,7,0.0
2011-11-12,5,Saturday,Early Morning,1,3,4,25.0
2011-11-12,6,Saturday,Morning Rush,0,7,7,0.0
2011-11-12,7,Saturday,Morning Rush,3,24,27,11.11
2011-11-12,8,Saturday,Morning Rush,14,87,101,13.86
2011-11-12,9,Saturday,Morning Rush,18,142,160,11.25
2011-11-12,10,Saturday,Mid-Day,62,170,232,26.72
2011-11-12,11,Saturday,Mid-Day,102,213,315,32.38
2011-11-12,12,Saturday,Mid-Day,142,224,366,38.8
2011-11-12,13,Saturday,Mid-Day,128,225,353,36.26
2011-11-12,14,Saturday,Mid-Day,191,244,435,43.91
2011-11-12,15,Saturday,Mid-Day,165,221,386,42.75
2011-11-12,16,Saturday,Evening Rush,137,224,361,37.95
2011-11-12,17,Saturday,Evening Rush,92,193,285,32.28
2011-11-12,18,Saturday,Evening Rush,53,150,203,26.11
2011-11-12,19,Saturday,Evening Rush,32,139,171,18.71
2011-11-12,20,Saturday,Night,31,101,132,23.48
2011-11-12,21,Saturday,Night,19,103,122,15.57
2011-11-12,22,Saturday,Night,30,88,118,25.42
2011-11-12,23,Saturday,Night,23,78,101,22.77
2011-11-13,0,Sunday,Early Morning,12,61,73,16.44
2011-11-13,1,Sunday,Early Morning,13,58,71,18.31
2011-11-13,2,Sunday,Early Morning,9,48,57,15.79
2011-11-13,3,Sunday,Early Morning,8,20,28,28.57
2011-11-13,4,Sunday,Early Morning,1,5,6,16.67
2011-11-13,5,Sunday,Early Morning,2,3,5,40.0
2011-11-13,6,Sunday,Morning Rush,5,18,23,21.74
2011-11-13,7,Sunday,Morning Rush,13,30,43,30.23
2011-11-13,8,Sunday,Morning Rush,24,55,79,30.38
2011-11-13,9,Sunday,Morning Rush,38,97,135,28.15
2011-11-13,10,Sunday,Mid-Day,63,178,241,26.14
2011-11-13,11,Sunday,Mid-Day,108,187,295,36.61
2011-11-13,12,Sunday,Mid-Day,112,242,354,31.64
2011-11-13,13,Sunday,Mid-Day,105,234,339,30.97
2011-11-13,14,Sunday,Mid-Day,108,263,371,29.11
2011-11-13,15,Sunday,Mid-Day,89,221,310,28.71
2011-11-13,16,Sunday,Evening Rush,93,226,319,29.15
2011-11-13,17,Sunday,Evening Rush,44,187,231,19.05
2011-11-13,18,Sunday,Evening Rush,35,155,190,18.42
2011-11-13,19,Sunday,Evening Rush,36,121,157,22.93
2011-11-13,20,Sunday,Night,24,115,139,17.27
2011-11-13,21,Sunday,Night,19,76,95,20.0
2011-11-13,22,Sunday,Night,25,64,89,28.09
2011-11-13,23,Sunday,Night,18,49,67,26.87
2011-11-14,0,Monday,Early Morning,8,22,30,26.67
2011-11-14,1,Monday,Early Morning,5,6,11,45.45
2011-11-14,2,Monday,Early Morning,7,10,17,41.18
2011-11-14,3,Monday,Early Morning,4,3,7,57.14
2011-11-14,4,Monday,Early Morning,0,5,5,0.0
2011-11-14,5,Monday,Early Morning,0,19,19,0.0
2011-11-14,6,Monday,Morning Rush,10,104,114,8.77
2011-11-14,7,Monday,Morning Rush,11,311,322,3.42
2011-11-14,8,Monday,Morning Rush,27,425,452,5.97
2011-11-14,9,Monday,Morning Rush,29,204,233,12.45
2011-11-14,10,Monday,Mid-Day,26,85,111,23.42
2011-11-14,11,Monday,Mid-Day,22,106,128,17.19
2011-11-14,12,Monday,Mid-Day,36,166,202,17.82
2011-11-14,13,Monday,Mid-Day,50,153,203,24.63
2011-11-14,14,Monday,Mid-Day,47,138,185,25.41
2011-11-14,15,Monday,Mid-Day,53,142,195,27.18
2011-11-14,16,Monday,Evening Rush,51,264,315,16.19
2011-11-14,17,Monday,Evening Rush,55,464,519,10.6
2011-11-14,18,Monday,Evening Rush,29,460,489,5.93
2011-11-14,19,Monday,Evening Rush,28,274,302,9.27
2011-11-14,20,Monday,Night,30,210,240,12.5
2011-11-14,21,Monday,Night,37,176,213,17.37
2011-11-14,22,Monday,Night,17,96,113,15.04
2011-11-14,23,Monday,Night,13,48,61,21.31
2011-11-15,0,Tuesday,Early Morning,7,15,22,31.82
2011-11-15,1,Tuesday,Early Morning,5,5,10,50.0
2011-11-15,2,Tuesday,Early Morning,7,8,15,46.67
2011-11-15,3,Tuesday,Early Morning,0,4,4,0.0
2011-11-15,4,Tuesday,Early Morning,1,6,7,14.29
2011-11-15,5,Tuesday,Early Morning,2,26,28,7.14
2011-11-15,6,Tuesday,Morning Rush,4,104,108,3.7
2011-11-15,7,Tuesday,Morning Rush,21,298,319,6.58
2011-11-15,8,Tuesday,Morning Rush,27,453,480,5.63
2011-11-15,9,Tuesday,Morning Rush,26,174,200,13.0
2011-11-15,10,Tuesday,Mid-Day,23,115,138,16.67
2011-11-15,11,Tuesday,Mid-Day,18,116,134,13.43
2011-11-15,12,Tuesday,Mid-Day,28,148,176,15.91
2011-11-15,13,Tuesday,Mid-Day,21,132,153,13.73
2011-11-15,14,Tuesday,Mid-Day,27,120,147,18.37
2011-11-15,15,Tuesday,Mid-Day,36,155,191,18.85
2011-11-15,16,Tuesday,Evening Rush,31,240,271,11.44
2011-11-15,17,Tuesday,Evening Rush,29,422,451,6.43
2011-11-15,18,Tuesday,Evening Rush,27,414,441,6.12
2011-11-15,19,Tuesday,Evening Rush,27,259,286,9.44
2011-11-15,20,Tuesday,Night,26,212,238,10.92
2011-11-15,21,Tuesday,Night,23,145,168,13.69
2011-11-15,22,Tuesday,Night,19,109,128,14.84
2011-11-15,23,Tuesday,Night,14,66,80,17.5
2011-11-16,0,Wednesday,Early Morning,5,26,31,16.13
2011-11-16,1,Wednesday,Early Morning,0,5,5,0.0
2011-11-16,2,Wednesday,Early Morning,4,6,10,40.0
2011-11-16,3,Wednesday,Early Morning,2,3,5,40.0
2011-11-16,4,Wednesday,Early Morning,1,3,4,25.0
2011-11-16,5,Wednesday,Early Morning,0,13,13,0.0
2011-11-16,6,Wednesday,Morning Rush,4,52,56,7.14
2011-11-16,7,Wednesday,Morning Rush,7,130,137,5.11
2011-11-16,8,Wednesday,Morning Rush,9,223,232,3.88
2011-11-16,9,Wednesday,Morning Rush,5,77,82,6.1
2011-11-16,10,Wednesday,Mid-Day,4,32,36,11.11
2011-11-16,11,Wednesday,Mid-Day,7,53,60,11.67
2011-11-16,12,Wednesday,Mid-Day,5,49,54,9.26
2011-11-16,13,Wednesday,Mid-Day,6,52,58,10.34
2011-11-16,14,Wednesday,Mid-Day,12,49,61,19.67
2011-11-16,15,Wednesday,Mid-Day,16,50,66,24.24
2011-11-16,16,Wednesday,Evening Rush,13,110,123,10.57
2011-11-16,17,Wednesday,Evening Rush,17,216,233,7.3
2011-11-16,18,Wednesday,Evening Rush,13,176,189,6.88
2011-11-16,19,Wednesday,Evening Rush,3,108,111,2.7
2011-11-16,20,Wednesday,Night,5,94,99,5.05
2011-11-16,21,Wednesday,Night,3,72,75,4.0
2011-11-16,22,Wednesday,Night,1,45,46,2.17
2011-11-16,23,Wednesday,Night,3,28,31,9.68
2011-11-17,0,Thursday,Early Morning,2,22,24,8.33
2011-11-17,1,Thursday,Early Morning,0,5,5,0.0
2011-11-17,2,Thursday,Early Morning,0,5,5,0.0
2011-11-17,3,Thursday,Early Morning,0,3,3,0.0
2011-11-17,4,Thursday,Early Morning,1,3,4,25.0
2011-11-17,5,Thursday,Early Morning,1,21,22,4.55
2011-11-17,6,Thursday,Morning Rush,3,72,75,4.0
2011-11-17,7,Thursday,Morning Rush,4,164,168,2.38
2011-11-17,8,Thursday,Morning Rush,12,343,355,3.38
2011-11-17,9,Thursday,Morning Rush,14,184,198,7.07
2011-11-17,10,Thursday,Mid-Day,7,74,81,8.64
2011-11-17,11,Thursday,Mid-Day,4,93,97,4.12
2011-11-17,12,Thursday,Mid-Day,6,115,121,4.96
2011-11-17,13,Thursday,Mid-Day,15,109,124,12.1
2011-11-17,14,Thursday,Mid-Day,5,105,110,4.55
2011-11-17,15,Thursday,Mid-Day,10,106,116,8.62
2011-11-17,16,Thursday,Evening Rush,8,187,195,4.1
2011-11-17,17,Thursday,Evening Rush,20,379,399,5.01
2011-11-17,18,Thursday,Evening Rush,9,298,307,2.93
2011-11-17,19,Thursday,Evening Rush,7,210,217,3.23
2011-11-17,20,Thursday,Night,7,162,169,4.14
2011-11-17,21,Thursday,Night,3,113,116,2.59
2011-11-17,22,Thursday,Night,1,83,84,1.19
2011-11-17,23,Thursday,Night,0,58,58,0.0
2011-11-18,0,Friday,Early Morning,2,28,30,6.67
2011-11-18,1,Friday,Early Morning,0,10,10,0.0
2011-11-18,2,Friday,Early Morning,2,8,10,20.0
2011-11-18,3,Friday,Early Morning,0,2,2,0.0
2011-11-18,4,Friday,Early Morning,0,5,5,0.0
2011-11-18,5,Friday,Early Morning,0,22,22,0.0
2011-11-18,6,Friday,Morning Rush,1,70,71,1.41
2011-11-18,7,Friday,Morning Rush,5,211,216,2.31
2011-11-18,8,Friday,Morning Rush,6,369,375,1.6
2011-11-18,9,Friday,Morning Rush,6,207,213,2.82
2011-11-18,10,Friday,Mid-Day,10,105,115,8.7
2011-11-18,11,Friday,Mid-Day,18,122,140,12.86
2011-11-18,12,Friday,Mid-Day,22,143,165,13.33
2011-11-18,13,Friday,Mid-Day,31,146,177,17.51
2011-11-18,14,Friday,Mid-Day,31,123,154,20.13
2011-11-18,15,Friday,Mid-Day,27,151,178,15.17
2011-11-18,16,Friday,Evening Rush,19,190,209,9.09
2011-11-18,17,Friday,Evening Rush,17,361,378,4.5
2011-11-18,18,Friday,Evening Rush,16,312,328,4.88
2011-11-18,19,Friday,Evening Rush,7,183,190,3.68
2011-11-18,20,Friday,Night,8,129,137,5.84
2011-11-18,21,Friday,Night,3,108,111,2.7
2011-11-18,22,Friday,Night,9,88,97,9.28
2011-11-18,23,Friday,Night,5,54,59,8.47
2011-11-19,0,Saturday,Early Morning,4,49,53,7.55
2011-11-19,1,Saturday,Early Morning,1,34,35,2.86
2011-11-19,2,Saturday,Early Morning,12,34,46,26.09
2011-11-19,3,Saturday,Early Morning,4,11,15,26.67
2011-11-19,4,Saturday,Early Morning,4,4,8,50.0
2011-11-19,5,Saturday,Early Morning,0,2,2,0.0
2011-11-19,6,Saturday,Morning Rush,2,10,12,16.67
2011-11-19,7,Saturday,Morning Rush,3,38,41,7.32
2011-11-19,8,Saturday,Morning Rush,12,80,92,13.04
2011-11-19,9,Saturday,Morning Rush,12,130,142,8.45
2011-11-19,10,Saturday,Mid-Day,35,165,200,17.5
2011-11-19,11,Saturday,Mid-Day,50,183,233,21.46
2011-11-19,12,Saturday,Mid-Day,93,218,311,29.9
2011-11-19,13,Saturday,Mid-Day,118,245,363,32.51
2011-11-19,14,Saturday,Mid-Day,121,228,349,34.67
2011-11-19,15,Saturday,Mid-Day,120,262,382,31.41
2011-11-19,16,Saturday,Evening Rush,99,188,287,34.49
2011-11-19,17,Saturday,Evening Rush,61,171,232,26.29
2011-11-19,18,Saturday,Evening Rush,36,172,208,17.31
2011-11-19,19,Saturday,Evening Rush,33,149,182,18.13
2011-11-19,20,Saturday,Night,48,115,163,29.45
2011-11-19,21,Saturday,Night,29,79,108,26.85
2011-11-19,22,Saturday,Night,26,80,106,24.53
2011-11-19,23,Saturday,Night,20,73,93,21.51
2011-11-20,0,Sunday,Early Morning,14,79,93,15.05
2011-11-20,1,Sunday,Early Morning,11,73,84,13.1
2011-11-20,2,Sunday,Early Morning,12,44,56,21.43
2011-11-20,3,Sunday,Early Morning,6,31,37,16.22
2011-11-20,4,Sunday,Early Morning,2,10,12,16.67
2011-11-20,5,Sunday,Early Morning,0,4,4,0.0
2011-11-20,6,Sunday,Morning Rush,3,6,9,33.33
2011-11-20,7,Sunday,Morning Rush,4,19,23,17.39
2011-11-20,8,Sunday,Morning Rush,13,52,65,20.0
2011-11-20,9,Sunday,Morning Rush,29,109,138,21.01
2011-11-20,10,Sunday,Mid-Day,46,183,229,20.09
2011-11-20,11,Sunday,Mid-Day,74,212,286,25.87
2011-11-20,12,Sunday,Mid-Day,70,234,304,23.03
2011-11-20,13,Sunday,Mid-Day,84,285,369,22.76
2011-11-20,14,Sunday,Mid-Day,113,250,363,31.13
2011-11-20,15,Sunday,Mid-Day,109,242,351,31.05
2011-11-20,16,Sunday,Evening Rush,81,225,306,26.47
2011-11-20,17,Sunday,Evening Rush,35,168,203,17.24
2011-11-20,18,Sunday,Evening Rush,22,123,145,15.17
2011-11-20,19,Sunday,Evening Rush,17,140,157,10.83
2011-11-20,20,Sunday,Night,23,90,113,20.35
2011-11-20,21,Sunday,Night,11,94,105,10.48
2011-11-20,22,Sunday,Night,5,35,40,12.5
2011-11-20,23,Sunday,Night,3,25,28,10.71
2011-11-21,0,Monday,Early Morning,4,13,17,23.53
2011-11-21,1,Monday,Early Morning,4,8,12,33.33
2011-11-21,2,Monday,Early Morning,1,2,3,33.33
2011-11-21,3,Monday,Early Morning,0,4,4,0.0
2011-11-21,4,Monday,Early Morning,0,5,5,0.0
2011-11-21,5,Monday,Early Morning,0,20,20,0.0
2011-11-21,6,Monday,Morning Rush,0,76,76,0.0
2011-11-21,7,Monday,Morning Rush,17,229,246,6.91
2011-11-21,8,Monday,Morning Rush,13,378,391,3.32
2011-11-21,9,Monday,Morning Rush,15,222,237,6.33
2011-11-21,10,Monday,Mid-Day,25,110,135,18.52
2011-11-21,11,Monday,Mid-Day,16,112,128,12.5
2011-11-21,12,Monday,Mid-Day,24,138,162,14.81
2011-11-21,13,Monday,Mid-Day,13,121,134,9.7
2011-11-21,14,Monday,Mid-Day,14,121,135,10.37
2011-11-21,15,Monday,Mid-Day,15,93,108,13.89
2011-11-21,16,Monday,Evening Rush,13,95,108,12.04
2011-11-21,17,Monday,Evening Rush,10,200,210,4.76
2011-11-21,18,Monday,Evening Rush,8,184,192,4.17
2011-11-21,19,Monday,Evening Rush,2,135,137,1.46
2011-11-21,20,Monday,Night,5,75,80,6.25
2011-11-21,21,Monday,Night,11,103,114,9.65
2011-11-21,22,Monday,Night,6,72,78,7.69
2011-11-21,23,Monday,Night,4,29,33,12.12
2011-11-22,0,Tuesday,Early Morning,0,14,14,0.0
2011-11-22,1,Tuesday,Early Morning,1,5,6,16.67
2011-11-22,2,Tuesday,Early Morning,2,4,6,33.33
2011-11-22,3,Tuesday,Early Morning,1,2,3,33.33
2011-11-22,4,Tuesday,Early Morning,0,7,7,0.0
2011-11-22,5,Tuesday,Early Morning,1,17,18,5.56
2011-11-22,6,Tuesday,Morning Rush,1,63,64,1.56
2011-11-22,7,Tuesday,Morning Rush,2,119,121,1.65
2011-11-22,8,Tuesday,Morning Rush,5,185,190,2.63
2011-11-22,9,Tuesday,Morning Rush,2,147,149,1.34
2011-11-22,10,Tuesday,Mid-Day,6,46,52,11.54
2011-11-22,11,Tuesday,Mid-Day,4,28,32,12.5
2011-11-22,12,Tuesday,Mid-Day,3,18,21,14.29
2011-11-22,13,Tuesday,Mid-Day,4,22,26,15.38
2011-11-22,14,Tuesday,Mid-Day,4,31,35,11.43
2011-11-22,15,Tuesday,Mid-Day,2,32,34,5.88
2011-11-22,16,Tuesday,Evening Rush,3,59,62,4.84
2011-11-22,17,Tuesday,Evening Rush,4,161,165,2.42
2011-11-22,18,Tuesday,Evening Rush,0,148,148,0.0
2011-11-22,19,Tuesday,Evening Rush,5,106,111,4.5
2011-11-22,20,Tuesday,Night,6,121,127,4.72
2011-11-22,21,Tuesday,Night,4,86,90,4.44
2011-11-22,22,Tuesday,Night,6,81,87,6.9
2011-11-22,23,Tuesday,Night,3,36,39,7.69
2011-11-23,0,Wednesday,Early Morning,2,14,16,12.5
2011-11-23,1,Wednesday,Early Morning,0,8,8,0.0
2011-11-23,2,Wednesday,Early Morning,1,5,6,16.67
2011-11-23,3,Wednesday,Early Morning,1,2,3,33.33
2011-11-23,4,Wednesday,Early Morning,0,5,5,0.0
2011-11-23,5,Wednesday,Early Morning,1,16,17,5.88
2011-11-23,6,Wednesday,Morning Rush,1,68,69,1.45
2011-11-23,7,Wednesday,Morning Rush,2,154,156,1.28
2011-11-23,8,Wednesday,Morning Rush,7,316,323,2.17
2011-11-23,9,Wednesday,Morning Rush,3,164,167,1.8
2011-11-23,10,Wednesday,Mid-Day,6,70,76,7.89
2011-11-23,11,Wednesday,Mid-Day,9,107,116,7.76
2011-11-23,12,Wednesday,Mid-Day,9,151,160,5.63
2011-11-23,13,Wednesday,Mid-Day,12,162,174,6.9
2011-11-23,14,Wednesday,Mid-Day,13,200,213,6.1
2011-11-23,15,Wednesday,Mid-Day,13,194,207,6.28
2011-11-23,16,Wednesday,Evening Rush,4,169,173,2.31
2011-11-23,17,Wednesday,Evening Rush,7,156,163,4.29
2011-11-23,18,Wednesday,Evening Rush,7,138,145,4.83
2011-11-23,19,Wednesday,Evening Rush,6,116,122,4.92
2011-11-23,20,Wednesday,Night,1,67,68,1.47
2011-11-23,21,Wednesday,Night,0,66,66,0.0
2011-11-23,22,Wednesday,Night,3,59,62,4.84
2011-11-23,23,Wednesday,Night,4,47,51,7.84
2011-11-24,0,Thursday,Early Morning,1,22,23,4.35
2011-11-24,1,Thursday,Early Morning,1,23,24,4.17
2011-11-24,2,Thursday,Early Morning,3,19,22,13.64
2011-11-24,3,Thursday,Early Morning,1,4,5,20.0
2011-11-24,4,Thursday,Early Morning,1,1,2,50.0
2011-11-24,5,Thursday,Early Morning,1,10,11,9.09
2011-11-24,6,Thursday,Morning Rush,1,5,6,16.67
2011-11-24,7,Thursday,Morning Rush,9,31,40,22.5
2011-11-24,8,Thursday,Morning Rush,4,42,46,8.7
2011-11-24,9,Thursday,Morning Rush,13,68,81,16.05
2011-11-24,10,Thursday,Mid-Day,34,64,98,34.69
2011-11-24,11,Thursday,Mid-Day,52,90,142,36.62
2011-11-24,12,Thursday,Mid-Day,62,88,150,41.33
2011-11-24,13,Thursday,Mid-Day,84,91,175,48.0
2011-11-24,14,Thursday,Mid-Day,74,94,168,44.05
2011-11-24,15,Thursday,Mid-Day,78,71,149,52.35
2011-11-24,16,Thursday,Evening Rush,48,66,114,42.11
2011-11-24,17,Thursday,Evening Rush,34,40,74,45.95
2011-11-24,18,Thursday,Evening Rush,13,24,37,35.14
2011-11-24,19,Thursday,Evening Rush,15,13,28,53.57
2011-11-24,20,Thursday,Night,14,17,31,45.16
2011-11-24,21,Thursday,Night,7,19,26,26.92
2011-11-24,22,Thursday,Night,8,14,22,36.36
2011-11-24,23,Thursday,Night,2,19,21,9.52
2011-11-25,0,Friday,Early Morning,7,22,29,24.14
2011-11-25,1,Friday,Early Morning,2,12,14,14.29
2011-11-25,2,Friday,Early Morning,4,6,10,40.0
2011-11-25,3,Friday,Early Morning,0,2,2,0.0
2011-11-25,4,Friday,Early Morning,4,3,7,57.14
2011-11-25,5,Friday,Early Morning,2,3,5,40.0
2011-11-25,6,Friday,Morning Rush,4,9,13,30.77
2011-11-25,7,Friday,Morning Rush,4,31,35,11.43
2011-11-25,8,Friday,Morning Rush,6,68,74,8.11
2011-11-25,9,Friday,Morning Rush,25,70,95,26.32
2011-11-25,10,Friday,Mid-Day,60,82,142,42.25
2011-11-25,11,Friday,Mid-Day,99,127,226,43.81
2011-11-25,12,Friday,Mid-Day,126,146,272,46.32
2011-11-25,13,Friday,Mid-Day,143,140,283,50.53
2011-11-25,14,Friday,Mid-Day,122,150,272,44.85
2011-11-25,15,Friday,Mid-Day,165,145,310,53.23
2011-11-25,16,Friday,Evening Rush,122,139,261,46.74
2011-11-25,17,Friday,Evening Rush,57,127,184,30.98
2011-11-25,18,Friday,Evening Rush,45,108,153,29.41
2011-11-25,19,Friday,Evening Rush,38,96,134,28.36
2011-11-25,20,Friday,Night,19,76,95,20.0
2011-11-25,21,Friday,Night,24,61,85,28.24
2011-11-25,22,Friday,Night,12,46,58,20.69
2011-11-25,23,Friday,Night,5,28,33,15.15
2011-11-26,0,Saturday,Early Morning,9,38,47,19.15
2011-11-26,1,Saturday,Early Morning,5,24,29,17.24
2011-11-26,2,Saturday,Early Morning,3,20,23,13.04
2011-11-26,3,Saturday,Early Morning,8,9,17,47.06
2011-11-26,4,Saturday,Early Morning,0,4,4,0.0
2011-11-26,5,Saturday,Early Morning,0,3,3,0.0
2011-11-26,6,Saturday,Morning Rush,2,8,10,20.0
2011-11-26,7,Saturday,Morning Rush,4,13,17,23.53
2011-11-26,8,Saturday,Morning Rush,10,50,60,16.67
2011-11-26,9,Saturday,Morning Rush,16,67,83,19.28
2011-11-26,10,Saturday,Mid-Day,57,84,141,40.43
2011-11-26,11,Saturday,Mid-Day,107,123,230,46.52
2011-11-26,12,Saturday,Mid-Day,137,172,309,44.34
2011-11-26,13,Saturday,Mid-Day,177,148,325,54.46
2011-11-26,14,Saturday,Mid-Day,141,158,299,47.16
2011-11-26,15,Saturday,Mid-Day,154,160,314,49.04
2011-11-26,16,Saturday,Evening Rush,137,138,275,49.82
2011-11-26,17,Saturday,Evening Rush,62,122,184,33.7
2011-11-26,18,Saturday,Evening Rush,67,118,185,36.22
2011-11-26,19,Saturday,Evening Rush,46,100,146,31.51
2011-11-26,20,Saturday,Night,55,86,141,39.01
2011-11-26,21,Saturday,Night,20,72,92,21.74
2011-11-26,22,Saturday,Night,14,51,65,21.54
2011-11-26,23,Saturday,Night,18,51,69,26.09
2011-11-27,0,Sunday,Early Morning,7,39,46,15.22
2011-11-27,1,Sunday,Early Morning,9,35,44,20.45
2011-11-27,2,Sunday,Early Morning,9,22,31,29.03
2011-11-27,3,Sunday,Early Morning,9,8,17,52.94
2011-11-27,4,Sunday,Early Morning,0,4,4,0.0
2011-11-27,5,Sunday,Early Morning,0,5,5,0.0
2011-11-27,6,Sunday,Morning Rush,0,9,9,0.0
2011-11-27,7,Sunday,Morning Rush,12,11,23,52.17
2011-11-27,8,Sunday,Morning Rush,6,36,42,14.29
2011-11-27,9,Sunday,Morning Rush,21,90,111,18.92
2011-11-27,10,Sunday,Mid-Day,58,131,189,30.69
2011-11-27,11,Sunday,Mid-Day,83,157,240,34.58
2011-11-27,12,Sunday,Mid-Day,63,193,256,24.61
2011-11-27,13,Sunday,Mid-Day,97,216,313,30.99
2011-11-27,14,Sunday,Mid-Day,113,200,313,36.1
2011-11-27,15,Sunday,Mid-Day,96,221,317,30.28
2011-11-27,16,Sunday,Evening Rush,94,229,323,29.1
2011-11-27,17,Sunday,Evening Rush,37,167,204,18.14
2011-11-27,18,Sunday,Evening Rush,25,130,155,16.13
2011-11-27,19,Sunday,Evening Rush,30,109,139,21.58
2011-11-27,20,Sunday,Night,10,94,104,9.62
2011-11-27,21,Sunday,Night,13,75,88,14.77
2011-11-27,22,Sunday,Night,13,53,66,19.7
2011-11-27,23,Sunday,Night,5,27,32,15.63
2011-11-28,0,Monday,Early Morning,6,10,16,37.5
2011-11-28,1,Monday,Early Morning,1,12,13,7.69
2011-11-28,3,Monday,Early Morning,1,4,5,20.0
2011-11-28,4,Monday,Early Morning,0,4,4,0.0
2011-11-28,5,Monday,Early Morning,0,34,34,0.0
2011-11-28,6,Monday,Morning Rush,6,98,104,5.77
2011-11-28,7,Monday,Morning Rush,7,270,277,2.53
2011-11-28,8,Monday,Morning Rush,13,394,407,3.19
2011-11-28,9,Monday,Morning Rush,17,191,208,8.17
2011-11-28,10,Monday,Mid-Day,21,86,107,19.63
2011-11-28,11,Monday,Mid-Day,11,107,118,9.32
2011-11-28,12,Monday,Mid-Day,13,165,178,7.3
2011-11-28,13,Monday,Mid-Day,25,137,162,15.43
2011-11-28,14,Monday,Mid-Day,14,129,143,9.79
2011-11-28,15,Monday,Mid-Day,18,132,150,12.0
2011-11-28,16,Monday,Evening Rush,24,240,264,9.09
2011-11-28,17,Monday,Evening Rush,24,444,468,5.13
2011-11-28,18,Monday,Evening Rush,20,396,416,4.81
2011-11-28,19,Monday,Evening Rush,4,260,264,1.52
2011-11-28,20,Monday,Night,12,206,218,5.5
2011-11-28,21,Monday,Night,4,152,156,2.56
2011-11-28,22,Monday,Night,7,102,109,6.42
2011-11-28,23,Monday,Night,5,41,46,10.87
2011-11-29,0,Tuesday,Early Morning,4,18,22,18.18
2011-11-29,1,Tuesday,Early Morning,1,16,17,5.88
2011-11-29,2,Tuesday,Early Morning,0,5,5,0.0
2011-11-29,3,Tuesday,Early Morning,0,2,2,0.0
2011-11-29,4,Tuesday,Early Morning,1,5,6,16.67
2011-11-29,5,Tuesday,Early Morning,1,21,22,4.55
2011-11-29,6,Tuesday,Morning Rush,1,88,89,1.12
2011-11-29,7,Tuesday,Morning Rush,12,330,342,3.51
2011-11-29,8,Tuesday,Morning Rush,9,440,449,2.0
2011-11-29,9,Tuesday,Morning Rush,5,197,202,2.48
2011-11-29,10,Tuesday,Mid-Day,2,34,36,5.56
2011-11-29,11,Tuesday,Mid-Day,1,10,11,9.09
2011-11-29,12,Tuesday,Mid-Day,1,17,18,5.56
2011-11-29,13,Tuesday,Mid-Day,0,22,22,0.0
2011-11-29,14,Tuesday,Mid-Day,1,35,36,2.78
2011-11-29,15,Tuesday,Mid-Day,5,60,65,7.69
2011-11-29,16,Tuesday,Evening Rush,5,146,151,3.31
2011-11-29,17,Tuesday,Evening Rush,8,346,354,2.26
2011-11-29,18,Tuesday,Evening Rush,11,347,358,3.07
2011-11-29,19,Tuesday,Evening Rush,6,244,250,2.4
2011-11-29,20,Tuesday,Night,8,176,184,4.35
2011-11-29,21,Tuesday,Night,9,116,125,7.2
2011-11-29,22,Tuesday,Night,5,90,95,5.26
2011-11-29,23,Tuesday,Night,0,53,53,0.0
2011-11-30,0,Wednesday,Early Morning,1,23,24,4.17
2011-11-30,1,Wednesday,Early Morning,0,8,8,0.0
2011-11-30,2,Wednesday,Early Morning,0,5,5,0.0
2011-11-30,3,Wednesday,Early Morning,0,1,1,0.0
2011-11-30,4,Wednesday,Early Morning,0,5,5,0.0
2011-11-30,5,Wednesday,Early Morning,1,21,22,4.55
2011-11-30,6,Wednesday,Morning Rush,3,100,103,2.91
2011-11-30,7,Wednesday,Morning Rush,9,276,285,3.16
2011-11-30,8,Wednesday,Morning Rush,13,465,478,2.72
2011-11-30,9,Wednesday,Morning Rush,7,186,193,3.63
2011-11-30,10,Wednesday,Mid-Day,15,95,110,13.64
2011-11-30,11,Wednesday,Mid-Day,10,112,122,8.2
2011-11-30,12,Wednesday,Mid-Day,12,148,160,7.5
2011-11-30,13,Wednesday,Mid-Day,16,131,147,10.88
2011-11-30,14,Wednesday,Mid-Day,13,99,112,11.61
2011-11-30,15,Wednesday,Mid-Day,11,104,115,9.57
2011-11-30,16,Wednesday,Evening Rush,27,199,226,11.95
2011-11-30,17,Wednesday,Evening Rush,15,365,380,3.95
2011-11-30,18,Wednesday,Evening Rush,7,369,376,1.86
2011-11-30,19,Wednesday,Evening Rush,6,273,279,2.15
2011-11-30,20,Wednesday,Night,6,184,190,3.16
2011-11-30,21,Wednesday,Night,7,128,135,5.19
2011-11-30,22,Wednesday,Night,5,82,87,5.75
2011-11-30,23,Wednesday,Night,4,46,50,8.0
2011-12-01,0,Thursday,Early Morning,1,19,20,5.0
2011-12-01,1,Thursday,Early Morning,1,9,10,10.0
2011-12-01,2,Thursday,Early Morning,1,8,9,11.11
2011-12-01,3,Thursday,Early Morning,1,6,7,14.29
2011-12-01,4,Thursday,Early Morning,0,1,1,0.0
2011-12-01,5,Thursday,Early Morning,1,23,24,4.17
2011-12-01,6,Thursday,Morning Rush,5,92,97,5.15
2011-12-01,7,Thursday,Morning Rush,11,265,276,3.99
2011-12-01,8,Thursday,Morning Rush,15,462,477,3.14
2011-12-01,9,Thursday,Morning Rush,9,215,224,4.02
2011-12-01,10,Thursday,Mid-Day,7,86,93,7.53
2011-12-01,11,Thursday,Mid-Day,7,95,102,6.86
2011-12-01,12,Thursday,Mid-Day,9,139,148,6.08
2011-12-01,13,Thursday,Mid-Day,17,137,154,11.04
2011-12-01,14,Thursday,Mid-Day,20,130,150,13.33
2011-12-01,15,Thursday,Mid-Day,10,144,154,6.49
2011-12-01,16,Thursday,Evening Rush,9,192,201,4.48
2011-12-01,17,Thursday,Evening Rush,9,409,418,2.15
2011-12-01,18,Thursday,Evening Rush,12,393,405,2.96
2011-12-01,19,Thursday,Evening Rush,9,219,228,3.95
2011-12-01,20,Thursday,Night,12,178,190,6.32
2011-12-01,21,Thursday,Night,8,154,162,4.94
2011-12-01,22,Thursday,Night,5,99,104,4.81
2011-12-01,23,Thursday,Night,3,70,73,4.11
2011-12-02,0,Friday,Early Morning,6,32,38,15.79
2011-12-02,1,Friday,Early Morning,1,14,15,6.67
2011-12-02,2,Friday,Early Morning,0,10,10,0.0
2011-12-02,3,Friday,Early Morning,0,1,1,0.0
2011-12-02,4,Friday,Early Morning,0,3,3,0.0
2011-12-02,5,Friday,Early Morning,0,23,23,0.0
2011-12-02,6,Friday,Morning Rush,3,84,87,3.45
2011-12-02,7,Friday,Morning Rush,6,199,205,2.93
2011-12-02,8,Friday,Morning Rush,13,432,445,2.92
2011-12-02,9,Friday,Morning Rush,12,234,246,4.88
2011-12-02,10,Friday,Mid-Day,16,89,105,15.24
2011-12-02,11,Friday,Mid-Day,18,142,160,11.25
2011-12-02,12,Friday,Mid-Day,18,186,204,8.82
2011-12-02,13,Friday,Mid-Day,19,188,207,9.18
2011-12-02,14,Friday,Mid-Day,25,145,170,14.71
2011-12-02,15,Friday,Mid-Day,24,175,199,12.06
2011-12-02,16,Friday,Evening Rush,22,254,276,7.97
2011-12-02,17,Friday,Evening Rush,20,391,411,4.87
2011-12-02,18,Friday,Evening Rush,10,362,372,2.69
2011-12-02,19,Friday,Evening Rush,13,252,265,4.91
2011-12-02,20,Friday,Night,12,178,190,6.32
2011-12-02,21,Friday,Night,9,102,111,8.11
2011-12-02,22,Friday,Night,7,95,102,6.86
2011-12-02,23,Friday,Night,14,81,95,14.74
2011-12-03,0,Saturday,Early Morning,10,65,75,13.33
2011-12-03,1,Saturday,Early Morning,9,62,71,12.68
2011-12-03,2,Saturday,Early Morning,9,41,50,18.0
2011-12-03,3,Saturday,Early Morning,4,5,9,44.44
2011-12-03,4,Saturday,Early Morning,1,7,8,12.5
2011-12-03,5,Saturday,Early Morning,0,6,6,0.0
2011-12-03,6,Saturday,Morning Rush,1,10,11,9.09
2011-12-03,7,Saturday,Morning Rush,2,24,26,7.69
2011-12-03,8,Saturday,Morning Rush,1,62,63,1.59
2011-12-03,9,Saturday,Morning Rush,25,99,124,20.16
2011-12-03,10,Saturday,Mid-Day,22,173,195,11.28
2011-12-03,11,Saturday,Mid-Day,48,227,275,17.45
2011-12-03,12,Saturday,Mid-Day,78,280,358,21.79
2011-12-03,13,Saturday,Mid-Day,70,222,292,23.97
2011-12-03,14,Saturday,Mid-Day,92,251,343,26.82
2011-12-03,15,Saturday,Mid-Day,100,237,337,29.67
2011-12-03,16,Saturday,Evening Rush,75,230,305,24.59
2011-12-03,17,Saturday,Evening Rush,46,186,232,19.83
2011-12-03,18,Saturday,Evening Rush,31,193,224,13.84
2011-12-03,19,Saturday,Evening Rush,31,144,175,17.71
2011-12-03,20,Saturday,Night,17,110,127,13.39
2011-12-03,21,Saturday,Night,5,104,109,4.59
2011-12-03,22,Saturday,Night,17,97,114,14.91
2011-12-03,23,Saturday,Night,12,73,85,14.12
2011-12-04,0,Sunday,Early Morning,19,64,83,22.89
2011-12-04,1,Sunday,Early Morning,20,54,74,27.03
2011-12-04,2,Sunday,Early Morning,11,51,62,17.74
2011-12-04,3,Sunday,Early Morning,7,34,41,17.07
2011-12-04,4,Sunday,Early Morning,2,9,11,18.18
2011-12-04,5,Sunday,Early Morning,2,2,4,50.0
2011-12-04,6,Sunday,Morning Rush,1,3,4,25.0
2011-12-04,7,Sunday,Morning Rush,3,23,26,11.54
2011-12-04,8,Sunday,Morning Rush,7,48,55,12.73
2011-12-04,9,Sunday,Morning Rush,12,114,126,9.52
2011-12-04,10,Sunday,Mid-Day,36,180,216,16.67
2011-12-04,11,Sunday,Mid-Day,48,206,254,18.9
2011-12-04,12,Sunday,Mid-Day,82,247,329,24.92
2011-12-04,13,Sunday,Mid-Day,88,269,357,24.65
2011-12-04,14,Sunday,Mid-Day,77,246,323,23.84
2011-12-04,15,Sunday,Mid-Day,69,227,296,23.31
2011-12-04,16,Sunday,Evening Rush,64,266,330,19.39
2011-12-04,17,Sunday,Evening Rush,38,207,245,15.51
2011-12-04,18,Sunday,Evening Rush,10,161,171,5.85
2011-12-04,19,Sunday,Evening Rush,15,158,173,8.67
2011-12-04,20,Sunday,Night,8,116,124,6.45
2011-12-04,21,Sunday,Night,7,65,72,9.72
2011-12-04,22,Sunday,Night,5,59,64,7.81
2011-12-04,23,Sunday,Night,3,42,45,6.67
2011-12-05,0,Monday,Early Morning,3,21,24,12.5
2011-12-05,1,Monday,Early Morning,2,10,12,16.67
2011-12-05,2,Monday,Early Morning,0,8,8,0.0
2011-12-05,3,Monday,Early Morning,0,2,2,0.0
2011-12-05,4,Monday,Early Morning,0,7,7,0.0
2011-12-05,5,Monday,Early Morning,1,24,25,4.0
2011-12-05,6,Monday,Morning Rush,1,89,90,1.11
2011-12-05,7,Monday,Morning Rush,9,274,283,3.18
2011-12-05,8,Monday,Morning Rush,12,392,404,2.97
2011-12-05,9,Monday,Morning Rush,12,178,190,6.32
2011-12-05,10,Monday,Mid-Day,9,78,87,10.34
2011-12-05,11,Monday,Mid-Day,17,106,123,13.82
2011-12-05,12,Monday,Mid-Day,29,125,154,18.83
2011-12-05,13,Monday,Mid-Day,18,153,171,10.53
2011-12-05,14,Monday,Mid-Day,7,126,133,5.26
2011-12-05,15,Monday,Mid-Day,16,132,148,10.81
2011-12-05,16,Monday,Evening Rush,10,238,248,4.03
2011-12-05,17,Monday,Evening Rush,16,430,446,3.59
2011-12-05,18,Monday,Evening Rush,13,386,399,3.26
2011-12-05,19,Monday,Evening Rush,13,295,308,4.22
2011-12-05,20,Monday,Night,15,190,205,7.32
2011-12-05,21,Monday,Night,10,166,176,5.68
2011-12-05,22,Monday,Night,12,94,106,11.32
2011-12-05,23,Monday,Night,8,54,62,12.9
2011-12-06,0,Tuesday,Early Morning,3,25,28,10.71
2011-12-06,1,Tuesday,Early Morning,2,14,16,12.5
2011-12-06,2,Tuesday,Early Morning,0,3,3,0.0
2011-12-06,3,Tuesday,Early Morning,0,3,3,0.0
2011-12-06,4,Tuesday,Early Morning,0,7,7,0.0
2011-12-06,5,Tuesday,Early Morning,0,20,20,0.0
2011-12-06,6,Tuesday,Morning Rush,5,81,86,5.81
2011-12-06,7,Tuesday,Morning Rush,7,227,234,2.99
2011-12-06,8,Tuesday,Morning Rush,13,401,414,3.14
2011-12-06,9,Tuesday,Morning Rush,4,200,204,1.96
2011-12-06,10,Tuesday,Mid-Day,6,44,50,12.0
2011-12-06,11,Tuesday,Mid-Day,4,28,32,12.5
2011-12-06,12,Tuesday,Mid-Day,5,50,55,9.09
2011-12-06,13,Tuesday,Mid-Day,6,65,71,8.45
2011-12-06,14,Tuesday,Mid-Day,6,69,75,8.0
2011-12-06,15,Tuesday,Mid-Day,2,43,45,4.44
2011-12-06,16,Tuesday,Evening Rush,4,84,88,4.55
2011-12-06,17,Tuesday,Evening Rush,13,249,262,4.96
2011-12-06,18,Tuesday,Evening Rush,17,287,304,5.59
2011-12-06,19,Tuesday,Evening Rush,10,223,233,4.29
2011-12-06,20,Tuesday,Night,3,107,110,2.73
2011-12-06,21,Tuesday,Night,6,108,114,5.26
2011-12-06,22,Tuesday,Night,5,82,87,5.75
2011-12-06,23,Tuesday,Night,5,48,53,9.43
2011-12-07,0,Wednesday,Early Morning,3,30,33,9.09
2011-12-07,1,Wednesday,Early Morning,4,9,13,30.77
2011-12-07,2,Wednesday,Early Morning,2,4,6,33.33
2011-12-07,3,Wednesday,Early Morning,0,3,3,0.0
2011-12-07,4,Wednesday,Early Morning,0,1,1,0.0
2011-12-07,5,Wednesday,Early Morning,0,3,3,0.0
2011-12-07,6,Wednesday,Morning Rush,0,18,18,0.0
2011-12-07,7,Wednesday,Morning Rush,3,43,46,6.52
2011-12-07,8,Wednesday,Morning Rush,6,80,86,6.98
2011-12-07,9,Wednesday,Morning Rush,0,64,64,0.0
2011-12-07,10,Wednesday,Mid-Day,1,32,33,3.03
2011-12-07,11,Wednesday,Mid-Day,3,47,50,6.0
2011-12-07,12,Wednesday,Mid-Day,4,29,33,12.12
2011-12-07,13,Wednesday,Mid-Day,5,28,33,15.15
2011-12-07,14,Wednesday,Mid-Day,1,24,25,4.0
2011-12-07,15,Wednesday,Mid-Day,5,25,30,16.67
2011-12-07,16,Wednesday,Evening Rush,3,28,31,9.68
2011-12-07,17,Wednesday,Evening Rush,4,48,52,7.69
2011-12-07,18,Wednesday,Evening Rush,3,48,51,5.88
2011-12-07,19,Wednesday,Evening Rush,2,31,33,6.06
2011-12-07,20,Wednesday,Night,1,25,26,3.85
2011-12-07,21,Wednesday,Night,0,6,6,0.0
2011-12-07,22,Wednesday,Night,0,13,13,0.0
2011-12-07,23,Wednesday,Night,0,16,16,0.0
2011-12-08,0,Thursday,Early Morning,0,21,21,0.0
2011-12-08,1,Thursday,Early Morning,1,6,7,14.29
2011-12-08,2,Thursday,Early Morning,0,4,4,0.0
2011-12-08,3,Thursday,Early Morning,0,1,1,0.0
2011-12-08,4,Thursday,Early Morning,0,2,2,0.0
2011-12-08,5,Thursday,Early Morning,0,12,12,0.0
2011-12-08,6,Thursday,Morning Rush,0,71,71,0.0
2011-12-08,7,Thursday,Morning Rush,11,233,244,4.51
2011-12-08,8,Thursday,Morning Rush,11,418,429,2.56
2011-12-08,9,Thursday,Morning Rush,7,218,225,3.11
2011-12-08,10,Thursday,Mid-Day,1,109,110,0.91
2011-12-08,11,Thursday,Mid-Day,6,100,106,5.66
2011-12-08,12,Thursday,Mid-Day,8,148,156,5.13
2011-12-08,13,Thursday,Mid-Day,9,115,124,7.26
2011-12-08,14,Thursday,Mid-Day,16,121,137,11.68
2011-12-08,15,Thursday,Mid-Day,19,98,117,16.24
2011-12-08,16,Thursday,Evening Rush,7,201,208,3.37
2011-12-08,17,Thursday,Evening Rush,10,321,331,3.02
2011-12-08,18,Thursday,Evening Rush,12,306,318,3.77
2011-12-08,19,Thursday,Evening Rush,12,220,232,5.17
2011-12-08,20,Thursday,Night,5,170,175,2.86
2011-12-08,21,Thursday,Night,4,135,139,2.88
2011-12-08,22,Thursday,Night,8,84,92,8.7
2011-12-08,23,Thursday,Night,3,58,61,4.92
2011-12-09,0,Friday,Early Morning,8,26,34,23.53
2011-12-09,1,Friday,Early Morning,2,12,14,14.29
2011-12-09,2,Friday,Early Morning,2,10,12,16.67
2011-12-09,3,Friday,Early Morning,1,5,6,16.67
2011-12-09,4,Friday,Early Morning,1,1,2,50.0
2011-12-09,5,Friday,Early Morning,0,20,20,0.0
2011-12-09,6,Friday,Morning Rush,1,62,63,1.59
2011-12-09,7,Friday,Morning Rush,4,195,199,2.01
2011-12-09,8,Friday,Morning Rush,7,378,385,1.82
2011-12-09,9,Friday,Morning Rush,8,256,264,3.03
2011-12-09,10,Friday,Mid-Day,11,115,126,8.73
2011-12-09,11,Friday,Mid-Day,15,121,136,11.03
2011-12-09,12,Friday,Mid-Day,27,146,173,15.61
2011-12-09,13,Friday,Mid-Day,27,141,168,16.07
2011-12-09,14,Friday,Mid-Day,24,163,187,12.83
2011-12-09,15,Friday,Mid-Day,29,160,189,15.34
2011-12-09,16,Friday,Evening Rush,24,226,250,9.6
2011-12-09,17,Friday,Evening Rush,10,352,362,2.76
2011-12-09,18,Friday,Evening Rush,10,308,318,3.14
2011-12-09,19,Friday,Evening Rush,10,189,199,5.03
2011-12-09,20,Friday,Night,10,140,150,6.67
2011-12-09,21,Friday,Night,9,131,140,6.43
2011-12-09,22,Friday,Night,15,114,129,11.63
2011-12-09,23,Friday,Night,6,88,94,6.38
2011-12-10,0,Saturday,Early Morning,11,66,77,14.29
2011-12-10,1,Saturday,Early Morning,11,55,66,16.67
2011-12-10,2,Saturday,Early Morning,12,48,60,20.0
2011-12-10,3,Saturday,Early Morning,5,20,25,20.0
2011-12-10,4,Saturday,Early Morning,0,3,3,0.0
2011-12-10,5,Saturday,Early Morning,0,6,6,0.0
2011-12-10,6,Saturday,Morning Rush,1,10,11,9.09
2011-12-10,7,Saturday,Morning Rush,0,11,11,0.0
2011-12-10,8,Saturday,Morning Rush,5,68,73,6.85
2011-12-10,9,Saturday,Morning Rush,15,134,149,10.07
2011-12-10,10,Saturday,Mid-Day,31,161,192,16.15
2011-12-10,11,Saturday,Mid-Day,44,192,236,18.64
2011-12-10,12,Saturday,Mid-Day,48,235,283,16.96
2011-12-10,13,Saturday,Mid-Day,47,239,286,16.43
2011-12-10,14,Saturday,Mid-Day,51,242,293,17.41
2011-12-10,15,Saturday,Mid-Day,60,239,299,20.07
2011-12-10,16,Saturday,Evening Rush,58,183,241,24.07
2011-12-10,17,Saturday,Evening Rush,34,151,185,18.38
2011-12-10,18,Saturday,Evening Rush,28,144,172,16.28
2011-12-10,19,Saturday,Evening Rush,15,139,154,9.74
2011-12-10,20,Saturday,Night,10,114,124,8.06
2011-12-10,21,Saturday,Night,4,79,83,4.82
2011-12-10,22,Saturday,Night,7,88,95,7.37
2011-12-10,23,Saturday,Night,5,61,66,7.58
2011-12-11,0,Sunday,Early Morning,5,69,74,6.76
2011-12-11,1,Sunday,Early Morning,8,54,62,12.9
2011-12-11,2,Sunday,Early Morning,5,47,52,9.62
2011-12-11,3,Sunday,Early Morning,2,17,19,10.53
2011-12-11,4,Sunday,Early Morning,0,5,5,0.0
2011-12-11,5,Sunday,Early Morning,0,6,6,0.0
2011-12-11,6,Sunday,Morning Rush,0,10,10,0.0
2011-12-11,7,Sunday,Morning Rush,1,30,31,3.23
2011-12-11,8,Sunday,Morning Rush,4,68,72,5.56
2011-12-11,9,Sunday,Morning Rush,19,88,107,17.76
2011-12-11,10,Sunday,Mid-Day,30,164,194,15.46
2011-12-11,11,Sunday,Mid-Day,31,166,197,15.74
2011-12-11,12,Sunday,Mid-Day,42,246,288,14.58
2011-12-11,13,Sunday,Mid-Day,44,224,268,16.42
2011-12-11,14,Sunday,Mid-Day,44,198,242,18.18
2011-12-11,15,Sunday,Mid-Day,47,219,266,17.67
2011-12-11,16,Sunday,Evening Rush,32,174,206,15.53
2011-12-11,17,Sunday,Evening Rush,13,150,163,7.98
2011-12-11,18,Sunday,Evening Rush,12,151,163,7.36
2011-12-11,19,Sunday,Evening Rush,7,98,105,6.67
2011-12-11,20,Sunday,Night,10,62,72,13.89
2011-12-11,21,Sunday,Night,10,53,63,15.87
2011-12-11,22,Sunday,Night,7,36,43,16.28
2011-12-11,23,Sunday,Night,4,31,35,11.43
2011-12-12,0,Monday,Early Morning,4,16,20,20.0
2011-12-12,1,Monday,Early Morning,0,9,9,0.0
2011-12-12,2,Monday,Early Morning,0,4,4,0.0
2011-12-12,3,Monday,Early Morning,0,2,2,0.0
2011-12-12,4,Monday,Early Morning,0,3,3,0.0
2011-12-12,5,Monday,Early Morning,0,21,21,0.0
2011-12-12,6,Monday,Morning Rush,1,63,64,1.56
2011-12-12,7,Monday,Morning Rush,4,231,235,1.7
2011-12-12,8,Monday,Morning Rush,7,378,385,1.82
2011-12-12,9,Monday,Morning Rush,12,208,220,5.45
2011-12-12,10,Monday,Mid-Day,14,91,105,13.33
2011-12-12,11,Monday,Mid-Day,15,100,115,13.04
2011-12-12,12,Monday,Mid-Day,7,138,145,4.83
2011-12-12,13,Monday,Mid-Day,13,153,166,7.83
2011-12-12,14,Monday,Mid-Day,16,95,111,14.41
2011-12-12,15,Monday,Mid-Day,8,124,132,6.06
2011-12-12,16,Monday,Evening Rush,5,209,214,2.34
2011-12-12,17,Monday,Evening Rush,7,352,359,1.95
2011-12-12,18,Monday,Evening Rush,8,349,357,2.24
2011-12-12,19,Monday,Evening Rush,9,232,241,3.73
2011-12-12,20,Monday,Night,8,157,165,4.85
2011-12-12,21,Monday,Night,2,119,121,1.65
2011-12-12,22,Monday,Night,0,71,71,0.0
2011-12-12,23,Monday,Night,3,42,45,6.67
2011-12-13,0,Tuesday,Early Morning,1,16,17,5.88
2011-12-13,1,Tuesday,Early Morning,0,4,4,0.0
2011-12-13,2,Tuesday,Early Morning,1,1,2,50.0
2011-12-13,3,Tuesday,Early Morning,0,3,3,0.0
2011-12-13,4,Tuesday,Early Morning,0,4,4,0.0
2011-12-13,5,Tuesday,Early Morning,0,20,20,0.0
2011-12-13,6,Tuesday,Morning Rush,0,92,92,0.0
2011-12-13,7,Tuesday,Morning Rush,2,221,223,0.9
2011-12-13,8,Tuesday,Morning Rush,9,391,400,2.25
2011-12-13,9,Tuesday,Morning Rush,10,223,233,4.29
2011-12-13,10,Tuesday,Mid-Day,3,99,102,2.94
2011-12-13,11,Tuesday,Mid-Day,9,115,124,7.26
2011-12-13,12,Tuesday,Mid-Day,20,147,167,11.98
2011-12-13,13,Tuesday,Mid-Day,7,120,127,5.51
2011-12-13,14,Tuesday,Mid-Day,18,116,134,13.43
2011-12-13,15,Tuesday,Mid-Day,7,144,151,4.64
2011-12-13,16,Tuesday,Evening Rush,13,194,207,6.28
2011-12-13,17,Tuesday,Evening Rush,17,381,398,4.27
2011-12-13,18,Tuesday,Evening Rush,12,370,382,3.14
2011-12-13,19,Tuesday,Evening Rush,5,262,267,1.87
2011-12-13,20,Tuesday,Night,7,154,161,4.35
2011-12-13,21,Tuesday,Night,5,134,139,3.6
2011-12-13,22,Tuesday,Night,5,102,107,4.67
2011-12-13,23,Tuesday,Night,4,55,59,6.78
2011-12-14,0,Wednesday,Early Morning,0,22,22,0.0
2011-12-14,1,Wednesday,Early Morning,0,8,8,0.0
2011-12-14,2,Wednesday,Early Morning,0,2,2,0.0
2011-12-14,3,Wednesday,Early Morning,0,3,3,0.0
2011-12-14,4,Wednesday,Early Morning,0,4,4,0.0
2011-12-14,5,Wednesday,Early Morning,0,26,26,0.0
2011-12-14,6,Wednesday,Morning Rush,0,87,87,0.0
2011-12-14,7,Wednesday,Morning Rush,4,243,247,1.62
2011-12-14,8,Wednesday,Morning Rush,9,458,467,1.93
2011-12-14,9,Wednesday,Morning Rush,9,230,239,3.77
2011-12-14,10,Wednesday,Mid-Day,9,133,142,6.34
2011-12-14,11,Wednesday,Mid-Day,12,103,115,10.43
2011-12-14,12,Wednesday,Mid-Day,6,138,144,4.17
2011-12-14,13,Wednesday,Mid-Day,14,119,133,10.53
2011-12-14,14,Wednesday,Mid-Day,17,134,151,11.26
2011-12-14,15,Wednesday,Mid-Day,24,143,167,14.37
2011-12-14,16,Wednesday,Evening Rush,12,233,245,4.9
2011-12-14,17,Wednesday,Evening Rush,19,377,396,4.8
2011-12-14,18,Wednesday,Evening Rush,11,379,390,2.82
2011-12-14,19,Wednesday,Evening Rush,9,259,268,3.36
2011-12-14,20,Wednesday,Night,6,169,175,3.43
2011-12-14,21,Wednesday,Night,9,145,154,5.84
2011-12-14,22,Wednesday,Night,5,99,104,4.81
2011-12-14,23,Wednesday,Night,3,48,51,5.88
2011-12-15,0,Thursday,Early Morning,5,45,50,10.0
2011-12-15,1,Thursday,Early Morning,5,15,20,25.0
2011-12-15,2,Thursday,Early Morning,2,5,7,28.57
2011-12-15,3,Thursday,Early Morning,1,2,3,33.33
2011-12-15,4,Thursday,Early Morning,0,6,6,0.0
2011-12-15,5,Thursday,Early Morning,0,24,24,0.0
2011-12-15,6,Thursday,Morning Rush,2,90,92,2.17
2011-12-15,7,Thursday,Morning Rush,6,252,258,2.33
2011-12-15,8,Thursday,Morning Rush,8,449,457,1.75
2011-12-15,9,Thursday,Morning Rush,6,274,280,2.14
2011-12-15,10,Thursday,Mid-Day,4,105,109,3.67
2011-12-15,11,Thursday,Mid-Day,9,126,135,6.67
2011-12-15,12,Thursday,Mid-Day,17,140,157,10.83
2011-12-15,13,Thursday,Mid-Day,14,150,164,8.54
2011-12-15,14,Thursday,Mid-Day,8,124,132,6.06
2011-12-15,15,Thursday,Mid-Day,6,76,82,7.32
2011-12-15,16,Thursday,Evening Rush,7,124,131,5.34
2011-12-15,17,Thursday,Evening Rush,14,310,324,4.32
2011-12-15,18,Thursday,Evening Rush,14,363,377,3.71
2011-12-15,19,Thursday,Evening Rush,13,274,287,4.53
2011-12-15,20,Thursday,Night,12,209,221,5.43
2011-12-15,21,Thursday,Night,10,145,155,6.45
2011-12-15,22,Thursday,Night,8,116,124,6.45
2011-12-15,23,Thursday,Night,10,104,114,8.77
2011-12-16,0,Friday,Early Morning,12,60,72,16.67
2011-12-16,1,Friday,Early Morning,3,28,31,9.68
2011-12-16,2,Friday,Early Morning,0,23,23,0.0
2011-12-16,3,Friday,Early Morning,2,3,5,40.0
2011-12-16,4,Friday,Early Morning,1,4,5,20.0
2011-12-16,5,Friday,Early Morning,0,26,26,0.0
2011-12-16,6,Friday,Morning Rush,2,80,82,2.44
2011-12-16,7,Friday,Morning Rush,5,226,231,2.16
2011-12-16,8,Friday,Morning Rush,10,449,459,2.18
2011-12-16,9,Friday,Morning Rush,8,235,243,3.29
2011-12-16,10,Friday,Mid-Day,10,122,132,7.58
2011-12-16,11,Friday,Mid-Day,9,135,144,6.25
2011-12-16,12,Friday,Mid-Day,10,163,173,5.78
2011-12-16,13,Friday,Mid-Day,12,125,137,8.76
2011-12-16,14,Friday,Mid-Day,13,115,128,10.16
2011-12-16,15,Friday,Mid-Day,12,141,153,7.84
2011-12-16,16,Friday,Evening Rush,12,212,224,5.36
2011-12-16,17,Friday,Evening Rush,13,352,365,3.56
2011-12-16,18,Friday,Evening Rush,10,285,295,3.39
2011-12-16,19,Friday,Evening Rush,11,203,214,5.14
2011-12-16,20,Friday,Night,6,146,152,3.95
2011-12-16,21,Friday,Night,7,95,102,6.86
2011-12-16,22,Friday,Night,6,100,106,5.66
2011-12-16,23,Friday,Night,4,71,75,5.33
2011-12-17,0,Saturday,Early Morning,3,59,62,4.84
2011-12-17,1,Saturday,Early Morning,4,39,43,9.3
2011-12-17,2,Saturday,Early Morning,11,47,58,18.97
2011-12-17,3,Saturday,Early Morning,4,22,26,15.38
2011-12-17,4,Saturday,Early Morning,0,9,9,0.0
2011-12-17,5,Saturday,Early Morning,2,7,9,22.22
2011-12-17,6,Saturday,Morning Rush,0,17,17,0.0
2011-12-17,7,Saturday,Morning Rush,0,20,20,0.0
2011-12-17,8,Saturday,Morning Rush,4,55,59,6.78
2011-12-17,9,Saturday,Morning Rush,5,95,100,5.0
2011-12-17,10,Saturday,Mid-Day,10,171,181,5.52
2011-12-17,11,Saturday,Mid-Day,21,188,209,10.05
2011-12-17,12,Saturday,Mid-Day,28,216,244,11.48
2011-12-17,13,Saturday,Mid-Day,32,204,236,13.56
2011-12-17,14,Saturday,Mid-Day,30,207,237,12.66
2011-12-17,15,Saturday,Mid-Day,33,195,228,14.47
2011-12-17,16,Saturday,Evening Rush,30,192,222,13.51
2011-12-17,17,Saturday,Evening Rush,12,153,165,7.27
2011-12-17,18,Saturday,Evening Rush,7,150,157,4.46
2011-12-17,19,Saturday,Evening Rush,11,95,106,10.38
2011-12-17,20,Saturday,Night,7,99,106,6.6
2011-12-17,21,Saturday,Night,8,88,96,8.33
2011-12-17,22,Saturday,Night,7,73,80,8.75
2011-12-17,23,Saturday,Night,6,63,69,8.7
2011-12-18,0,Sunday,Early Morning,7,64,71,9.86
2011-12-18,1,Sunday,Early Morning,3,43,46,6.52
2011-12-18,2,Sunday,Early Morning,2,39,41,4.88
2011-12-18,3,Sunday,Early Morning,2,16,18,11.11
2011-12-18,4,Sunday,Early Morning,0,1,1,0.0
2011-12-18,5,Sunday,Early Morning,1,4,5,20.0
2011-12-18,6,Sunday,Morning Rush,0,3,3,0.0
2011-12-18,7,Sunday,Morning Rush,1,11,12,8.33
2011-12-18,8,Sunday,Morning Rush,1,31,32,3.13
2011-12-18,9,Sunday,Morning Rush,6,75,81,7.41
2011-12-18,10,Sunday,Mid-Day,7,122,129,5.43
2011-12-18,11,Sunday,Mid-Day,20,168,188,10.64
2011-12-18,12,Sunday,Mid-Day,26,202,228,11.4
2011-12-18,13,Sunday,Mid-Day,18,210,228,7.89
2011-12-18,14,Sunday,Mid-Day,19,200,219,8.68
2011-12-18,15,Sunday,Mid-Day,23,184,207,11.11
2011-12-18,16,Sunday,Evening Rush,27,207,234,11.54
2011-12-18,17,Sunday,Evening Rush,10,126,136,7.35
2011-12-18,18,Sunday,Evening Rush,15,123,138,10.87
2011-12-18,19,Sunday,Evening Rush,5,130,135,3.7
2011-12-18,20,Sunday,Night,10,94,104,9.62
2011-12-18,21,Sunday,Night,9,80,89,10.11
2011-12-18,22,Sunday,Night,2,47,49,4.08
2011-12-18,23,Sunday,Night,6,31,37,16.22
2011-12-19,0,Monday,Early Morning,3,14,17,17.65
2011-12-19,1,Monday,Early Morning,3,8,11,27.27
2011-12-19,2,Monday,Early Morning,0,3,3,0.0
2011-12-19,3,Monday,Early Morning,0,3,3,0.0
2011-12-19,4,Monday,Early Morning,0,4,4,0.0
2011-12-19,5,Monday,Early Morning,0,21,21,0.0
2011-12-19,6,Monday,Morning Rush,0,68,68,0.0
2011-12-19,7,Monday,Morning Rush,4,187,191,2.09
2011-12-19,8,Monday,Morning Rush,8,389,397,2.02
2011-12-19,9,Monday,Morning Rush,17,166,183,9.29
2011-12-19,10,Monday,Mid-Day,12,96,108,11.11
2011-12-19,11,Monday,Mid-Day,22,105,127,17.32
2011-12-19,12,Monday,Mid-Day,13,128,141,9.22
2011-12-19,13,Monday,Mid-Day,15,127,142,10.56
2011-12-19,14,Monday,Mid-Day,30,107,137,21.9
2011-12-19,15,Monday,Mid-Day,24,135,159,15.09
2011-12-19,16,Monday,Evening Rush,19,189,208,9.13
2011-12-19,17,Monday,Evening Rush,16,362,378,4.23
2011-12-19,18,Monday,Evening Rush,11,343,354,3.11
2011-12-19,19,Monday,Evening Rush,17,234,251,6.77
2011-12-19,20,Monday,Night,9,197,206,4.37
2011-12-19,21,Monday,Night,15,112,127,11.81
2011-12-19,22,Monday,Night,12,95,107,11.21
2011-12-19,23,Monday,Night,10,50,60,16.67
2011-12-20,0,Tuesday,Early Morning,0,21,21,0.0
2011-12-20,1,Tuesday,Early Morning,0,6,6,0.0
2011-12-20,2,Tuesday,Early Morning,1,10,11,9.09
2011-12-20,3,Tuesday,Early Morning,1,1,2,50.0
2011-12-20,4,Tuesday,Early Morning,0,4,4,0.0
2011-12-20,5,Tuesday,Early Morning,0,15,15,0.0
2011-12-20,6,Tuesday,Morning Rush,1,71,72,1.39
2011-12-20,7,Tuesday,Morning Rush,7,261,268,2.61
2011-12-20,8,Tuesday,Morning Rush,10,422,432,2.31
2011-12-20,9,Tuesday,Morning Rush,14,245,259,5.41
2011-12-20,10,Tuesday,Mid-Day,20,109,129,15.5
2011-12-20,11,Tuesday,Mid-Day,13,116,129,10.08
2011-12-20,12,Tuesday,Mid-Day,16,159,175,9.14
2011-12-20,13,Tuesday,Mid-Day,18,163,181,9.94
2011-12-20,14,Tuesday,Mid-Day,11,127,138,7.97
2011-12-20,15,Tuesday,Mid-Day,15,139,154,9.74
2011-12-20,16,Tuesday,Evening Rush,20,218,238,8.4
2011-12-20,17,Tuesday,Evening Rush,14,417,431,3.25
2011-12-20,18,Tuesday,Evening Rush,26,385,411,6.33
2011-12-20,19,Tuesday,Evening Rush,6,218,224,2.68
2011-12-20,20,Tuesday,Night,3,144,147,2.04
2011-12-20,21,Tuesday,Night,4,139,143,2.8
2011-12-20,22,Tuesday,Night,3,104,107,2.8
2011-12-20,23,Tuesday,Night,13,40,53,24.53
2011-12-21,0,Wednesday,Early Morning,7,18,25,28.0
2011-12-21,1,Wednesday,Early Morning,1,10,11,9.09
2011-12-21,2,Wednesday,Early Morning,0,4,4,0.0
2011-12-21,3,Wednesday,Early Morning,0,2,2,0.0
2011-12-21,4,Wednesday,Early Morning,0,2,2,0.0
2011-12-21,5,Wednesday,Early Morning,0,28,28,0.0
2011-12-21,6,Wednesday,Morning Rush,1,75,76,1.32
2011-12-21,7,Wednesday,Morning Rush,5,224,229,2.18
2011-12-21,8,Wednesday,Morning Rush,12,393,405,2.96
2011-12-21,9,Wednesday,Morning Rush,14,220,234,5.98
2011-12-21,10,Wednesday,Mid-Day,6,83,89,6.74
2011-12-21,11,Wednesday,Mid-Day,3,53,56,5.36
2011-12-21,12,Wednesday,Mid-Day,3,58,61,4.92
2011-12-21,13,Wednesday,Mid-Day,3,55,58,5.17
2011-12-21,14,Wednesday,Mid-Day,11,40,51,21.57
2011-12-21,15,Wednesday,Mid-Day,4,57,61,6.56
2011-12-21,16,Wednesday,Evening Rush,6,95,101,5.94
2011-12-21,17,Wednesday,Evening Rush,3,226,229,1.31
2011-12-21,18,Wednesday,Evening Rush,2,278,280,0.71
2011-12-21,19,Wednesday,Evening Rush,9,200,209,4.31
2011-12-21,20,Wednesday,Night,5,162,167,2.99
2011-12-21,21,Wednesday,Night,9,114,123,7.32
2011-12-21,22,Wednesday,Night,3,102,105,2.86
2011-12-21,23,Wednesday,Night,0,54,54,0.0
2011-12-22,0,Thursday,Early Morning,3,24,27,11.11
2011-12-22,1,Thursday,Early Morning,0,15,15,0.0
2011-12-22,2,Thursday,Early Morning,1,10,11,9.09
2011-12-22,3,Thursday,Early Morning,0,6,6,0.0
2011-12-22,4,Thursday,Early Morning,0,3,3,0.0
2011-12-22,5,Thursday,Early Morning,1,15,16,6.25
2011-12-22,6,Thursday,Morning Rush,1,63,64,1.56
2011-12-22,7,Thursday,Morning Rush,4,182,186,2.15
2011-12-22,8,Thursday,Morning Rush,10,333,343,2.92
2011-12-22,9,Thursday,Morning Rush,10,218,228,4.39
2011-12-22,10,Thursday,Mid-Day,13,128,141,9.22
2011-12-22,11,Thursday,Mid-Day,10,135,145,6.9
2011-12-22,12,Thursday,Mid-Day,22,180,202,10.89
2011-12-22,13,Thursday,Mid-Day,21,167,188,11.17
2011-12-22,14,Thursday,Mid-Day,23,136,159,14.47
2011-12-22,15,Thursday,Mid-Day,28,186,214,13.08
2011-12-22,16,Thursday,Evening Rush,30,226,256,11.72
2011-12-22,17,Thursday,Evening Rush,24,332,356,6.74
2011-12-22,18,Thursday,Evening Rush,11,277,288,3.82
2011-12-22,19,Thursday,Evening Rush,12,130,142,8.45
2011-12-22,20,Thursday,Night,0,33,33,0.0
2011-12-22,21,Thursday,Night,2,15,17,11.76
2011-12-22,22,Thursday,Night,0,17,17,0.0
2011-12-22,23,Thursday,Night,1,10,11,9.09
2011-12-23,0,Friday,Early Morning,2,7,9,22.22
2011-12-23,1,Friday,Early Morning,1,11,12,8.33
2011-12-23,2,Friday,Early Morning,1,12,13,7.69
2011-12-23,3,Friday,Early Morning,0,4,4,0.0
2011-12-23,4,Friday,Early Morning,0,2,2,0.0
2011-12-23,5,Friday,Early Morning,0,8,8,0.0
2011-12-23,6,Friday,Morning Rush,0,40,40,0.0
2011-12-23,7,Friday,Morning Rush,4,88,92,4.35
2011-12-23,8,Friday,Morning Rush,9,173,182,4.95
2011-12-23,9,Friday,Morning Rush,4,152,156,2.56
2011-12-23,10,Friday,Mid-Day,8,96,104,7.69
2011-12-23,11,Friday,Mid-Day,26,148,174,14.94
2011-12-23,12,Friday,Mid-Day,14,156,170,8.24
2011-12-23,13,Friday,Mid-Day,17,177,194,8.76
2011-12-23,14,Friday,Mid-Day,23,177,200,11.5
2011-12-23,15,Friday,Mid-Day,12,191,203,5.91
2011-12-23,16,Friday,Evening Rush,15,166,181,8.29
2011-12-23,17,Friday,Evening Rush,11,129,140,7.86
2011-12-23,18,Friday,Evening Rush,4,91,95,4.21
2011-12-23,19,Friday,Evening Rush,1,75,76,1.32
2011-12-23,20,Friday,Night,3,47,50,6.0
2011-12-23,21,Friday,Night,0,32,32,0.0
2011-12-23,22,Friday,Night,4,43,47,8.51
2011-12-23,23,Friday,Night,4,21,25,16.0
2011-12-24,0,Saturday,Early Morning,3,20,23,13.04
2011-12-24,1,Saturday,Early Morning,1,15,16,6.25
2011-12-24,2,Saturday,Early Morning,4,22,26,15.38
2011-12-24,3,Saturday,Early Morning,0,5,5,0.0
2011-12-24,4,Saturday,Early Morning,0,3,3,0.0
2011-12-24,5,Saturday,Early Morning,1,3,4,25.0
2011-12-24,6,Saturday,Morning Rush,0,10,10,0.0
2011-12-24,7,Saturday,Morning Rush,0,10,10,0.0
2011-12-24,8,Saturday,Morning Rush,0,27,27,0.0
2011-12-24,9,Saturday,Morning Rush,3,53,56,5.36
2011-12-24,10,Saturday,Mid-Day,4,52,56,7.14
2011-12-24,11,Saturday,Mid-Day,9,62,71,12.68
2011-12-24,12,Saturday,Mid-Day,15,79,94,15.96
2011-12-24,13,Saturday,Mid-Day,24,97,121,19.83
2011-12-24,14,Saturday,Mid-Day,15,70,85,17.65
2011-12-24,15,Saturday,Mid-Day,15,82,97,15.46
2011-12-24,16,Saturday,Evening Rush,25,74,99,25.25
2011-12-24,17,Saturday,Evening Rush,15,53,68,22.06
2011-12-24,18,Saturday,Evening Rush,2,33,35,5.71
2011-12-24,19,Saturday,Evening Rush,1,24,25,4.0
2011-12-24,20,Saturday,Night,5,19,24,20.83
2011-12-24,21,Saturday,Night,4,15,19,21.05
2011-12-24,22,Saturday,Night,8,12,20,40.0
2011-12-24,23,Saturday,Night,1,16,17,5.88
2011-12-25,0,Sunday,Early Morning,2,4,6,33.33
2011-12-25,1,Sunday,Early Morning,2,2,4,50.0
2011-12-25,2,Sunday,Early Morning,0,2,2,0.0
2011-12-25,3,Sunday,Early Morning,1,3,4,25.0
2011-12-25,5,Sunday,Early Morning,0,1,1,0.0
2011-12-25,6,Sunday,Morning Rush,0,1,1,0.0
2011-12-25,7,Sunday,Morning Rush,0,4,4,0.0
2011-12-25,8,Sunday,Morning Rush,1,4,5,20.0
2011-12-25,9,Sunday,Morning Rush,3,20,23,13.04
2011-12-25,10,Sunday,Mid-Day,31,12,43,72.09
2011-12-25,11,Sunday,Mid-Day,43,42,85,50.59
2011-12-25,12,Sunday,Mid-Day,25,41,66,37.88
2011-12-25,13,Sunday,Mid-Day,40,39,79,50.63
2011-12-25,14,Sunday,Mid-Day,41,45,86,47.67
2011-12-25,15,Sunday,Mid-Day,43,48,91,47.25
2011-12-25,16,Sunday,Evening Rush,35,51,86,40.7
2011-12-25,17,Sunday,Evening Rush,11,33,44,25.0
2011-12-25,18,Sunday,Evening Rush,7,23,30,23.33
2011-12-25,19,Sunday,Evening Rush,2,14,16,12.5
2011-12-25,20,Sunday,Night,8,18,26,30.77
2011-12-25,21,Sunday,Night,4,15,19,21.05
2011-12-25,22,Sunday,Night,2,15,17,11.76
2011-12-25,23,Sunday,Night,2,14,16,12.5
2011-12-26,0,Monday,Early Morning,5,6,11,45.45
2011-12-26,1,Monday,Early Morning,3,7,10,30.0
2011-12-26,2,Monday,Early Morning,2,5,7,28.57
2011-12-26,4,Monday,Early Morning,0,2,2,0.0
2011-12-26,5,Monday,Early Morning,0,4,4,0.0
2011-12-26,6,Monday,Morning Rush,0,4,4,0.0
2011-12-26,7,Monday,Morning Rush,2,17,19,10.53
2011-12-26,8,Monday,Morning Rush,5,13,18,27.78
2011-12-26,9,Monday,Morning Rush,24,38,62,38.71
2011-12-26,10,Monday,Mid-Day,31,39,70,44.29
2011-12-26,11,Monday,Mid-Day,40,51,91,43.96
2011-12-26,12,Monday,Mid-Day,34,66,100,34.0
2011-12-26,13,Monday,Mid-Day,57,83,140,40.71
2011-12-26,14,Monday,Mid-Day,73,80,153,47.71
2011-12-26,15,Monday,Mid-Day,26,105,131,19.85
2011-12-26,16,Monday,Evening Rush,28,69,97,28.87
2011-12-26,17,Monday,Evening Rush,30,67,97,30.93
2011-12-26,18,Monday,Evening Rush,21,54,75,28.0
2011-12-26,19,Monday,Evening Rush,16,49,65,24.62
2011-12-26,20,Monday,Night,14,42,56,25.0
2011-12-26,21,Monday,Night,10,39,49,20.41
2011-12-26,22,Monday,Night,5,22,27,18.52
2011-12-26,23,Monday,Night,4,25,29,13.79
2011-12-27,0,Tuesday,Early Morning,3,9,12,25.0
2011-12-27,1,Tuesday,Early Morning,0,6,6,0.0
2011-12-27,2,Tuesday,Early Morning,2,2,4,50.0
2011-12-27,3,Tuesday,Early Morning,0,3,3,0.0
2011-12-27,4,Tuesday,Early Morning,0,3,3,0.0
2011-12-27,5,Tuesday,Early Morning,0,8,8,0.0
2011-12-27,6,Tuesday,Morning Rush,0,35,35,0.0
2011-12-27,7,Tuesday,Morning Rush,1,79,80,1.25
2011-12-27,8,Tuesday,Morning Rush,9,155,164,5.49
2011-12-27,9,Tuesday,Morning Rush,19,85,104,18.27
2011-12-27,10,Tuesday,Mid-Day,13,47,60,21.67
2011-12-27,11,Tuesday,Mid-Day,6,24,30,20.0
2011-12-27,12,Tuesday,Mid-Day,8,16,24,33.33
2011-12-27,13,Tuesday,Mid-Day,1,19,20,5.0
2011-12-27,14,Tuesday,Mid-Day,0,14,14,0.0
2011-12-27,15,Tuesday,Mid-Day,2,17,19,10.53
2011-12-27,16,Tuesday,Evening Rush,2,44,46,4.35
2011-12-27,17,Tuesday,Evening Rush,6,109,115,5.22
2011-12-27,18,Tuesday,Evening Rush,9,126,135,6.67
2011-12-27,19,Tuesday,Evening Rush,3,87,90,3.33
2011-12-27,20,Tuesday,Night,3,66,69,4.35
2011-12-27,21,Tuesday,Night,11,52,63,17.46
2011-12-27,22,Tuesday,Night,3,29,32,9.38
2011-12-27,23,Tuesday,Night,2,24,26,7.69
2011-12-28,0,Wednesday,Early Morning,0,10,10,0.0
2011-12-28,1,Wednesday,Early Morning,0,12,12,0.0
2011-12-28,2,Wednesday,Early Morning,0,7,7,0.0
2011-12-28,3,Wednesday,Early Morning,0,4,4,0.0
2011-12-28,5,Wednesday,Early Morning,0,9,9,0.0
2011-12-28,6,Wednesday,Morning Rush,1,42,43,2.33
2011-12-28,7,Wednesday,Morning Rush,4,106,110,3.64
2011-12-28,8,Wednesday,Morning Rush,11,206,217,5.07
2011-12-28,9,Wednesday,Morning Rush,18,171,189,9.52
2011-12-28,10,Wednesday,Mid-Day,12,84,96,12.5
2011-12-28,11,Wednesday,Mid-Day,18,93,111,16.22
2011-12-28,12,Wednesday,Mid-Day,32,108,140,22.86
2011-12-28,13,Wednesday,Mid-Day,24,135,159,15.09
2011-12-28,14,Wednesday,Mid-Day,24,96,120,20.0
2011-12-28,15,Wednesday,Mid-Day,16,101,117,13.68
2011-12-28,16,Wednesday,Evening Rush,23,144,167,13.77
2011-12-28,17,Wednesday,Evening Rush,25,225,250,10.0
2011-12-28,18,Wednesday,Evening Rush,10,159,169,5.92
2011-12-28,19,Wednesday,Evening Rush,16,135,151,10.6
2011-12-28,20,Wednesday,Night,9,70,79,11.39
2011-12-28,21,Wednesday,Night,7,63,70,10.0
2011-12-28,22,Wednesday,Night,2,31,33,6.06
2011-12-28,23,Wednesday,Night,3,36,39,7.69
2011-12-29,0,Thursday,Early Morning,4,24,28,14.29
2011-12-29,1,Thursday,Early Morning,0,15,15,0.0
2011-12-29,2,Thursday,Early Morning,0,3,3,0.0
2011-12-29,3,Thursday,Early Morning,0,2,2,0.0
2011-12-29,4,Thursday,Early Morning,1,2,3,33.33
2011-12-29,5,Thursday,Early Morning,0,10,10,0.0
2011-12-29,6,Thursday,Morning Rush,2,39,41,4.88
2011-12-29,7,Thursday,Morning Rush,2,104,106,1.89
2011-12-29,8,Thursday,Morning Rush,3,207,210,1.43
2011-12-29,9,Thursday,Morning Rush,15,155,170,8.82
2011-12-29,10,Thursday,Mid-Day,13,97,110,11.82
2011-12-29,11,Thursday,Mid-Day,23,99,122,18.85
2011-12-29,12,Thursday,Mid-Day,12,118,130,9.23
2011-12-29,13,Thursday,Mid-Day,36,95,131,27.48
2011-12-29,14,Thursday,Mid-Day,30,112,142,21.13
2011-12-29,15,Thursday,Mid-Day,27,150,177,15.25
2011-12-29,16,Thursday,Evening Rush,22,155,177,12.43
2011-12-29,17,Thursday,Evening Rush,14,226,240,5.83
2011-12-29,18,Thursday,Evening Rush,15,192,207,7.25
2011-12-29,19,Thursday,Evening Rush,11,124,135,8.15
2011-12-29,20,Thursday,Night,8,88,96,8.33
2011-12-29,21,Thursday,Night,8,60,68,11.76
2011-12-29,22,Thursday,Night,7,48,55,12.73
2011-12-29,23,Thursday,Night,1,44,45,2.22
2011-12-30,0,Friday,Early Morning,4,26,30,13.33
2011-12-30,1,Friday,Early Morning,9,11,20,45.0
2011-12-30,2,Friday,Early Morning,2,10,12,16.67
2011-12-30,3,Friday,Early Morning,0,6,6,0.0
2011-12-30,4,Friday,Early Morning,0,2,2,0.0
2011-12-30,5,Friday,Early Morning,0,10,10,0.0
2011-12-30,6,Friday,Morning Rush,1,31,32,3.13
2011-12-30,7,Friday,Morning Rush,3,92,95,3.16
2011-12-30,8,Friday,Morning Rush,12,193,205,5.85
2011-12-30,9,Friday,Morning Rush,19,175,194,9.79
2011-12-30,10,Friday,Mid-Day,10,108,118,8.47
2011-12-30,11,Friday,Mid-Day,45,126,171,26.32
2011-12-30,12,Friday,Mid-Day,38,159,197,19.29
2011-12-30,13,Friday,Mid-Day,53,154,207,25.6
2011-12-30,14,Friday,Mid-Day,67,178,245,27.35
2011-12-30,15,Friday,Mid-Day,56,236,292,19.18
2011-12-30,16,Friday,Evening Rush,36,247,283,12.72
2011-12-30,17,Friday,Evening Rush,54,188,242,22.31
2011-12-30,18,Friday,Evening Rush,19,163,182,10.44
2011-12-30,19,Friday,Evening Rush,16,96,112,14.29
2011-12-30,20,Friday,Night,16,75,91,17.58
2011-12-30,21,Friday,Night,11,84,95,11.58
2011-12-30,22,Friday,Night,7,78,85,8.24
2011-12-30,23,Friday,Night,13,60,73,17.81
2011-12-31,0,Saturday,Early Morning,7,37,44,15.91
2011-12-31,1,Saturday,Early Morning,4,31,35,11.43
2011-12-31,2,Saturday,Early Morning,1,27,28,3.57
2011-12-31,3,Saturday,Early Morning,1,17,18,5.56
2011-12-31,4,Saturday,Early Morning,1,9,10,10.0
2011-12-31,5,Saturday,Early Morning,1,0,1,100.0
2011-12-31,6,Saturday,Morning Rush,1,5,6,16.67
2011-12-31,7,Saturday,Morning Rush,6,13,19,31.58
2011-12-31,8,Saturday,Morning Rush,7,42,49,14.29
2011-12-31,9,Saturday,Morning Rush,18,72,90,20.0
2011-12-31,10,Saturday,Mid-Day,20,108,128,15.63
2011-12-31,11,Saturday,Mid-Day,65,152,217,29.95
2011-12-31,12,Saturday,Mid-Day,93,180,273,34.07
2011-12-31,13,Saturday,Mid-Day,108,205,313,34.5
2011-12-31,14,Saturday,Mid-Day,115,185,300,38.33
2011-12-31,15,Saturday,Mid-Day,89,164,253,35.18
2011-12-31,16,Saturday,Evening Rush,52,143,195,26.67
2011-12-31,17,Saturday,Evening Rush,28,101,129,21.71
2011-12-31,18,Saturday,Evening Rush,13,80,93,13.98
2011-12-31,19,Saturday,Evening Rush,19,73,92,20.65
2011-12-31,20,Saturday,Night,8,63,71,11.27
2011-12-31,21,Saturday,Night,2,50,52,3.85
2011-12-31,22,Saturday,Night,2,36,38,5.26
2011-12-31,23,Saturday,Night,4,27,31,12.9
2012-01-01,0,Sunday,Early Morning,5,43,48,10.42
2012-01-01,1,Sunday,Early Morning,15,78,93,16.13
2012-01-01,2,Sunday,Early Morning,16,59,75,21.33
2012-01-01,3,Sunday,Early Morning,11,41,52,21.15
2012-01-01,4,Sunday,Early Morning,0,8,8,0.0
2012-01-01,5,Sunday,Early Morning,0,5,5,0.0
2012-01-01,6,Sunday,Morning Rush,1,1,2,50.0
2012-01-01,7,Sunday,Morning Rush,1,6,7,14.29
2012-01-01,8,Sunday,Morning Rush,4,10,14,28.57
2012-01-01,9,Sunday,Morning Rush,13,27,40,32.5
2012-01-01,10,Sunday,Mid-Day,18,52,70,25.71
2012-01-01,11,Sunday,Mid-Day,40,98,138,28.99
2012-01-01,12,Sunday,Mid-Day,58,143,201,28.86
2012-01-01,13,Sunday,Mid-Day,82,141,223,36.77
2012-01-01,14,Sunday,Mid-Day,120,147,267,44.94
2012-01-01,15,Sunday,Mid-Day,101,164,265,38.11
2012-01-01,16,Sunday,Evening Rush,68,147,215,31.63
2012-01-01,17,Sunday,Evening Rush,36,75,111,32.43
2012-01-01,18,Sunday,Evening Rush,25,81,106,23.58
2012-01-01,19,Sunday,Evening Rush,20,85,105,19.05
2012-01-01,20,Sunday,Night,25,58,83,30.12
2012-01-01,21,Sunday,Night,10,61,71,14.08
2012-01-01,22,Sunday,Night,13,53,66,19.7
2012-01-01,23,Sunday,Night,4,25,29,13.79
2012-01-02,0,Monday,Early Morning,8,31,39,20.51
2012-01-02,1,Monday,Early Morning,1,11,12,8.33
2012-01-02,2,Monday,Early Morning,1,6,7,14.29
2012-01-02,4,Monday,Early Morning,0,4,4,0.0
2012-01-02,5,Monday,Early Morning,1,3,4,25.0
2012-01-02,6,Monday,Morning Rush,0,14,14,0.0
2012-01-02,7,Monday,Morning Rush,0,16,16,0.0
2012-01-02,8,Monday,Morning Rush,2,51,53,3.77
2012-01-02,9,Monday,Morning Rush,15,53,68,22.06
2012-01-02,10,Monday,Mid-Day,20,89,109,18.35
2012-01-02,11,Monday,Mid-Day,33,142,175,18.86
2012-01-02,12,Monday,Mid-Day,41,161,202,20.3
2012-01-02,13,Monday,Mid-Day,26,150,176,14.77
2012-01-02,14,Monday,Mid-Day,10,141,151,6.62
2012-01-02,15,Monday,Mid-Day,29,139,168,17.26
2012-01-02,16,Monday,Evening Rush,10,144,154,6.49
2012-01-02,17,Monday,Evening Rush,17,136,153,11.11
2012-01-02,18,Monday,Evening Rush,13,113,126,10.32
2012-01-02,19,Monday,Evening Rush,4,89,93,4.3
2012-01-02,20,Monday,Night,5,83,88,5.68
2012-01-02,21,Monday,Night,3,63,66,4.55
2012-01-02,22,Monday,Night,3,36,39,7.69
2012-01-02,23,Monday,Night,2,32,34,5.88
2012-01-03,0,Tuesday,Early Morning,0,13,13,0.0
2012-01-03,1,Tuesday,Early Morning,1,5,6,16.67
2012-01-03,2,Tuesday,Early Morning,0,3,3,0.0
2012-01-03,3,Tuesday,Early Morning,0,2,2,0.0
2012-01-03,4,Tuesday,Early Morning,0,5,5,0.0
2012-01-03,5,Tuesday,Early Morning,0,12,12,0.0
2012-01-03,6,Tuesday,Morning Rush,4,81,85,4.71
2012-01-03,7,Tuesday,Morning Rush,2,168,170,1.18
2012-01-03,8,Tuesday,Morning Rush,5,349,354,1.41
2012-01-03,9,Tuesday,Morning Rush,8,145,153,5.23
2012-01-03,10,Tuesday,Mid-Day,5,55,60,8.33
2012-01-03,11,Tuesday,Mid-Day,12,63,75,16.0
2012-01-03,12,Tuesday,Mid-Day,4,70,74,5.41
2012-01-03,13,Tuesday,Mid-Day,5,68,73,6.85
2012-01-03,14,Tuesday,Mid-Day,7,72,79,8.86
2012-01-03,15,Tuesday,Mid-Day,9,68,77,11.69
2012-01-03,16,Tuesday,Evening Rush,7,129,136,5.15
2012-01-03,17,Tuesday,Evening Rush,4,241,245,1.63
2012-01-03,18,Tuesday,Evening Rush,10,214,224,4.46
2012-01-03,19,Tuesday,Evening Rush,4,152,156,2.56
2012-01-03,20,Tuesday,Night,0,115,115,0.0
2012-01-03,21,Tuesday,Night,2,66,68,2.94
2012-01-03,22,Tuesday,Night,0,33,33,0.0
2012-01-03,23,Tuesday,Night,0,18,18,0.0
2012-01-04,0,Wednesday,Early Morning,0,9,9,0.0
2012-01-04,1,Wednesday,Early Morning,0,3,3,0.0
2012-01-04,2,Wednesday,Early Morning,0,1,1,0.0
2012-01-04,3,Wednesday,Early Morning,0,1,1,0.0
2012-01-04,4,Wednesday,Early Morning,0,2,2,0.0
2012-01-04,5,Wednesday,Early Morning,0,14,14,0.0
2012-01-04,6,Wednesday,Morning Rush,0,59,59,0.0
2012-01-04,7,Wednesday,Morning Rush,1,151,152,0.66
2012-01-04,8,Wednesday,Morning Rush,5,310,315,1.59
2012-01-04,9,Wednesday,Morning Rush,7,173,180,3.89
2012-01-04,10,Wednesday,Mid-Day,7,57,64,10.94
2012-01-04,11,Wednesday,Mid-Day,6,40,46,13.04
2012-01-04,12,Wednesday,Mid-Day,9,75,84,10.71
2012-01-04,13,Wednesday,Mid-Day,9,82,91,9.89
2012-01-04,14,Wednesday,Mid-Day,6,69,75,8.0
2012-01-04,15,Wednesday,Mid-Day,9,81,90,10.0
2012-01-04,16,Wednesday,Evening Rush,8,123,131,6.11
2012-01-04,17,Wednesday,Evening Rush,9,272,281,3.2
2012-01-04,18,Wednesday,Evening Rush,9,280,289,3.11
2012-01-04,19,Wednesday,Evening Rush,2,182,184,1.09
2012-01-04,20,Wednesday,Night,2,121,123,1.63
2012-01-04,21,Wednesday,Night,2,88,90,2.22
2012-01-04,22,Wednesday,Night,4,48,52,7.69
2012-01-04,23,Wednesday,Night,0,32,32,0.0
2012-01-05,0,Thursday,Early Morning,1,13,14,7.14
2012-01-05,1,Thursday,Early Morning,0,5,5,0.0
2012-01-05,2,Thursday,Early Morning,0,4,4,0.0
2012-01-05,3,Thursday,Early Morning,0,4,4,0.0
2012-01-05,4,Thursday,Early Morning,0,5,5,0.0
2012-01-05,5,Thursday,Early Morning,0,26,26,0.0
2012-01-05,6,Thursday,Morning Rush,0,78,78,0.0
2012-01-05,7,Thursday,Morning Rush,3,212,215,1.4
2012-01-05,8,Thursday,Morning Rush,11,377,388,2.84
2012-01-05,9,Thursday,Morning Rush,7,220,227,3.08
2012-01-05,10,Thursday,Mid-Day,5,81,86,5.81
2012-01-05,11,Thursday,Mid-Day,6,78,84,7.14
2012-01-05,12,Thursday,Mid-Day,6,114,120,5.0
2012-01-05,13,Thursday,Mid-Day,6,112,118,5.08
2012-01-05,14,Thursday,Mid-Day,13,104,117,11.11
2012-01-05,15,Thursday,Mid-Day,6,113,119,5.04
2012-01-05,16,Thursday,Evening Rush,19,178,197,9.64
2012-01-05,17,Thursday,Evening Rush,19,393,412,4.61
2012-01-05,18,Thursday,Evening Rush,9,374,383,2.35
2012-01-05,19,Thursday,Evening Rush,10,255,265,3.77
2012-01-05,20,Thursday,Night,5,172,177,2.82
2012-01-05,21,Thursday,Night,9,88,97,9.28
2012-01-05,22,Thursday,Night,1,70,71,1.41
2012-01-05,23,Thursday,Night,4,56,60,6.67
2012-01-06,0,Friday,Early Morning,1,24,25,4.0
2012-01-06,1,Friday,Early Morning,2,6,8,25.0
2012-01-06,2,Friday,Early Morning,2,3,5,40.0
2012-01-06,3,Friday,Early Morning,1,3,4,25.0
2012-01-06,4,Friday,Early Morning,0,3,3,0.0
2012-01-06,5,Friday,Early Morning,0,13,13,0.0
2012-01-06,6,Friday,Morning Rush,1,69,70,1.43
2012-01-06,7,Friday,Morning Rush,4,201,205,1.95
2012-01-06,8,Friday,Morning Rush,11,436,447,2.46
2012-01-06,9,Friday,Morning Rush,4,237,241,1.66
2012-01-06,10,Friday,Mid-Day,14,102,116,12.07
2012-01-06,11,Friday,Mid-Day,8,130,138,5.8
2012-01-06,12,Friday,Mid-Day,23,168,191,12.04
2012-01-06,13,Friday,Mid-Day,16,188,204,7.84
2012-01-06,14,Friday,Mid-Day,26,152,178,14.61
2012-01-06,15,Friday,Mid-Day,44,178,222,19.82
2012-01-06,16,Friday,Evening Rush,35,259,294,11.9
2012-01-06,17,Friday,Evening Rush,20,456,476,4.2
2012-01-06,18,Friday,Evening Rush,28,391,419,6.68
2012-01-06,19,Friday,Evening Rush,11,261,272,4.04
2012-01-06,20,Friday,Night,14,163,177,7.91
2012-01-06,21,Friday,Night,17,137,154,11.04
2012-01-06,22,Friday,Night,12,123,135,8.89
2012-01-06,23,Friday,Night,13,88,101,12.87
2012-01-07,0,Saturday,Early Morning,2,77,79,2.53
2012-01-07,1,Saturday,Early Morning,6,56,62,9.68
2012-01-07,2,Saturday,Early Morning,2,36,38,5.26
2012-01-07,3,Saturday,Early Morning,1,19,20,5.0
2012-01-07,4,Saturday,Early Morning,1,9,10,10.0
2012-01-07,5,Saturday,Early Morning,2,7,9,22.22
2012-01-07,6,Saturday,Morning Rush,0,7,7,0.0
2012-01-07,7,Saturday,Morning Rush,0,20,20,0.0
2012-01-07,8,Saturday,Morning Rush,0,64,64,0.0
2012-01-07,9,Saturday,Morning Rush,14,116,130,10.77
2012-01-07,10,Saturday,Mid-Day,43,160,203,21.18
2012-01-07,11,Saturday,Mid-Day,74,250,324,22.84
2012-01-07,12,Saturday,Mid-Day,100,276,376,26.6
2012-01-07,13,Saturday,Mid-Day,149,296,445,33.48
2012-01-07,14,Saturday,Mid-Day,156,356,512,30.47
2012-01-07,15,Saturday,Mid-Day,132,317,449,29.4
2012-01-07,16,Saturday,Evening Rush,133,268,401,33.17
2012-01-07,17,Saturday,Evening Rush,87,235,322,27.02
2012-01-07,18,Saturday,Evening Rush,49,248,297,16.5
2012-01-07,19,Saturday,Evening Rush,44,171,215,20.47
2012-01-07,20,Saturday,Night,21,149,170,12.35
2012-01-07,21,Saturday,Night,22,118,140,15.71
2012-01-07,22,Saturday,Night,16,93,109,14.68
2012-01-07,23,Saturday,Night,16,103,119,13.45
2012-01-08,0,Sunday,Early Morning,14,77,91,15.38
2012-01-08,1,Sunday,Early Morning,10,62,72,13.89
2012-01-08,2,Sunday,Early Morning,10,57,67,14.93
2012-01-08,3,Sunday,Early Morning,6,26,32,18.75
2012-01-08,4,Sunday,Early Morning,2,4,6,33.33
2012-01-08,5,Sunday,Early Morning,0,2,2,0.0
2012-01-08,6,Sunday,Morning Rush,0,2,2,0.0
2012-01-08,7,Sunday,Morning Rush,1,23,24,4.17
2012-01-08,8,Sunday,Morning Rush,4,53,57,7.02
2012-01-08,9,Sunday,Morning Rush,23,102,125,18.4
2012-01-08,10,Sunday,Mid-Day,27,181,208,12.98
2012-01-08,11,Sunday,Mid-Day,55,201,256,21.48
2012-01-08,12,Sunday,Mid-Day,78,273,351,22.22
2012-01-08,13,Sunday,Mid-Day,77,266,343,22.45
2012-01-08,14,Sunday,Mid-Day,75,253,328,22.87
2012-01-08,15,Sunday,Mid-Day,89,241,330,26.97
2012-01-08,16,Sunday,Evening Rush,58,256,314,18.47
2012-01-08,17,Sunday,Evening Rush,22,197,219,10.05
2012-01-08,18,Sunday,Evening Rush,19,162,181,10.5
2012-01-08,19,Sunday,Evening Rush,8,104,112,7.14
2012-01-08,20,Sunday,Night,7,119,126,5.56
2012-01-08,21,Sunday,Night,10,81,91,10.99
2012-01-08,22,Sunday,Night,4,54,58,6.9
2012-01-08,23,Sunday,Night,0,30,30,0.0
2012-01-09,0,Monday,Early Morning,3,12,15,20.0
2012-01-09,1,Monday,Early Morning,1,4,5,20.0
2012-01-09,2,Monday,Early Morning,2,3,5,40.0
2012-01-09,3,Monday,Early Morning,0,3,3,0.0
2012-01-09,4,Monday,Early Morning,0,4,4,0.0
2012-01-09,5,Monday,Early Morning,0,21,21,0.0
2012-01-09,6,Monday,Morning Rush,3,85,88,3.41
2012-01-09,7,Monday,Morning Rush,1,239,240,0.42
2012-01-09,8,Monday,Morning Rush,13,407,420,3.1
2012-01-09,9,Monday,Morning Rush,9,188,197,4.57
2012-01-09,10,Monday,Mid-Day,13,95,108,12.04
2012-01-09,11,Monday,Mid-Day,6,82,88,6.82
2012-01-09,12,Monday,Mid-Day,10,93,103,9.71
2012-01-09,13,Monday,Mid-Day,3,77,80,3.75
2012-01-09,14,Monday,Mid-Day,5,45,50,10.0
2012-01-09,15,Monday,Mid-Day,5,64,69,7.25
2012-01-09,16,Monday,Evening Rush,3,46,49,6.12
2012-01-09,17,Monday,Evening Rush,5,147,152,3.29
2012-01-09,18,Monday,Evening Rush,6,158,164,3.66
2012-01-09,19,Monday,Evening Rush,3,187,190,1.58
2012-01-09,20,Monday,Night,5,127,132,3.79
2012-01-09,21,Monday,Night,1,78,79,1.27
2012-01-09,22,Monday,Night,8,54,62,12.9
2012-01-09,23,Monday,Night,1,51,52,1.92
2012-01-10,0,Tuesday,Early Morning,0,14,14,0.0
2012-01-10,1,Tuesday,Early Morning,2,3,5,40.0
2012-01-10,2,Tuesday,Early Morning,2,2,4,50.0
2012-01-10,4,Tuesday,Early Morning,0,4,4,0.0
2012-01-10,5,Tuesday,Early Morning,0,23,23,0.0
2012-01-10,6,Tuesday,Morning Rush,0,79,79,0.0
2012-01-10,7,Tuesday,Morning Rush,3,219,222,1.35
2012-01-10,8,Tuesday,Morning Rush,6,465,471,1.27
2012-01-10,9,Tuesday,Morning Rush,11,184,195,5.64
2012-01-10,10,Tuesday,Mid-Day,3,80,83,3.61
2012-01-10,11,Tuesday,Mid-Day,8,93,101,7.92
2012-01-10,12,Tuesday,Mid-Day,13,127,140,9.29
2012-01-10,13,Tuesday,Mid-Day,15,163,178,8.43
2012-01-10,14,Tuesday,Mid-Day,10,96,106,9.43
2012-01-10,15,Tuesday,Mid-Day,17,119,136,12.5
2012-01-10,16,Tuesday,Evening Rush,15,225,240,6.25
2012-01-10,17,Tuesday,Evening Rush,14,446,460,3.04
2012-01-10,18,Tuesday,Evening Rush,13,372,385,3.38
2012-01-10,19,Tuesday,Evening Rush,11,270,281,3.91
2012-01-10,20,Tuesday,Night,10,190,200,5.0
2012-01-10,21,Tuesday,Night,7,109,116,6.03
2012-01-10,22,Tuesday,Night,10,104,114,8.77
2012-01-10,23,Tuesday,Night,3,38,41,7.32
2012-01-11,0,Wednesday,Early Morning,2,26,28,7.14
2012-01-11,1,Wednesday,Early Morning,1,6,7,14.29
2012-01-11,2,Wednesday,Early Morning,0,5,5,0.0
2012-01-11,3,Wednesday,Early Morning,0,4,4,0.0
2012-01-11,4,Wednesday,Early Morning,0,2,2,0.0
2012-01-11,5,Wednesday,Early Morning,0,22,22,0.0
2012-01-11,6,Wednesday,Morning Rush,2,72,74,2.7
2012-01-11,7,Wednesday,Morning Rush,9,247,256,3.52
2012-01-11,8,Wednesday,Morning Rush,11,488,499,2.2
2012-01-11,9,Wednesday,Morning Rush,7,218,225,3.11
2012-01-11,10,Wednesday,Mid-Day,13,84,97,13.4
2012-01-11,11,Wednesday,Mid-Day,9,90,99,9.09
2012-01-11,12,Wednesday,Mid-Day,4,51,55,7.27
2012-01-11,13,Wednesday,Mid-Day,8,57,65,12.31
2012-01-11,14,Wednesday,Mid-Day,3,70,73,4.11
2012-01-11,15,Wednesday,Mid-Day,6,73,79,7.59
2012-01-11,16,Wednesday,Evening Rush,6,112,118,5.08
2012-01-11,17,Wednesday,Evening Rush,6,128,134,4.48
2012-01-11,18,Wednesday,Evening Rush,2,96,98,2.04
2012-01-11,19,Wednesday,Evening Rush,1,92,93,1.08
2012-01-11,20,Wednesday,Night,2,55,57,3.51
2012-01-11,21,Wednesday,Night,0,29,29,0.0
2012-01-11,22,Wednesday,Night,0,49,49,0.0
2012-01-11,23,Wednesday,Night,0,9,9,0.0
2012-01-12,0,Thursday,Early Morning,0,3,3,0.0
2012-01-12,1,Thursday,Early Morning,0,3,3,0.0
2012-01-12,2,Thursday,Early Morning,1,1,2,50.0
2012-01-12,3,Thursday,Early Morning,0,3,3,0.0
2012-01-12,4,Thursday,Early Morning,0,2,2,0.0
2012-01-12,5,Thursday,Early Morning,0,16,16,0.0
2012-01-12,6,Thursday,Morning Rush,1,88,89,1.12
2012-01-12,7,Thursday,Morning Rush,2,218,220,0.91
2012-01-12,8,Thursday,Morning Rush,11,497,508,2.17
2012-01-12,9,Thursday,Morning Rush,10,220,230,4.35
2012-01-12,10,Thursday,Mid-Day,6,84,90,6.67
2012-01-12,11,Thursday,Mid-Day,18,101,119,15.13
2012-01-12,12,Thursday,Mid-Day,14,130,144,9.72
2012-01-12,13,Thursday,Mid-Day,13,170,183,7.1
2012-01-12,14,Thursday,Mid-Day,24,132,156,15.38
2012-01-12,15,Thursday,Mid-Day,32,156,188,17.02
2012-01-12,16,Thursday,Evening Rush,33,248,281,11.74
2012-01-12,17,Thursday,Evening Rush,23,472,495,4.65
2012-01-12,18,Thursday,Evening Rush,22,399,421,5.23
2012-01-12,19,Thursday,Evening Rush,17,313,330,5.15
2012-01-12,20,Thursday,Night,11,229,240,4.58
2012-01-12,21,Thursday,Night,12,162,174,6.9
2012-01-12,22,Thursday,Night,12,121,133,9.02
2012-01-12,23,Thursday,Night,7,60,67,10.45
2012-01-13,0,Friday,Early Morning,4,38,42,9.52
2012-01-13,1,Friday,Early Morning,0,12,12,0.0
2012-01-13,2,Friday,Early Morning,1,13,14,7.14
2012-01-13,3,Friday,Early Morning,3,4,7,42.86
2012-01-13,4,Friday,Early Morning,1,2,3,33.33
2012-01-13,5,Friday,Early Morning,0,21,21,0.0
2012-01-13,6,Friday,Morning Rush,2,71,73,2.74
2012-01-13,7,Friday,Morning Rush,3,174,177,1.69
2012-01-13,8,Friday,Morning Rush,11,408,419,2.63
2012-01-13,9,Friday,Morning Rush,10,204,214,4.67
2012-01-13,10,Friday,Mid-Day,2,101,103,1.94
2012-01-13,11,Friday,Mid-Day,12,102,114,10.53
2012-01-13,12,Friday,Mid-Day,14,140,154,9.09
2012-01-13,13,Friday,Mid-Day,14,140,154,9.09
2012-01-13,14,Friday,Mid-Day,10,119,129,7.75
2012-01-13,15,Friday,Mid-Day,15,123,138,10.87
2012-01-13,16,Friday,Evening Rush,18,215,233,7.73
2012-01-13,17,Friday,Evening Rush,15,317,332,4.52
2012-01-13,18,Friday,Evening Rush,7,294,301,2.33
2012-01-13,19,Friday,Evening Rush,7,199,206,3.4
2012-01-13,20,Friday,Night,6,130,136,4.41
2012-01-13,21,Friday,Night,7,95,102,6.86
2012-01-13,22,Friday,Night,7,58,65,10.77
2012-01-13,23,Friday,Night,5,60,65,7.69
2012-01-14,0,Saturday,Early Morning,2,42,44,4.55
2012-01-14,1,Saturday,Early Morning,6,44,50,12.0
2012-01-14,2,Saturday,Early Morning,6,32,38,15.79
2012-01-14,3,Saturday,Early Morning,6,14,20,30.0
2012-01-14,4,Saturday,Early Morning,0,3,3,0.0
2012-01-14,5,Saturday,Early Morning,0,4,4,0.0
2012-01-14,6,Saturday,Morning Rush,0,5,5,0.0
2012-01-14,7,Saturday,Morning Rush,0,24,24,0.0
2012-01-14,8,Saturday,Morning Rush,3,89,92,3.26
2012-01-14,9,Saturday,Morning Rush,3,78,81,3.7
2012-01-14,10,Saturday,Mid-Day,14,135,149,9.4
2012-01-14,11,Saturday,Mid-Day,28,150,178,15.73
2012-01-14,12,Saturday,Mid-Day,30,189,219,13.7
2012-01-14,13,Saturday,Mid-Day,38,182,220,17.27
2012-01-14,14,Saturday,Mid-Day,52,179,231,22.51
2012-01-14,15,Saturday,Mid-Day,49,177,226,21.68
2012-01-14,16,Saturday,Evening Rush,28,178,206,13.59
2012-01-14,17,Saturday,Evening Rush,15,129,144,10.42
2012-01-14,18,Saturday,Evening Rush,21,122,143,14.69
2012-01-14,19,Saturday,Evening Rush,12,90,102,11.76
2012-01-14,20,Saturday,Night,8,95,103,7.77
2012-01-14,21,Saturday,Night,3,66,69,4.35
2012-01-14,22,Saturday,Night,4,62,66,6.06
2012-01-14,23,Saturday,Night,5,71,76,6.58
2012-01-15,0,Sunday,Early Morning,9,50,59,15.25
2012-01-15,1,Sunday,Early Morning,2,40,42,4.76
2012-01-15,2,Sunday,Early Morning,5,38,43,11.63
2012-01-15,3,Sunday,Early Morning,1,24,25,4.0
2012-01-15,4,Sunday,Early Morning,1,5,6,16.67
2012-01-15,5,Sunday,Early Morning,0,5,5,0.0
2012-01-15,6,Sunday,Morning Rush,1,7,8,12.5
2012-01-15,7,Sunday,Morning Rush,3,14,17,17.65
2012-01-15,8,Sunday,Morning Rush,2,34,36,5.56
2012-01-15,9,Sunday,Morning Rush,10,80,90,11.11
2012-01-15,10,Sunday,Mid-Day,11,115,126,8.73
2012-01-15,11,Sunday,Mid-Day,21,144,165,12.73
2012-01-15,12,Sunday,Mid-Day,42,192,234,17.95
2012-01-15,13,Sunday,Mid-Day,40,184,224,17.86
2012-01-15,14,Sunday,Mid-Day,25,163,188,13.3
2012-01-15,15,Sunday,Mid-Day,33,173,206,16.02
2012-01-15,16,Sunday,Evening Rush,31,174,205,15.12
2012-01-15,17,Sunday,Evening Rush,15,131,146,10.27
2012-01-15,18,Sunday,Evening Rush,7,113,120,5.83
2012-01-15,19,Sunday,Evening Rush,9,101,110,8.18
2012-01-15,20,Sunday,Night,10,85,95,10.53
2012-01-15,21,Sunday,Night,1,71,72,1.39
2012-01-15,22,Sunday,Night,2,58,60,3.33
2012-01-15,23,Sunday,Night,3,26,29,10.34
2012-01-16,0,Monday,Early Morning,2,23,25,8.0
2012-01-16,1,Monday,Early Morning,2,18,20,10.0
2012-01-16,2,Monday,Early Morning,3,14,17,17.65
2012-01-16,3,Monday,Early Morning,0,3,3,0.0
2012-01-16,4,Monday,Early Morning,2,6,8,25.0
2012-01-16,5,Monday,Early Morning,1,5,6,16.67
2012-01-16,6,Monday,Morning Rush,0,13,13,0.0
2012-01-16,7,Monday,Morning Rush,5,28,33,15.15
2012-01-16,8,Monday,Morning Rush,3,75,78,3.85
2012-01-16,9,Monday,Morning Rush,7,89,96,7.29
2012-01-16,10,Monday,Mid-Day,19,107,126,15.08
2012-01-16,11,Monday,Mid-Day,21,158,179,11.73
2012-01-16,12,Monday,Mid-Day,20,165,185,10.81
2012-01-16,13,Monday,Mid-Day,26,202,228,11.4
2012-01-16,14,Monday,Mid-Day,23,158,181,12.71
2012-01-16,15,Monday,Mid-Day,17,175,192,8.85
2012-01-16,16,Monday,Evening Rush,22,158,180,12.22
2012-01-16,17,Monday,Evening Rush,19,174,193,9.84
2012-01-16,18,Monday,Evening Rush,6,175,181,3.31
2012-01-16,19,Monday,Evening Rush,10,134,144,6.94
2012-01-16,20,Monday,Night,2,88,90,2.22
2012-01-16,21,Monday,Night,3,46,49,6.12
2012-01-16,22,Monday,Night,4,39,43,9.3
2012-01-16,23,Monday,Night,0,28,28,0.0
2012-01-17,0,Tuesday,Early Morning,0,12,12,0.0
2012-01-17,1,Tuesday,Early Morning,0,2,2,0.0
2012-01-17,2,Tuesday,Early Morning,0,12,12,0.0
2012-01-17,4,Tuesday,Early Morning,0,2,2,0.0
2012-01-17,5,Tuesday,Early Morning,0,13,13,0.0
2012-01-17,6,Tuesday,Morning Rush,0,57,57,0.0
2012-01-17,7,Tuesday,Morning Rush,5,121,126,3.97
2012-01-17,8,Tuesday,Morning Rush,3,90,93,3.23
2012-01-17,9,Tuesday,Morning Rush,7,61,68,10.29
2012-01-17,10,Tuesday,Mid-Day,1,61,62,1.61
2012-01-17,11,Tuesday,Mid-Day,2,73,75,2.67
2012-01-17,12,Tuesday,Mid-Day,3,83,86,3.49
2012-01-17,13,Tuesday,Mid-Day,8,95,103,7.77
2012-01-17,14,Tuesday,Mid-Day,12,120,132,9.09
2012-01-17,15,Tuesday,Mid-Day,6,123,129,4.65
2012-01-17,16,Tuesday,Evening Rush,14,205,219,6.39
2012-01-17,17,Tuesday,Evening Rush,20,442,462,4.33
2012-01-17,18,Tuesday,Evening Rush,12,451,463,2.59
2012-01-17,19,Tuesday,Evening Rush,11,297,308,3.57
2012-01-17,20,Tuesday,Night,11,169,180,6.11
2012-01-17,21,Tuesday,Night,6,174,180,3.33
2012-01-17,22,Tuesday,Night,5,85,90,5.56
2012-01-17,23,Tuesday,Night,1,60,61,1.64
2012-01-18,0,Wednesday,Early Morning,3,14,17,17.65
2012-01-18,1,Wednesday,Early Morning,0,10,10,0.0
2012-01-18,2,Wednesday,Early Morning,1,1,2,50.0
2012-01-18,3,Wednesday,Early Morning,1,3,4,25.0
2012-01-18,4,Wednesday,Early Morning,0,1,1,0.0
2012-01-18,5,Wednesday,Early Morning,0,29,29,0.0
2012-01-18,6,Wednesday,Morning Rush,0,88,88,0.0
2012-01-18,7,Wednesday,Morning Rush,1,262,263,0.38
2012-01-18,8,Wednesday,Morning Rush,15,474,489,3.07
2012-01-18,9,Wednesday,Morning Rush,6,196,202,2.97
2012-01-18,10,Wednesday,Mid-Day,5,88,93,5.38
2012-01-18,11,Wednesday,Mid-Day,4,110,114,3.51
2012-01-18,12,Wednesday,Mid-Day,6,155,161,3.73
2012-01-18,13,Wednesday,Mid-Day,6,124,130,4.62
2012-01-18,14,Wednesday,Mid-Day,7,98,105,6.67
2012-01-18,15,Wednesday,Mid-Day,8,122,130,6.15
2012-01-18,16,Wednesday,Evening Rush,13,163,176,7.39
2012-01-18,17,Wednesday,Evening Rush,8,338,346,2.31
2012-01-18,18,Wednesday,Evening Rush,8,347,355,2.25
2012-01-18,19,Wednesday,Evening Rush,5,251,256,1.95
2012-01-18,20,Wednesday,Night,1,164,165,0.61
2012-01-18,21,Wednesday,Night,5,119,124,4.03
2012-01-18,22,Wednesday,Night,4,74,78,5.13
2012-01-18,23,Wednesday,Night,2,36,38,5.26
2012-01-19,0,Thursday,Early Morning,0,16,16,0.0
2012-01-19,1,Thursday,Early Morning,0,5,5,0.0
2012-01-19,2,Thursday,Early Morning,0,3,3,0.0
2012-01-19,3,Thursday,Early Morning,0,4,4,0.0
2012-01-19,4,Thursday,Early Morning,0,1,1,0.0
2012-01-19,5,Thursday,Early Morning,0,19,19,0.0
2012-01-19,6,Thursday,Morning Rush,0,86,86,0.0
2012-01-19,7,Thursday,Morning Rush,2,204,206,0.97
2012-01-19,8,Thursday,Morning Rush,9,414,423,2.13
2012-01-19,9,Thursday,Morning Rush,6,204,210,2.86
2012-01-19,10,Thursday,Mid-Day,10,98,108,9.26
2012-01-19,11,Thursday,Mid-Day,6,93,99,6.06
2012-01-19,12,Thursday,Mid-Day,5,106,111,4.5
2012-01-19,13,Thursday,Mid-Day,6,118,124,4.84
2012-01-19,14,Thursday,Mid-Day,15,104,119,12.61
2012-01-19,15,Thursday,Mid-Day,9,118,127,7.09
2012-01-19,16,Thursday,Evening Rush,8,185,193,4.15
2012-01-19,17,Thursday,Evening Rush,21,364,385,5.45
2012-01-19,18,Thursday,Evening Rush,16,345,361,4.43
2012-01-19,19,Thursday,Evening Rush,5,229,234,2.14
2012-01-19,20,Thursday,Night,7,184,191,3.66
2012-01-19,21,Thursday,Night,4,117,121,3.31
2012-01-19,22,Thursday,Night,0,90,90,0.0
2012-01-19,23,Thursday,Night,1,55,56,1.79
2012-01-20,0,Friday,Early Morning,3,24,27,11.11
2012-01-20,1,Friday,Early Morning,0,15,15,0.0
2012-01-20,2,Friday,Early Morning,0,11,11,0.0
2012-01-20,3,Friday,Early Morning,0,4,4,0.0
2012-01-20,4,Friday,Early Morning,0,3,3,0.0
2012-01-20,5,Friday,Early Morning,0,19,19,0.0
2012-01-20,6,Friday,Morning Rush,0,68,68,0.0
2012-01-20,7,Friday,Morning Rush,2,183,185,1.08
2012-01-20,8,Friday,Morning Rush,4,421,425,0.94
2012-01-20,9,Friday,Morning Rush,21,242,263,7.98
2012-01-20,10,Friday,Mid-Day,1,96,97,1.03
2012-01-20,11,Friday,Mid-Day,6,117,123,4.88
2012-01-20,12,Friday,Mid-Day,5,119,124,4.03
2012-01-20,13,Friday,Mid-Day,12,144,156,7.69
2012-01-20,14,Friday,Mid-Day,8,107,115,6.96
2012-01-20,15,Friday,Mid-Day,12,144,156,7.69
2012-01-20,16,Friday,Evening Rush,11,163,174,6.32
2012-01-20,17,Friday,Evening Rush,9,340,349,2.58
2012-01-20,18,Friday,Evening Rush,5,296,301,1.66
2012-01-20,19,Friday,Evening Rush,6,186,192,3.13
2012-01-20,20,Friday,Night,1,141,142,0.7
2012-01-20,21,Friday,Night,5,99,104,4.81
2012-01-20,22,Friday,Night,1,71,72,1.39
2012-01-20,23,Friday,Night,3,35,38,7.89
2012-01-21,0,Saturday,Early Morning,0,24,24,0.0
2012-01-21,1,Saturday,Early Morning,1,22,23,4.35
2012-01-21,2,Saturday,Early Morning,1,25,26,3.85
2012-01-21,3,Saturday,Early Morning,0,13,13,0.0
2012-01-21,4,Saturday,Early Morning,0,1,1,0.0
2012-01-21,5,Saturday,Early Morning,0,2,2,0.0
2012-01-21,6,Saturday,Morning Rush,0,1,1,0.0
2012-01-21,7,Saturday,Morning Rush,3,10,13,23.08
2012-01-21,8,Saturday,Morning Rush,3,22,25,12.0
2012-01-21,9,Saturday,Morning Rush,2,40,42,4.76
2012-01-21,10,Saturday,Mid-Day,0,45,45,0.0
2012-01-21,11,Saturday,Mid-Day,1,62,63,1.59
2012-01-21,12,Saturday,Mid-Day,5,62,67,7.46
2012-01-21,13,Saturday,Mid-Day,10,66,76,13.16
2012-01-21,14,Saturday,Mid-Day,6,89,95,6.32
2012-01-21,15,Saturday,Mid-Day,6,113,119,5.04
2012-01-21,16,Saturday,Evening Rush,5,113,118,4.24
2012-01-21,17,Saturday,Evening Rush,7,99,106,6.6
2012-01-21,18,Saturday,Evening Rush,3,107,110,2.73
2012-01-21,19,Saturday,Evening Rush,0,85,85,0.0
2012-01-21,20,Saturday,Night,5,62,67,7.46
2012-01-21,21,Saturday,Night,5,64,69,7.25
2012-01-21,22,Saturday,Night,3,56,59,5.08
2012-01-21,23,Saturday,Night,1,51,52,1.92
2012-01-22,0,Sunday,Early Morning,1,51,52,1.92
2012-01-22,1,Sunday,Early Morning,1,49,50,2.0
2012-01-22,2,Sunday,Early Morning,1,46,47,2.13
2012-01-22,3,Sunday,Early Morning,1,20,21,4.76
2012-01-22,4,Sunday,Early Morning,1,1,2,50.0
2012-01-22,5,Sunday,Early Morning,1,2,3,33.33
2012-01-22,6,Sunday,Morning Rush,0,4,4,0.0
2012-01-22,7,Sunday,Morning Rush,2,11,13,15.38
2012-01-22,8,Sunday,Morning Rush,3,29,32,9.38
2012-01-22,9,Sunday,Morning Rush,9,54,63,14.29
2012-01-22,10,Sunday,Mid-Day,9,120,129,6.98
2012-01-22,11,Sunday,Mid-Day,18,115,133,13.53
2012-01-22,12,Sunday,Mid-Day,24,161,185,12.97
2012-01-22,13,Sunday,Mid-Day,24,175,199,12.06
2012-01-22,14,Sunday,Mid-Day,19,163,182,10.44
2012-01-22,15,Sunday,Mid-Day,27,149,176,15.34
2012-01-22,16,Sunday,Evening Rush,12,143,155,7.74
2012-01-22,17,Sunday,Evening Rush,8,100,108,7.41
2012-01-22,18,Sunday,Evening Rush,11,110,121,9.09
2012-01-22,19,Sunday,Evening Rush,9,80,89,10.11
2012-01-22,20,Sunday,Night,5,69,74,6.76
2012-01-22,21,Sunday,Night,8,36,44,18.18
2012-01-22,22,Sunday,Night,0,58,58,0.0
2012-01-22,23,Sunday,Night,2,35,37,5.41
2012-01-23,0,Monday,Early Morning,2,17,19,10.53
2012-01-23,1,Monday,Early Morning,0,4,4,0.0
2012-01-23,2,Monday,Early Morning,0,2,2,0.0
2012-01-23,3,Monday,Early Morning,0,1,1,0.0
2012-01-23,4,Monday,Early Morning,0,1,1,0.0
2012-01-23,5,Monday,Early Morning,0,19,19,0.0
2012-01-23,6,Monday,Morning Rush,6,36,42,14.29
2012-01-23,7,Monday,Morning Rush,8,114,122,6.56
2012-01-23,8,Monday,Morning Rush,5,267,272,1.84
2012-01-23,9,Monday,Morning Rush,13,198,211,6.16
2012-01-23,10,Monday,Mid-Day,10,139,149,6.71
2012-01-23,11,Monday,Mid-Day,5,57,62,8.06
2012-01-23,12,Monday,Mid-Day,10,52,62,16.13
2012-01-23,13,Monday,Mid-Day,5,32,37,13.51
2012-01-23,14,Monday,Mid-Day,13,48,61,21.31
2012-01-23,15,Monday,Mid-Day,10,64,74,13.51
2012-01-23,16,Monday,Evening Rush,14,108,122,11.48
2012-01-23,17,Monday,Evening Rush,6,270,276,2.17
2012-01-23,18,Monday,Evening Rush,7,275,282,2.48
2012-01-23,19,Monday,Evening Rush,9,211,220,4.09
2012-01-23,20,Monday,Night,8,161,169,4.73
2012-01-23,21,Monday,Night,8,112,120,6.67
2012-01-23,22,Monday,Night,4,64,68,5.88
2012-01-23,23,Monday,Night,2,35,37,5.41
2012-01-24,0,Tuesday,Early Morning,6,19,25,24.0
2012-01-24,1,Tuesday,Early Morning,2,7,9,22.22
2012-01-24,2,Tuesday,Early Morning,2,6,8,25.0
2012-01-24,3,Tuesday,Early Morning,0,3,3,0.0
2012-01-24,4,Tuesday,Early Morning,0,2,2,0.0
2012-01-24,5,Tuesday,Early Morning,0,26,26,0.0
2012-01-24,6,Tuesday,Morning Rush,1,88,89,1.12
2012-01-24,7,Tuesday,Morning Rush,11,221,232,4.74
2012-01-24,8,Tuesday,Morning Rush,11,479,490,2.24
2012-01-24,9,Tuesday,Morning Rush,11,244,255,4.31
2012-01-24,10,Tuesday,Mid-Day,23,93,116,19.83
2012-01-24,11,Tuesday,Mid-Day,30,123,153,19.61
2012-01-24,12,Tuesday,Mid-Day,25,150,175,14.29
2012-01-24,13,Tuesday,Mid-Day,33,170,203,16.26
2012-01-24,14,Tuesday,Mid-Day,35,138,173,20.23
2012-01-24,15,Tuesday,Mid-Day,52,156,208,25.0
2012-01-24,16,Tuesday,Evening Rush,35,243,278,12.59
2012-01-24,17,Tuesday,Evening Rush,41,474,515,7.96
2012-01-24,18,Tuesday,Evening Rush,32,391,423,7.57
2012-01-24,19,Tuesday,Evening Rush,20,311,331,6.04
2012-01-24,20,Tuesday,Night,18,211,229,7.86
2012-01-24,21,Tuesday,Night,18,154,172,10.47
2012-01-24,22,Tuesday,Night,14,111,125,11.2
2012-01-24,23,Tuesday,Night,19,80,99,19.19
2012-01-25,0,Wednesday,Early Morning,6,25,31,19.35
2012-01-25,1,Wednesday,Early Morning,4,9,13,30.77
2012-01-25,2,Wednesday,Early Morning,3,3,6,50.0
2012-01-25,3,Wednesday,Early Morning,0,1,1,0.0
2012-01-25,4,Wednesday,Early Morning,0,4,4,0.0
2012-01-25,5,Wednesday,Early Morning,0,33,33,0.0
2012-01-25,6,Wednesday,Morning Rush,1,87,88,1.14
2012-01-25,7,Wednesday,Morning Rush,14,243,257,5.45
2012-01-25,8,Wednesday,Morning Rush,18,495,513,3.51
2012-01-25,9,Wednesday,Morning Rush,18,218,236,7.63
2012-01-25,10,Wednesday,Mid-Day,30,111,141,21.28
2012-01-25,11,Wednesday,Mid-Day,52,105,157,33.12
2012-01-25,12,Wednesday,Mid-Day,46,147,193,23.83
2012-01-25,13,Wednesday,Mid-Day,63,149,212,29.72
2012-01-25,14,Wednesday,Mid-Day,53,107,160,33.13
2012-01-25,15,Wednesday,Mid-Day,30,125,155,19.35
2012-01-25,16,Wednesday,Evening Rush,29,217,246,11.79
2012-01-25,17,Wednesday,Evening Rush,27,443,470,5.74
2012-01-25,18,Wednesday,Evening Rush,24,415,439,5.47
2012-01-25,19,Wednesday,Evening Rush,5,311,316,1.58
2012-01-25,20,Wednesday,Night,10,225,235,4.26
2012-01-25,21,Wednesday,Night,19,166,185,10.27
2012-01-25,22,Wednesday,Night,12,101,113,10.62
2012-01-25,23,Wednesday,Night,3,63,66,4.55
2012-01-26,0,Thursday,Early Morning,3,22,25,12.0
2012-01-26,1,Thursday,Early Morning,5,16,21,23.81
2012-01-26,2,Thursday,Early Morning,1,6,7,14.29
2012-01-26,3,Thursday,Early Morning,1,5,6,16.67
2012-01-26,4,Thursday,Early Morning,0,3,3,0.0
2012-01-26,5,Thursday,Early Morning,0,28,28,0.0
2012-01-26,6,Thursday,Morning Rush,0,88,88,0.0
2012-01-26,7,Thursday,Morning Rush,11,228,239,4.6
2012-01-26,8,Thursday,Morning Rush,16,514,530,3.02
2012-01-26,9,Thursday,Morning Rush,18,256,274,6.57
2012-01-26,10,Thursday,Mid-Day,16,92,108,14.81
2012-01-26,11,Thursday,Mid-Day,11,100,111,9.91
2012-01-26,12,Thursday,Mid-Day,29,136,165,17.58
2012-01-26,13,Thursday,Mid-Day,17,156,173,9.83
2012-01-26,14,Thursday,Mid-Day,16,112,128,12.5
2012-01-26,15,Thursday,Mid-Day,22,142,164,13.41
2012-01-26,16,Thursday,Evening Rush,15,209,224,6.7
2012-01-26,17,Thursday,Evening Rush,16,397,413,3.87
2012-01-26,18,Thursday,Evening Rush,12,394,406,2.96
2012-01-26,19,Thursday,Evening Rush,11,302,313,3.51
2012-01-26,20,Thursday,Night,8,216,224,3.57
2012-01-26,21,Thursday,Night,8,184,192,4.17
2012-01-26,22,Thursday,Night,3,139,142,2.11
2012-01-26,23,Thursday,Night,5,86,91,5.49
2012-01-27,0,Friday,Early Morning,6,32,38,15.79
2012-01-27,1,Friday,Early Morning,6,23,29,20.69
2012-01-27,2,Friday,Early Morning,2,11,13,15.38
2012-01-27,3,Friday,Early Morning,3,5,8,37.5
2012-01-27,4,Friday,Early Morning,1,3,4,25.0
2012-01-27,5,Friday,Early Morning,0,24,24,0.0
2012-01-27,6,Friday,Morning Rush,0,72,72,0.0
2012-01-27,7,Friday,Morning Rush,6,128,134,4.48
2012-01-27,8,Friday,Morning Rush,14,206,220,6.36
2012-01-27,9,Friday,Morning Rush,6,101,107,5.61
2012-01-27,10,Friday,Mid-Day,9,117,126,7.14
2012-01-27,11,Friday,Mid-Day,10,95,105,9.52
2012-01-27,12,Friday,Mid-Day,25,155,180,13.89
2012-01-27,13,Friday,Mid-Day,26,175,201,12.94
2012-01-27,14,Friday,Mid-Day,23,153,176,13.07
2012-01-27,15,Friday,Mid-Day,27,170,197,13.71
2012-01-27,16,Friday,Evening Rush,26,241,267,9.74
2012-01-27,17,Friday,Evening Rush,16,406,422,3.79
2012-01-27,18,Friday,Evening Rush,20,363,383,5.22
2012-01-27,19,Friday,Evening Rush,10,241,251,3.98
2012-01-27,20,Friday,Night,6,153,159,3.77
2012-01-27,21,Friday,Night,8,127,135,5.93
2012-01-27,22,Friday,Night,11,108,119,9.24
2012-01-27,23,Friday,Night,8,78,86,9.3
2012-01-28,0,Saturday,Early Morning,1,68,69,1.45
2012-01-28,1,Saturday,Early Morning,1,57,58,1.72
2012-01-28,2,Saturday,Early Morning,3,38,41,7.32
2012-01-28,3,Saturday,Early Morning,1,16,17,5.88
2012-01-28,4,Saturday,Early Morning,0,8,8,0.0
2012-01-28,5,Saturday,Early Morning,0,10,10,0.0
2012-01-28,6,Saturday,Morning Rush,3,12,15,20.0
2012-01-28,7,Saturday,Morning Rush,3,28,31,9.68
2012-01-28,8,Saturday,Morning Rush,9,82,91,9.89
2012-01-28,9,Saturday,Morning Rush,13,145,158,8.23
2012-01-28,10,Saturday,Mid-Day,27,164,191,14.14
2012-01-28,11,Saturday,Mid-Day,55,241,296,18.58
2012-01-28,12,Saturday,Mid-Day,70,244,314,22.29
2012-01-28,13,Saturday,Mid-Day,80,293,373,21.45
2012-01-28,14,Saturday,Mid-Day,123,239,362,33.98
2012-01-28,15,Saturday,Mid-Day,90,320,410,21.95
2012-01-28,16,Saturday,Evening Rush,131,276,407,32.19
2012-01-28,17,Saturday,Evening Rush,57,233,290,19.66
2012-01-28,18,Saturday,Evening Rush,40,201,241,16.6
2012-01-28,19,Saturday,Evening Rush,33,173,206,16.02
2012-01-28,20,Saturday,Night,5,115,120,4.17
2012-01-28,21,Saturday,Night,18,109,127,14.17
2012-01-28,22,Saturday,Night,6,97,103,5.83
2012-01-28,23,Saturday,Night,6,79,85,7.06
2012-01-29,0,Sunday,Early Morning,15,81,96,15.63
2012-01-29,1,Sunday,Early Morning,5,68,73,6.85
2012-01-29,2,Sunday,Early Morning,3,48,51,5.88
2012-01-29,3,Sunday,Early Morning,4,17,21,19.05
2012-01-29,4,Sunday,Early Morning,0,5,5,0.0
2012-01-29,5,Sunday,Early Morning,1,6,7,14.29
2012-01-29,6,Sunday,Morning Rush,1,4,5,20.0
2012-01-29,7,Sunday,Morning Rush,0,12,12,0.0
2012-01-29,8,Sunday,Morning Rush,9,61,70,12.86
2012-01-29,9,Sunday,Morning Rush,13,98,111,11.71
2012-01-29,10,Sunday,Mid-Day,38,153,191,19.9
2012-01-29,11,Sunday,Mid-Day,57,198,255,22.35
2012-01-29,12,Sunday,Mid-Day,73,215,288,25.35
2012-01-29,13,Sunday,Mid-Day,78,238,316,24.68
2012-01-29,14,Sunday,Mid-Day,51,229,280,18.21
2012-01-29,15,Sunday,Mid-Day,68,242,310,21.94
2012-01-29,16,Sunday,Evening Rush,54,268,322,16.77
2012-01-29,17,Sunday,Evening Rush,33,201,234,14.1
2012-01-29,18,Sunday,Evening Rush,17,151,168,10.12
2012-01-29,19,Sunday,Evening Rush,14,145,159,8.81
2012-01-29,20,Sunday,Night,13,98,111,11.71
2012-01-29,21,Sunday,Night,0,69,69,0.0
2012-01-29,22,Sunday,Night,7,57,64,10.94
2012-01-29,23,Sunday,Night,4,21,25,16.0
2012-01-30,0,Monday,Early Morning,0,10,10,0.0
2012-01-30,1,Monday,Early Morning,0,9,9,0.0
2012-01-30,2,Monday,Early Morning,1,6,7,14.29
2012-01-30,3,Monday,Early Morning,0,4,4,0.0
2012-01-30,4,Monday,Early Morning,0,5,5,0.0
2012-01-30,5,Monday,Early Morning,0,26,26,0.0
2012-01-30,6,Monday,Morning Rush,0,80,80,0.0
2012-01-30,7,Monday,Morning Rush,4,221,225,1.78
2012-01-30,8,Monday,Morning Rush,12,481,493,2.43
2012-01-30,9,Monday,Morning Rush,5,193,198,2.53
2012-01-30,10,Monday,Mid-Day,3,82,85,3.53
2012-01-30,11,Monday,Mid-Day,6,93,99,6.06
2012-01-30,12,Monday,Mid-Day,5,129,134,3.73
2012-01-30,13,Monday,Mid-Day,15,117,132,11.36
2012-01-30,14,Monday,Mid-Day,15,100,115,13.04
2012-01-30,15,Monday,Mid-Day,7,131,138,5.07
2012-01-30,16,Monday,Evening Rush,11,210,221,4.98
2012-01-30,17,Monday,Evening Rush,16,422,438,3.65
2012-01-30,18,Monday,Evening Rush,11,399,410,2.68
2012-01-30,19,Monday,Evening Rush,8,298,306,2.61
2012-01-30,20,Monday,Night,2,179,181,1.1
2012-01-30,21,Monday,Night,3,159,162,1.85
2012-01-30,22,Monday,Night,2,92,94,2.13
2012-01-30,23,Monday,Night,0,52,52,0.0
2012-01-31,0,Tuesday,Early Morning,0,15,15,0.0
2012-01-31,1,Tuesday,Early Morning,1,7,8,12.5
2012-01-31,2,Tuesday,Early Morning,0,2,2,0.0
2012-01-31,3,Tuesday,Early Morning,0,2,2,0.0
2012-01-31,4,Tuesday,Early Morning,0,1,1,0.0
2012-01-31,5,Tuesday,Early Morning,0,22,22,0.0
2012-01-31,6,Tuesday,Morning Rush,0,104,104,0.0
2012-01-31,7,Tuesday,Morning Rush,6,273,279,2.15
2012-01-31,8,Tuesday,Morning Rush,14,498,512,2.73
2012-01-31,9,Tuesday,Morning Rush,30,231,261,11.49
2012-01-31,10,Tuesday,Mid-Day,34,110,144,23.61
2012-01-31,11,Tuesday,Mid-Day,14,125,139,10.07
2012-01-31,12,Tuesday,Mid-Day,13,181,194,6.7
2012-01-31,13,Tuesday,Mid-Day,27,171,198,13.64
2012-01-31,14,Tuesday,Mid-Day,18,142,160,11.25
2012-01-31,15,Tuesday,Mid-Day,27,150,177,15.25
2012-01-31,16,Tuesday,Evening Rush,30,277,307,9.77
2012-01-31,17,Tuesday,Evening Rush,41,518,559,7.33
2012-01-31,18,Tuesday,Evening Rush,16,486,502,3.19
2012-01-31,19,Tuesday,Evening Rush,22,306,328,6.71
2012-01-31,20,Tuesday,Night,15,223,238,6.3
2012-01-31,21,Tuesday,Night,3,162,165,1.82
2012-01-31,22,Tuesday,Night,11,118,129,8.53
2012-01-31,23,Tuesday,Night,2,61,63,3.17
2012-02-01,0,Wednesday,Early Morning,0,31,31,0.0
2012-02-01,1,Wednesday,Early Morning,0,4,4,0.0
2012-02-01,2,Wednesday,Early Morning,1,6,7,14.29
2012-02-01,3,Wednesday,Early Morning,0,3,3,0.0
2012-02-01,4,Wednesday,Early Morning,0,1,1,0.0
2012-02-01,5,Wednesday,Early Morning,0,18,18,0.0
2012-02-01,6,Wednesday,Morning Rush,0,67,67,0.0
2012-02-01,7,Wednesday,Morning Rush,7,201,208,3.37
2012-02-01,8,Wednesday,Morning Rush,15,505,520,2.88
2012-02-01,9,Wednesday,Morning Rush,9,267,276,3.26
2012-02-01,10,Wednesday,Mid-Day,9,124,133,6.77
2012-02-01,11,Wednesday,Mid-Day,27,116,143,18.88
2012-02-01,12,Wednesday,Mid-Day,26,153,179,14.53
2012-02-01,13,Wednesday,Mid-Day,12,174,186,6.45
2012-02-01,14,Wednesday,Mid-Day,33,159,192,17.19
2012-02-01,15,Wednesday,Mid-Day,25,169,194,12.89
2012-02-01,16,Wednesday,Evening Rush,22,261,283,7.77
2012-02-01,17,Wednesday,Evening Rush,31,508,539,5.75
2012-02-01,18,Wednesday,Evening Rush,12,514,526,2.28
2012-02-01,19,Wednesday,Evening Rush,20,315,335,5.97
2012-02-01,20,Wednesday,Night,10,254,264,3.79
2012-02-01,21,Wednesday,Night,16,217,233,6.87
2012-02-01,22,Wednesday,Night,7,133,140,5.0
2012-02-01,23,Wednesday,Night,22,75,97,22.68
2012-02-02,0,Thursday,Early Morning,7,24,31,22.58
2012-02-02,1,Thursday,Early Morning,3,14,17,17.65
2012-02-02,2,Thursday,Early Morning,2,7,9,22.22
2012-02-02,3,Thursday,Early Morning,0,2,2,0.0
2012-02-02,4,Thursday,Early Morning,0,1,1,0.0
2012-02-02,5,Thursday,Early Morning,0,19,19,0.0
2012-02-02,6,Thursday,Morning Rush,1,73,74,1.35
2012-02-02,7,Thursday,Morning Rush,4,201,205,1.95
2012-02-02,8,Thursday,Morning Rush,9,436,445,2.02
2012-02-02,9,Thursday,Morning Rush,15,213,228,6.58
2012-02-02,10,Thursday,Mid-Day,6,72,78,7.69
2012-02-02,11,Thursday,Mid-Day,6,99,105,5.71
2012-02-02,12,Thursday,Mid-Day,8,140,148,5.41
2012-02-02,13,Thursday,Mid-Day,13,124,137,9.49
2012-02-02,14,Thursday,Mid-Day,12,129,141,8.51
2012-02-02,15,Thursday,Mid-Day,24,150,174,13.79
2012-02-02,16,Thursday,Evening Rush,18,211,229,7.86
2012-02-02,17,Thursday,Evening Rush,13,437,450,2.89
2012-02-02,18,Thursday,Evening Rush,17,393,410,4.15
2012-02-02,19,Thursday,Evening Rush,16,311,327,4.89
2012-02-02,20,Thursday,Night,9,204,213,4.23
2012-02-02,21,Thursday,Night,4,144,148,2.7
2012-02-02,22,Thursday,Night,3,106,109,2.75
2012-02-02,23,Thursday,Night,0,61,61,0.0
2012-02-03,0,Friday,Early Morning,1,37,38,2.63
2012-02-03,1,Friday,Early Morning,3,19,22,13.64
2012-02-03,2,Friday,Early Morning,0,6,6,0.0
2012-02-03,3,Friday,Early Morning,0,4,4,0.0
2012-02-03,4,Friday,Early Morning,0,2,2,0.0
2012-02-03,5,Friday,Early Morning,0,17,17,0.0
2012-02-03,6,Friday,Morning Rush,0,88,88,0.0
2012-02-03,7,Friday,Morning Rush,10,216,226,4.42
2012-02-03,8,Friday,Morning Rush,12,429,441,2.72
2012-02-03,9,Friday,Morning Rush,18,252,270,6.67
2012-02-03,10,Friday,Mid-Day,15,114,129,11.63
2012-02-03,11,Friday,Mid-Day,15,149,164,9.15
2012-02-03,12,Friday,Mid-Day,25,191,216,11.57
2012-02-03,13,Friday,Mid-Day,25,173,198,12.63
2012-02-03,14,Friday,Mid-Day,22,148,170,12.94
2012-02-03,15,Friday,Mid-Day,48,168,216,22.22
2012-02-03,16,Friday,Evening Rush,36,275,311,11.58
2012-02-03,17,Friday,Evening Rush,30,458,488,6.15
2012-02-03,18,Friday,Evening Rush,17,368,385,4.42
2012-02-03,19,Friday,Evening Rush,11,256,267,4.12
2012-02-03,20,Friday,Night,8,155,163,4.91
2012-02-03,21,Friday,Night,8,126,134,5.97
2012-02-03,22,Friday,Night,3,116,119,2.52
2012-02-03,23,Friday,Night,3,74,77,3.9
2012-02-04,0,Saturday,Early Morning,10,76,86,11.63
2012-02-04,1,Saturday,Early Morning,0,43,43,0.0
2012-02-04,2,Saturday,Early Morning,6,38,44,13.64
2012-02-04,3,Saturday,Early Morning,1,17,18,5.56
2012-02-04,4,Saturday,Early Morning,1,5,6,16.67
2012-02-04,5,Saturday,Early Morning,1,3,4,25.0
2012-02-04,6,Saturday,Morning Rush,1,4,5,20.0
2012-02-04,7,Saturday,Morning Rush,1,27,28,3.57
2012-02-04,8,Saturday,Morning Rush,4,86,90,4.44
2012-02-04,9,Saturday,Morning Rush,16,141,157,10.19
2012-02-04,10,Saturday,Mid-Day,31,193,224,13.84
2012-02-04,11,Saturday,Mid-Day,46,224,270,17.04
2012-02-04,12,Saturday,Mid-Day,40,260,300,13.33
2012-02-04,13,Saturday,Mid-Day,58,244,302,19.21
2012-02-04,14,Saturday,Mid-Day,47,229,276,17.03
2012-02-04,15,Saturday,Mid-Day,61,244,305,20.0
2012-02-04,16,Saturday,Evening Rush,20,123,143,13.99
2012-02-04,17,Saturday,Evening Rush,13,54,67,19.4
2012-02-04,18,Saturday,Evening Rush,6,58,64,9.38
2012-02-04,19,Saturday,Evening Rush,5,75,80,6.25
2012-02-04,20,Saturday,Night,4,73,77,5.19
2012-02-04,21,Saturday,Night,4,74,78,5.13
2012-02-04,22,Saturday,Night,4,91,95,4.21
2012-02-04,23,Saturday,Night,4,66,70,5.71
2012-02-05,0,Sunday,Early Morning,3,58,61,4.92
2012-02-05,1,Sunday,Early Morning,5,46,51,9.8
2012-02-05,2,Sunday,Early Morning,4,59,63,6.35
2012-02-05,3,Sunday,Early Morning,4,13,17,23.53
2012-02-05,4,Sunday,Early Morning,0,9,9,0.0
2012-02-05,5,Sunday,Early Morning,0,4,4,0.0
2012-02-05,6,Sunday,Morning Rush,0,4,4,0.0
2012-02-05,7,Sunday,Morning Rush,0,16,16,0.0
2012-02-05,8,Sunday,Morning Rush,4,58,62,6.45
2012-02-05,9,Sunday,Morning Rush,9,83,92,9.78
2012-02-05,10,Sunday,Mid-Day,10,138,148,6.76
2012-02-05,11,Sunday,Mid-Day,22,160,182,12.09
2012-02-05,12,Sunday,Mid-Day,25,223,248,10.08
2012-02-05,13,Sunday,Mid-Day,33,241,274,12.04
2012-02-05,14,Sunday,Mid-Day,40,203,243,16.46
2012-02-05,15,Sunday,Mid-Day,55,217,272,20.22
2012-02-05,16,Sunday,Evening Rush,35,261,296,11.82
2012-02-05,17,Sunday,Evening Rush,31,275,306,10.13
2012-02-05,18,Sunday,Evening Rush,10,171,181,5.52
2012-02-05,19,Sunday,Evening Rush,6,63,69,8.7
2012-02-05,20,Sunday,Night,3,47,50,6.0
2012-02-05,21,Sunday,Night,6,60,66,9.09
2012-02-05,22,Sunday,Night,9,182,191,4.71
2012-02-05,23,Sunday,Night,4,38,42,9.52
2012-02-06,0,Monday,Early Morning,7,14,21,33.33
2012-02-06,1,Monday,Early Morning,0,6,6,0.0
2012-02-06,2,Monday,Early Morning,0,3,3,0.0
2012-02-06,4,Monday,Early Morning,0,2,2,0.0
2012-02-06,5,Monday,Early Morning,0,17,17,0.0
2012-02-06,6,Monday,Morning Rush,0,72,72,0.0
2012-02-06,7,Monday,Morning Rush,5,229,234,2.14
2012-02-06,8,Monday,Morning Rush,10,434,444,2.25
2012-02-06,9,Monday,Morning Rush,8,269,277,2.89
2012-02-06,10,Monday,Mid-Day,20,96,116,17.24
2012-02-06,11,Monday,Mid-Day,12,104,116,10.34
2012-02-06,12,Monday,Mid-Day,19,131,150,12.67
2012-02-06,13,Monday,Mid-Day,17,124,141,12.06
2012-02-06,14,Monday,Mid-Day,14,126,140,10.0
2012-02-06,15,Monday,Mid-Day,25,146,171,14.62
2012-02-06,16,Monday,Evening Rush,13,215,228,5.7
2012-02-06,17,Monday,Evening Rush,13,417,430,3.02
2012-02-06,18,Monday,Evening Rush,11,426,437,2.52
2012-02-06,19,Monday,Evening Rush,7,284,291,2.41
2012-02-06,20,Monday,Night,7,194,201,3.48
2012-02-06,21,Monday,Night,11,143,154,7.14
2012-02-06,22,Monday,Night,4,83,87,4.6
2012-02-06,23,Monday,Night,3,43,46,6.52
2012-02-07,0,Tuesday,Early Morning,1,22,23,4.35
2012-02-07,1,Tuesday,Early Morning,8,6,14,57.14
2012-02-07,2,Tuesday,Early Morning,0,4,4,0.0
2012-02-07,3,Tuesday,Early Morning,1,1,2,50.0
2012-02-07,4,Tuesday,Early Morning,0,3,3,0.0
2012-02-07,5,Tuesday,Early Morning,0,15,15,0.0
2012-02-07,6,Tuesday,Morning Rush,2,98,100,2.0
2012-02-07,7,Tuesday,Morning Rush,6,293,299,2.01
2012-02-07,8,Tuesday,Morning Rush,7,522,529,1.32
2012-02-07,9,Tuesday,Morning Rush,11,278,289,3.81
2012-02-07,10,Tuesday,Mid-Day,12,104,116,10.34
2012-02-07,11,Tuesday,Mid-Day,9,120,129,6.98
2012-02-07,12,Tuesday,Mid-Day,9,163,172,5.23
2012-02-07,13,Tuesday,Mid-Day,15,169,184,8.15
2012-02-07,14,Tuesday,Mid-Day,11,127,138,7.97
2012-02-07,15,Tuesday,Mid-Day,13,133,146,8.9
2012-02-07,16,Tuesday,Evening Rush,19,257,276,6.88
2012-02-07,17,Tuesday,Evening Rush,15,494,509,2.95
2012-02-07,18,Tuesday,Evening Rush,10,508,518,1.93
2012-02-07,19,Tuesday,Evening Rush,11,327,338,3.25
2012-02-07,20,Tuesday,Night,6,206,212,2.83
2012-02-07,21,Tuesday,Night,20,170,190,10.53
2012-02-07,22,Tuesday,Night,11,107,118,9.32
2012-02-07,23,Tuesday,Night,2,49,51,3.92
2012-02-08,0,Wednesday,Early Morning,2,21,23,8.7
2012-02-08,1,Wednesday,Early Morning,1,9,10,10.0
2012-02-08,2,Wednesday,Early Morning,0,1,1,0.0
2012-02-08,3,Wednesday,Early Morning,0,1,1,0.0
2012-02-08,4,Wednesday,Early Morning,0,1,1,0.0
2012-02-08,5,Wednesday,Early Morning,0,20,20,0.0
2012-02-08,6,Wednesday,Morning Rush,3,95,98,3.06
2012-02-08,7,Wednesday,Morning Rush,5,276,281,1.78
2012-02-08,8,Wednesday,Morning Rush,13,495,508,2.56
2012-02-08,9,Wednesday,Morning Rush,8,245,253,3.16
2012-02-08,10,Wednesday,Mid-Day,1,107,108,0.93
2012-02-08,11,Wednesday,Mid-Day,5,97,102,4.9
2012-02-08,12,Wednesday,Mid-Day,14,124,138,10.14
2012-02-08,13,Wednesday,Mid-Day,15,111,126,11.9
2012-02-08,14,Wednesday,Mid-Day,8,100,108,7.41
2012-02-08,15,Wednesday,Mid-Day,5,49,54,9.26
2012-02-08,16,Wednesday,Evening Rush,2,73,75,2.67
2012-02-08,17,Wednesday,Evening Rush,8,147,155,5.16
2012-02-08,18,Wednesday,Evening Rush,4,163,167,2.4
2012-02-08,19,Wednesday,Evening Rush,3,158,161,1.86
2012-02-08,20,Wednesday,Night,3,122,125,2.4
2012-02-08,21,Wednesday,Night,3,126,129,2.33
2012-02-08,22,Wednesday,Night,3,95,98,3.06
2012-02-08,23,Wednesday,Night,3,57,60,5.0
2012-02-09,0,Thursday,Early Morning,3,23,26,11.54
2012-02-09,1,Thursday,Early Morning,2,10,12,16.67
2012-02-09,2,Thursday,Early Morning,0,2,2,0.0
2012-02-09,3,Thursday,Early Morning,0,4,4,0.0
2012-02-09,4,Thursday,Early Morning,0,1,1,0.0
2012-02-09,5,Thursday,Early Morning,0,18,18,0.0
2012-02-09,6,Thursday,Morning Rush,1,75,76,1.32
2012-02-09,7,Thursday,Morning Rush,4,263,267,1.5
2012-02-09,8,Thursday,Morning Rush,11,473,484,2.27
2012-02-09,9,Thursday,Morning Rush,9,229,238,3.78
2012-02-09,10,Thursday,Mid-Day,7,90,97,7.22
2012-02-09,11,Thursday,Mid-Day,4,95,99,4.04
2012-02-09,12,Thursday,Mid-Day,10,148,158,6.33
2012-02-09,13,Thursday,Mid-Day,10,144,154,6.49
2012-02-09,14,Thursday,Mid-Day,18,126,144,12.5
2012-02-09,15,Thursday,Mid-Day,14,120,134,10.45
2012-02-09,16,Thursday,Evening Rush,15,223,238,6.3
2012-02-09,17,Thursday,Evening Rush,12,387,399,3.01
2012-02-09,18,Thursday,Evening Rush,13,404,417,3.12
2012-02-09,19,Thursday,Evening Rush,8,287,295,2.71
2012-02-09,20,Thursday,Night,2,197,199,1.01
2012-02-09,21,Thursday,Night,8,169,177,4.52
2012-02-09,22,Thursday,Night,3,104,107,2.8
2012-02-09,23,Thursday,Night,9,75,84,10.71
2012-02-10,0,Friday,Early Morning,4,39,43,9.3
2012-02-10,1,Friday,Early Morning,2,11,13,15.38
2012-02-10,2,Friday,Early Morning,7,9,16,43.75
2012-02-10,3,Friday,Early Morning,0,5,5,0.0
2012-02-10,4,Friday,Early Morning,0,2,2,0.0
2012-02-10,5,Friday,Early Morning,0,17,17,0.0
2012-02-10,6,Friday,Morning Rush,3,61,64,4.69
2012-02-10,7,Friday,Morning Rush,5,225,230,2.17
2012-02-10,8,Friday,Morning Rush,1,447,448,0.22
2012-02-10,9,Friday,Morning Rush,10,265,275,3.64
2012-02-10,10,Friday,Mid-Day,5,119,124,4.03
2012-02-10,11,Friday,Mid-Day,19,134,153,12.42
2012-02-10,12,Friday,Mid-Day,8,168,176,4.55
2012-02-10,13,Friday,Mid-Day,22,170,192,11.46
2012-02-10,14,Friday,Mid-Day,8,138,146,5.48
2012-02-10,15,Friday,Mid-Day,27,164,191,14.14
2012-02-10,16,Friday,Evening Rush,28,240,268,10.45
2012-02-10,17,Friday,Evening Rush,15,381,396,3.79
2012-02-10,18,Friday,Evening Rush,14,345,359,3.9
2012-02-10,19,Friday,Evening Rush,16,246,262,6.11
2012-02-10,20,Friday,Night,7,144,151,4.64
2012-02-10,21,Friday,Night,14,108,122,11.48
2012-02-10,22,Friday,Night,11,102,113,9.73
2012-02-10,23,Friday,Night,1,64,65,1.54
2012-02-11,0,Saturday,Early Morning,3,50,53,5.66
2012-02-11,1,Saturday,Early Morning,2,43,45,4.44
2012-02-11,2,Saturday,Early Morning,2,24,26,7.69
2012-02-11,3,Saturday,Early Morning,0,9,9,0.0
2012-02-11,4,Saturday,Early Morning,0,4,4,0.0
2012-02-11,5,Saturday,Early Morning,0,2,2,0.0
2012-02-11,6,Saturday,Morning Rush,1,8,9,11.11
2012-02-11,7,Saturday,Morning Rush,0,19,19,0.0
2012-02-11,8,Saturday,Morning Rush,1,77,78,1.28
2012-02-11,9,Saturday,Morning Rush,5,85,90,5.56
2012-02-11,10,Saturday,Mid-Day,23,143,166,13.86
2012-02-11,11,Saturday,Mid-Day,26,157,183,14.21
2012-02-11,12,Saturday,Mid-Day,25,196,221,11.31
2012-02-11,13,Saturday,Mid-Day,18,217,235,7.66
2012-02-11,14,Saturday,Mid-Day,38,205,243,15.64
2012-02-11,15,Saturday,Mid-Day,12,112,124,9.68
2012-02-11,16,Saturday,Evening Rush,12,134,146,8.22
2012-02-11,17,Saturday,Evening Rush,13,131,144,9.03
2012-02-11,18,Saturday,Evening Rush,3,105,108,2.78
2012-02-11,19,Saturday,Evening Rush,2,85,87,2.3
2012-02-11,20,Saturday,Night,1,62,63,1.59
2012-02-11,21,Saturday,Night,5,43,48,10.42
2012-02-11,22,Saturday,Night,0,46,46,0.0
2012-02-11,23,Saturday,Night,0,20,20,0.0
2012-02-12,0,Sunday,Early Morning,0,21,21,0.0
2012-02-12,1,Sunday,Early Morning,0,24,24,0.0
2012-02-12,2,Sunday,Early Morning,1,26,27,3.7
2012-02-12,3,Sunday,Early Morning,0,14,14,0.0
2012-02-12,4,Sunday,Early Morning,0,1,1,0.0
2012-02-12,5,Sunday,Early Morning,0,3,3,0.0
2012-02-12,6,Sunday,Morning Rush,0,2,2,0.0
2012-02-12,7,Sunday,Morning Rush,0,18,18,0.0
2012-02-12,8,Sunday,Morning Rush,0,26,26,0.0
2012-02-12,9,Sunday,Morning Rush,3,60,63,4.76
2012-02-12,10,Sunday,Mid-Day,8,83,91,8.79
2012-02-12,11,Sunday,Mid-Day,3,121,124,2.42
2012-02-12,12,Sunday,Mid-Day,7,133,140,5.0
2012-02-12,13,Sunday,Mid-Day,10,128,138,7.25
2012-02-12,14,Sunday,Mid-Day,9,102,111,8.11
2012-02-12,15,Sunday,Mid-Day,5,150,155,3.23
2012-02-12,16,Sunday,Evening Rush,16,148,164,9.76
2012-02-12,17,Sunday,Evening Rush,4,83,87,4.6
2012-02-12,18,Sunday,Evening Rush,4,92,96,4.17
2012-02-12,19,Sunday,Evening Rush,2,78,80,2.5
2012-02-12,20,Sunday,Night,1,56,57,1.75
2012-02-12,21,Sunday,Night,0,36,36,0.0
2012-02-12,22,Sunday,Night,0,28,28,0.0
2012-02-12,23,Sunday,Night,0,23,23,0.0
2012-02-13,0,Monday,Early Morning,0,9,9,0.0
2012-02-13,1,Monday,Early Morning,0,6,6,0.0
2012-02-13,2,Monday,Early Morning,0,4,4,0.0
2012-02-13,3,Monday,Early Morning,0,1,1,0.0
2012-02-13,4,Monday,Early Morning,0,2,2,0.0
2012-02-13,5,Monday,Early Morning,0,17,17,0.0
2012-02-13,6,Monday,Morning Rush,1,71,72,1.39
2012-02-13,7,Monday,Morning Rush,1,194,195,0.51
2012-02-13,8,Monday,Morning Rush,4,413,417,0.96
2012-02-13,9,Monday,Morning Rush,7,198,205,3.41
2012-02-13,10,Monday,Mid-Day,1,70,71,1.41
2012-02-13,11,Monday,Mid-Day,5,85,90,5.56
2012-02-13,12,Monday,Mid-Day,7,111,118,5.93
2012-02-13,13,Monday,Mid-Day,11,129,140,7.86
2012-02-13,14,Monday,Mid-Day,10,125,135,7.41
2012-02-13,15,Monday,Mid-Day,10,145,155,6.45
2012-02-13,16,Monday,Evening Rush,5,206,211,2.37
2012-02-13,17,Monday,Evening Rush,8,399,407,1.97
2012-02-13,18,Monday,Evening Rush,6,399,405,1.48
2012-02-13,19,Monday,Evening Rush,7,256,263,2.66
2012-02-13,20,Monday,Night,4,210,214,1.87
2012-02-13,21,Monday,Night,2,145,147,1.36
2012-02-13,22,Monday,Night,3,99,102,2.94
2012-02-13,23,Monday,Night,2,34,36,5.56
2012-02-14,0,Tuesday,Early Morning,0,14,14,0.0
2012-02-14,1,Tuesday,Early Morning,0,6,6,0.0
2012-02-14,2,Tuesday,Early Morning,0,3,3,0.0
2012-02-14,3,Tuesday,Early Morning,0,3,3,0.0
2012-02-14,4,Tuesday,Early Morning,0,2,2,0.0
2012-02-14,5,Tuesday,Early Morning,2,20,22,9.09
2012-02-14,6,Tuesday,Morning Rush,1,89,90,1.11
2012-02-14,7,Tuesday,Morning Rush,4,276,280,1.43
2012-02-14,8,Tuesday,Morning Rush,3,510,513,0.58
2012-02-14,9,Tuesday,Morning Rush,6,256,262,2.29
2012-02-14,10,Tuesday,Mid-Day,8,90,98,8.16
2012-02-14,11,Tuesday,Mid-Day,5,107,112,4.46
2012-02-14,12,Tuesday,Mid-Day,10,162,172,5.81
2012-02-14,13,Tuesday,Mid-Day,6,167,173,3.47
2012-02-14,14,Tuesday,Mid-Day,13,111,124,10.48
2012-02-14,15,Tuesday,Mid-Day,7,138,145,4.83
2012-02-14,16,Tuesday,Evening Rush,15,251,266,5.64
2012-02-14,17,Tuesday,Evening Rush,19,504,523,3.63
2012-02-14,18,Tuesday,Evening Rush,8,398,406,1.97
2012-02-14,19,Tuesday,Evening Rush,11,270,281,3.91
2012-02-14,20,Tuesday,Night,6,178,184,3.26
2012-02-14,21,Tuesday,Night,4,105,109,3.67
2012-02-14,22,Tuesday,Night,5,72,77,6.49
2012-02-14,23,Tuesday,Night,2,55,57,3.51
2012-02-15,0,Wednesday,Early Morning,0,22,22,0.0
2012-02-15,1,Wednesday,Early Morning,0,5,5,0.0
2012-02-15,2,Wednesday,Early Morning,0,4,4,0.0
2012-02-15,3,Wednesday,Early Morning,0,3,3,0.0
2012-02-15,4,Wednesday,Early Morning,0,1,1,0.0
2012-02-15,5,Wednesday,Early Morning,0,25,25,0.0
2012-02-15,6,Wednesday,Morning Rush,3,92,95,3.16
2012-02-15,7,Wednesday,Morning Rush,3,318,321,0.93
2012-02-15,8,Wednesday,Morning Rush,7,508,515,1.36
2012-02-15,9,Wednesday,Morning Rush,5,226,231,2.16
2012-02-15,10,Wednesday,Mid-Day,12,108,120,10.0
2012-02-15,11,Wednesday,Mid-Day,13,125,138,9.42
2012-02-15,12,Wednesday,Mid-Day,11,152,163,6.75
2012-02-15,13,Wednesday,Mid-Day,11,159,170,6.47
2012-02-15,14,Wednesday,Mid-Day,6,128,134,4.48
2012-02-15,15,Wednesday,Mid-Day,7,164,171,4.09
2012-02-15,16,Wednesday,Evening Rush,9,222,231,3.9
2012-02-15,17,Wednesday,Evening Rush,17,470,487,3.49
2012-02-15,18,Wednesday,Evening Rush,9,459,468,1.92
2012-02-15,19,Wednesday,Evening Rush,9,302,311,2.89
2012-02-15,20,Wednesday,Night,4,207,211,1.9
2012-02-15,21,Wednesday,Night,8,170,178,4.49
2012-02-15,22,Wednesday,Night,3,104,107,2.8
2012-02-15,23,Wednesday,Night,4,54,58,6.9
2012-02-16,0,Thursday,Early Morning,1,22,23,4.35
2012-02-16,1,Thursday,Early Morning,0,5,5,0.0
2012-02-16,2,Thursday,Early Morning,1,6,7,14.29
2012-02-16,3,Thursday,Early Morning,0,1,1,0.0
2012-02-16,4,Thursday,Early Morning,0,3,3,0.0
2012-02-16,5,Thursday,Early Morning,0,20,20,0.0
2012-02-16,6,Thursday,Morning Rush,4,83,87,4.6
2012-02-16,7,Thursday,Morning Rush,3,285,288,1.04
2012-02-16,8,Thursday,Morning Rush,9,489,498,1.81
2012-02-16,9,Thursday,Morning Rush,3,199,202,1.49
2012-02-16,10,Thursday,Mid-Day,2,42,44,4.55
2012-02-16,11,Thursday,Mid-Day,2,69,71,2.82
2012-02-16,12,Thursday,Mid-Day,1,44,45,2.22
2012-02-16,13,Thursday,Mid-Day,2,62,64,3.13
2012-02-16,14,Thursday,Mid-Day,1,30,31,3.23
2012-02-16,15,Thursday,Mid-Day,3,50,53,5.66
2012-02-16,16,Thursday,Evening Rush,8,110,118,6.78
2012-02-16,17,Thursday,Evening Rush,8,281,289,2.77
2012-02-16,18,Thursday,Evening Rush,8,345,353,2.27
2012-02-16,19,Thursday,Evening Rush,4,254,258,1.55
2012-02-16,20,Thursday,Night,5,211,216,2.31
2012-02-16,21,Thursday,Night,3,142,145,2.07
2012-02-16,22,Thursday,Night,3,108,111,2.7
2012-02-16,23,Thursday,Night,3,70,73,4.11
2012-02-17,0,Friday,Early Morning,2,32,34,5.88
2012-02-17,1,Friday,Early Morning,2,16,18,11.11
2012-02-17,2,Friday,Early Morning,1,11,12,8.33
2012-02-17,3,Friday,Early Morning,0,1,1,0.0
2012-02-17,4,Friday,Early Morning,0,1,1,0.0
2012-02-17,5,Friday,Early Morning,0,16,16,0.0
2012-02-17,6,Friday,Morning Rush,1,70,71,1.41
2012-02-17,7,Friday,Morning Rush,4,222,226,1.77
2012-02-17,8,Friday,Morning Rush,4,516,520,0.77
2012-02-17,9,Friday,Morning Rush,8,275,283,2.83
2012-02-17,10,Friday,Mid-Day,13,103,116,11.21
2012-02-17,11,Friday,Mid-Day,9,133,142,6.34
2012-02-17,12,Friday,Mid-Day,21,177,198,10.61
2012-02-17,13,Friday,Mid-Day,34,171,205,16.59
2012-02-17,14,Friday,Mid-Day,33,137,170,19.41
2012-02-17,15,Friday,Mid-Day,41,180,221,18.55
2012-02-17,16,Friday,Evening Rush,56,251,307,18.24
2012-02-17,17,Friday,Evening Rush,36,429,465,7.74
2012-02-17,18,Friday,Evening Rush,15,362,377,3.98
2012-02-17,19,Friday,Evening Rush,16,266,282,5.67
2012-02-17,20,Friday,Night,13,158,171,7.6
2012-02-17,21,Friday,Night,15,114,129,11.63
2012-02-17,22,Friday,Night,15,92,107,14.02
2012-02-17,23,Friday,Night,10,72,82,12.2
2012-02-18,0,Saturday,Early Morning,5,81,86,5.81
2012-02-18,1,Saturday,Early Morning,7,38,45,15.56
2012-02-18,2,Saturday,Early Morning,6,39,45,13.33
2012-02-18,3,Saturday,Early Morning,3,15,18,16.67
2012-02-18,4,Saturday,Early Morning,3,4,7,42.86
2012-02-18,5,Saturday,Early Morning,0,1,1,0.0
2012-02-18,6,Saturday,Morning Rush,1,8,9,11.11
2012-02-18,7,Saturday,Morning Rush,8,33,41,19.51
2012-02-18,8,Saturday,Morning Rush,10,92,102,9.8
2012-02-18,9,Saturday,Morning Rush,22,116,138,15.94
2012-02-18,10,Saturday,Mid-Day,48,157,205,23.41
2012-02-18,11,Saturday,Mid-Day,102,184,286,35.66
2012-02-18,12,Saturday,Mid-Day,128,241,369,34.69
2012-02-18,13,Saturday,Mid-Day,165,219,384,42.97
2012-02-18,14,Saturday,Mid-Day,183,244,427,42.86
2012-02-18,15,Saturday,Mid-Day,229,270,499,45.89
2012-02-18,16,Saturday,Evening Rush,186,218,404,46.04
2012-02-18,17,Saturday,Evening Rush,142,222,364,39.01
2012-02-18,18,Saturday,Evening Rush,70,176,246,28.46
2012-02-18,19,Saturday,Evening Rush,38,150,188,20.21
2012-02-18,20,Saturday,Night,25,123,148,16.89
2012-02-18,21,Saturday,Night,25,89,114,21.93
2012-02-18,22,Saturday,Night,17,101,118,14.41
2012-02-18,23,Saturday,Night,12,62,74,16.22
2012-02-19,0,Sunday,Early Morning,9,65,74,12.16
2012-02-19,1,Sunday,Early Morning,10,62,72,13.89
2012-02-19,2,Sunday,Early Morning,3,45,48,6.25
2012-02-19,3,Sunday,Early Morning,3,12,15,20.0
2012-02-19,4,Sunday,Early Morning,0,3,3,0.0
2012-02-19,5,Sunday,Early Morning,1,1,2,50.0
2012-02-19,6,Sunday,Morning Rush,0,5,5,0.0
2012-02-19,7,Sunday,Morning Rush,2,12,14,14.29
2012-02-19,8,Sunday,Morning Rush,8,48,56,14.29
2012-02-19,9,Sunday,Morning Rush,20,73,93,21.51
2012-02-19,10,Sunday,Mid-Day,49,142,191,25.65
2012-02-19,11,Sunday,Mid-Day,82,144,226,36.28
2012-02-19,12,Sunday,Mid-Day,71,184,255,27.84
2012-02-19,13,Sunday,Mid-Day,64,197,261,24.52
2012-02-19,14,Sunday,Mid-Day,48,189,237,20.25
2012-02-19,15,Sunday,Mid-Day,85,168,253,33.6
2012-02-19,16,Sunday,Evening Rush,62,150,212,29.25
2012-02-19,17,Sunday,Evening Rush,22,135,157,14.01
2012-02-19,18,Sunday,Evening Rush,23,144,167,13.77
2012-02-19,19,Sunday,Evening Rush,18,101,119,15.13
2012-02-19,20,Sunday,Night,22,81,103,21.36
2012-02-19,21,Sunday,Night,3,33,36,8.33
2012-02-19,22,Sunday,Night,8,47,55,14.55
2012-02-19,23,Sunday,Night,5,30,35,14.29
2012-02-20,0,Monday,Early Morning,5,36,41,12.2
2012-02-20,1,Monday,Early Morning,3,12,15,20.0
2012-02-20,2,Monday,Early Morning,1,19,20,5.0
2012-02-20,3,Monday,Early Morning,0,8,8,0.0
2012-02-20,5,Monday,Early Morning,0,6,6,0.0
2012-02-20,6,Monday,Morning Rush,1,9,10,10.0
2012-02-20,7,Monday,Morning Rush,2,42,44,4.55
2012-02-20,8,Monday,Morning Rush,9,111,120,7.5
2012-02-20,9,Monday,Morning Rush,12,98,110,10.91
2012-02-20,10,Monday,Mid-Day,30,113,143,20.98
2012-02-20,11,Monday,Mid-Day,45,163,208,21.63
2012-02-20,12,Monday,Mid-Day,65,216,281,23.13
2012-02-20,13,Monday,Mid-Day,66,246,312,21.15
2012-02-20,14,Monday,Mid-Day,57,206,263,21.67
2012-02-20,15,Monday,Mid-Day,54,235,289,18.69
2012-02-20,16,Monday,Evening Rush,64,216,280,22.86
2012-02-20,17,Monday,Evening Rush,27,226,253,10.67
2012-02-20,18,Monday,Evening Rush,27,215,242,11.16
2012-02-20,19,Monday,Evening Rush,8,164,172,4.65
2012-02-20,20,Monday,Night,9,117,126,7.14
2012-02-20,21,Monday,Night,8,90,98,8.16
2012-02-20,22,Monday,Night,9,53,62,14.52
2012-02-20,23,Monday,Night,0,26,26,0.0
2012-02-21,0,Tuesday,Early Morning,1,11,12,8.33
2012-02-21,1,Tuesday,Early Morning,0,7,7,0.0
2012-02-21,2,Tuesday,Early Morning,0,3,3,0.0
2012-02-21,4,Tuesday,Early Morning,0,2,2,0.0
2012-02-21,5,Tuesday,Early Morning,0,15,15,0.0
2012-02-21,6,Tuesday,Morning Rush,3,83,86,3.49
2012-02-21,7,Tuesday,Morning Rush,6,273,279,2.15
2012-02-21,8,Tuesday,Morning Rush,5,459,464,1.08
2012-02-21,9,Tuesday,Morning Rush,6,211,217,2.76
2012-02-21,10,Tuesday,Mid-Day,8,77,85,9.41
2012-02-21,11,Tuesday,Mid-Day,5,81,86,5.81
2012-02-21,12,Tuesday,Mid-Day,16,147,163,9.82
2012-02-21,13,Tuesday,Mid-Day,8,123,131,6.11
2012-02-21,14,Tuesday,Mid-Day,16,108,124,12.9
2012-02-21,15,Tuesday,Mid-Day,23,137,160,14.37
2012-02-21,16,Tuesday,Evening Rush,14,240,254,5.51
2012-02-21,17,Tuesday,Evening Rush,21,411,432,4.86
2012-02-21,18,Tuesday,Evening Rush,11,414,425,2.59
2012-02-21,19,Tuesday,Evening Rush,5,299,304,1.64
2012-02-21,20,Tuesday,Night,4,223,227,1.76
2012-02-21,21,Tuesday,Night,7,147,154,4.55
2012-02-21,22,Tuesday,Night,3,97,100,3.0
2012-02-21,23,Tuesday,Night,1,46,47,2.13
2012-02-22,0,Wednesday,Early Morning,5,19,24,20.83
2012-02-22,1,Wednesday,Early Morning,3,4,7,42.86
2012-02-22,2,Wednesday,Early Morning,1,5,6,16.67
2012-02-22,3,Wednesday,Early Morning,1,3,4,25.0
2012-02-22,4,Wednesday,Early Morning,0,2,2,0.0
2012-02-22,5,Wednesday,Early Morning,1,29,30,3.33
2012-02-22,6,Wednesday,Morning Rush,5,85,90,5.56
2012-02-22,7,Wednesday,Morning Rush,10,292,302,3.31
2012-02-22,8,Wednesday,Morning Rush,9,567,576,1.56
2012-02-22,9,Wednesday,Morning Rush,11,241,252,4.37
2012-02-22,10,Wednesday,Mid-Day,17,122,139,12.23
2012-02-22,11,Wednesday,Mid-Day,22,149,171,12.87
2012-02-22,12,Wednesday,Mid-Day,21,186,207,10.14
2012-02-22,13,Wednesday,Mid-Day,15,175,190,7.89
2012-02-22,14,Wednesday,Mid-Day,35,142,177,19.77
2012-02-22,15,Wednesday,Mid-Day,34,161,195,17.44
2012-02-22,16,Wednesday,Evening Rush,30,268,298,10.07
2012-02-22,17,Wednesday,Evening Rush,43,486,529,8.13
2012-02-22,18,Wednesday,Evening Rush,42,483,525,8.0
2012-02-22,19,Wednesday,Evening Rush,22,305,327,6.73
2012-02-22,20,Wednesday,Night,25,249,274,9.12
2012-02-22,21,Wednesday,Night,19,220,239,7.95
2012-02-22,22,Wednesday,Night,18,129,147,12.24
2012-02-22,23,Wednesday,Night,5,57,62,8.06
2012-02-23,0,Thursday,Early Morning,12,30,42,28.57
2012-02-23,1,Thursday,Early Morning,3,12,15,20.0
2012-02-23,2,Thursday,Early Morning,5,4,9,55.56
2012-02-23,3,Thursday,Early Morning,2,4,6,33.33
2012-02-23,4,Thursday,Early Morning,0,1,1,0.0
2012-02-23,5,Thursday,Early Morning,2,30,32,6.25
2012-02-23,6,Thursday,Morning Rush,3,88,91,3.3
2012-02-23,7,Thursday,Morning Rush,9,317,326,2.76
2012-02-23,8,Thursday,Morning Rush,11,549,560,1.96
2012-02-23,9,Thursday,Morning Rush,14,228,242,5.79
2012-02-23,10,Thursday,Mid-Day,41,107,148,27.7
2012-02-23,11,Thursday,Mid-Day,54,128,182,29.67
2012-02-23,12,Thursday,Mid-Day,25,199,224,11.16
2012-02-23,13,Thursday,Mid-Day,30,188,218,13.76
2012-02-23,14,Thursday,Mid-Day,36,156,192,18.75
2012-02-23,15,Thursday,Mid-Day,46,171,217,21.2
2012-02-23,16,Thursday,Evening Rush,45,298,343,13.12
2012-02-23,17,Thursday,Evening Rush,49,561,610,8.03
2012-02-23,18,Thursday,Evening Rush,36,486,522,6.9
2012-02-23,19,Thursday,Evening Rush,20,349,369,5.42
2012-02-23,20,Thursday,Night,23,246,269,8.55
2012-02-23,21,Thursday,Night,17,205,222,7.66
2012-02-23,22,Thursday,Night,19,118,137,13.87
2012-02-23,23,Thursday,Night,14,71,85,16.47
2012-02-24,0,Friday,Early Morning,12,34,46,26.09
2012-02-24,1,Friday,Early Morning,3,15,18,16.67
2012-02-24,2,Friday,Early Morning,1,4,5,20.0
2012-02-24,3,Friday,Early Morning,0,5,5,0.0
2012-02-24,4,Friday,Early Morning,0,2,2,0.0
2012-02-24,5,Friday,Early Morning,1,25,26,3.85
2012-02-24,6,Friday,Morning Rush,2,80,82,2.44
2012-02-24,7,Friday,Morning Rush,7,265,272,2.57
2012-02-24,8,Friday,Morning Rush,17,452,469,3.62
2012-02-24,9,Friday,Morning Rush,15,229,244,6.15
2012-02-24,10,Friday,Mid-Day,22,119,141,15.6
2012-02-24,11,Friday,Mid-Day,27,136,163,16.56
2012-02-24,12,Friday,Mid-Day,27,201,228,11.84
2012-02-24,13,Friday,Mid-Day,30,153,183,16.39
2012-02-24,14,Friday,Mid-Day,5,26,31,16.13
2012-02-24,15,Friday,Mid-Day,11,83,94,11.7
2012-02-24,16,Friday,Evening Rush,12,166,178,6.74
2012-02-24,17,Friday,Evening Rush,14,242,256,5.47
2012-02-24,18,Friday,Evening Rush,11,289,300,3.67
2012-02-24,19,Friday,Evening Rush,6,227,233,2.58
2012-02-24,20,Friday,Night,8,159,167,4.79
2012-02-24,21,Friday,Night,1,151,152,0.66
2012-02-24,22,Friday,Night,4,102,106,3.77
2012-02-24,23,Friday,Night,10,76,86,11.63
2012-02-25,0,Saturday,Early Morning,5,56,61,8.2
2012-02-25,1,Saturday,Early Morning,4,42,46,8.7
2012-02-25,2,Saturday,Early Morning,1,37,38,2.63
2012-02-25,3,Saturday,Early Morning,0,7,7,0.0
2012-02-25,4,Saturday,Early Morning,0,2,2,0.0
2012-02-25,5,Saturday,Early Morning,0,3,3,0.0
2012-02-25,6,Saturday,Morning Rush,1,12,13,7.69
2012-02-25,7,Saturday,Morning Rush,3,20,23,13.04
2012-02-25,8,Saturday,Morning Rush,3,90,93,3.23
2012-02-25,9,Saturday,Morning Rush,15,107,122,12.3
2012-02-25,10,Saturday,Mid-Day,24,159,183,13.11
2012-02-25,11,Saturday,Mid-Day,23,187,210,10.95
2012-02-25,12,Saturday,Mid-Day,41,217,258,15.89
2012-02-25,13,Saturday,Mid-Day,48,178,226,21.24
2012-02-25,14,Saturday,Mid-Day,35,181,216,16.2
2012-02-25,15,Saturday,Mid-Day,21,211,232,9.05
2012-02-25,16,Saturday,Evening Rush,32,163,195,16.41
2012-02-25,17,Saturday,Evening Rush,16,143,159,10.06
2012-02-25,18,Saturday,Evening Rush,7,126,133,5.26
2012-02-25,19,Saturday,Evening Rush,12,137,149,8.05
2012-02-25,20,Saturday,Night,10,95,105,9.52
2012-02-25,21,Saturday,Night,5,80,85,5.88
2012-02-25,22,Saturday,Night,4,78,82,4.88
2012-02-25,23,Saturday,Night,7,84,91,7.69
2012-02-26,0,Sunday,Early Morning,7,63,70,10.0
2012-02-26,1,Sunday,Early Morning,5,50,55,9.09
2012-02-26,2,Sunday,Early Morning,5,37,42,11.9
2012-02-26,3,Sunday,Early Morning,0,21,21,0.0
2012-02-26,4,Sunday,Early Morning,1,5,6,16.67
2012-02-26,5,Sunday,Early Morning,0,5,5,0.0
2012-02-26,6,Sunday,Morning Rush,0,2,2,0.0
2012-02-26,7,Sunday,Morning Rush,2,20,22,9.09
2012-02-26,8,Sunday,Morning Rush,2,57,59,3.39
2012-02-26,9,Sunday,Morning Rush,11,76,87,12.64
2012-02-26,10,Sunday,Mid-Day,27,161,188,14.36
2012-02-26,11,Sunday,Mid-Day,43,184,227,18.94
2012-02-26,12,Sunday,Mid-Day,49,256,305,16.07
2012-02-26,13,Sunday,Mid-Day,58,267,325,17.85
2012-02-26,14,Sunday,Mid-Day,68,263,331,20.54
2012-02-26,15,Sunday,Mid-Day,72,281,353,20.4
2012-02-26,16,Sunday,Evening Rush,64,275,339,18.88
2012-02-26,17,Sunday,Evening Rush,46,241,287,16.03
2012-02-26,18,Sunday,Evening Rush,17,199,216,7.87
2012-02-26,19,Sunday,Evening Rush,13,130,143,9.09
2012-02-26,20,Sunday,Night,9,79,88,10.23
2012-02-26,21,Sunday,Night,8,75,83,9.64
2012-02-26,22,Sunday,Night,3,68,71,4.23
2012-02-26,23,Sunday,Night,5,59,64,7.81
2012-02-27,0,Monday,Early Morning,2,27,29,6.9
2012-02-27,1,Monday,Early Morning,0,6,6,0.0
2012-02-27,2,Monday,Early Morning,0,4,4,0.0
2012-02-27,3,Monday,Early Morning,0,2,2,0.0
2012-02-27,4,Monday,Early Morning,0,1,1,0.0
2012-02-27,5,Monday,Early Morning,0,16,16,0.0
2012-02-27,6,Monday,Morning Rush,1,89,90,1.11
2012-02-27,7,Monday,Morning Rush,2,278,280,0.71
2012-02-27,8,Monday,Morning Rush,14,514,528,2.65
2012-02-27,9,Monday,Morning Rush,11,219,230,4.78
2012-02-27,10,Monday,Mid-Day,16,88,104,15.38
2012-02-27,11,Monday,Mid-Day,11,92,103,10.68
2012-02-27,12,Monday,Mid-Day,13,164,177,7.34
2012-02-27,13,Monday,Mid-Day,23,159,182,12.64
2012-02-27,14,Monday,Mid-Day,24,134,158,15.19
2012-02-27,15,Monday,Mid-Day,24,150,174,13.79
2012-02-27,16,Monday,Evening Rush,20,266,286,6.99
2012-02-27,17,Monday,Evening Rush,26,503,529,4.91
2012-02-27,18,Monday,Evening Rush,10,517,527,1.9
2012-02-27,19,Monday,Evening Rush,16,318,334,4.79
2012-02-27,20,Monday,Night,11,208,219,5.02
2012-02-27,21,Monday,Night,14,181,195,7.18
2012-02-27,22,Monday,Night,9,83,92,9.78
2012-02-27,23,Monday,Night,6,50,56,10.71
2012-02-28,0,Tuesday,Early Morning,0,10,10,0.0
2012-02-28,1,Tuesday,Early Morning,0,6,6,0.0
2012-02-28,2,Tuesday,Early Morning,1,2,3,33.33
2012-02-28,3,Tuesday,Early Morning,0,6,6,0.0
2012-02-28,4,Tuesday,Early Morning,0,2,2,0.0
2012-02-28,5,Tuesday,Early Morning,1,20,21,4.76
2012-02-28,6,Tuesday,Morning Rush,1,100,101,0.99
2012-02-28,7,Tuesday,Morning Rush,12,313,325,3.69
2012-02-28,8,Tuesday,Morning Rush,16,543,559,2.86
2012-02-28,9,Tuesday,Morning Rush,7,225,232,3.02
2012-02-28,10,Tuesday,Mid-Day,14,118,132,10.61
2012-02-28,11,Tuesday,Mid-Day,8,155,163,4.91
2012-02-28,12,Tuesday,Mid-Day,19,164,183,10.38
2012-02-28,13,Tuesday,Mid-Day,16,174,190,8.42
2012-02-28,14,Tuesday,Mid-Day,13,121,134,9.7
2012-02-28,15,Tuesday,Mid-Day,17,149,166,10.24
2012-02-28,16,Tuesday,Evening Rush,17,270,287,5.92
2012-02-28,17,Tuesday,Evening Rush,33,497,530,6.23
2012-02-28,18,Tuesday,Evening Rush,17,432,449,3.79
2012-02-28,19,Tuesday,Evening Rush,15,291,306,4.9
2012-02-28,20,Tuesday,Night,2,202,204,0.98
2012-02-28,21,Tuesday,Night,10,178,188,5.32
2012-02-28,22,Tuesday,Night,6,95,101,5.94
2012-02-28,23,Tuesday,Night,4,61,65,6.15
2012-02-29,0,Wednesday,Early Morning,2,30,32,6.25
2012-02-29,1,Wednesday,Early Morning,0,6,6,0.0
2012-02-29,2,Wednesday,Early Morning,0,4,4,0.0
2012-02-29,3,Wednesday,Early Morning,0,2,2,0.0
2012-02-29,5,Wednesday,Early Morning,0,29,29,0.0
2012-02-29,6,Wednesday,Morning Rush,4,100,104,3.85
2012-02-29,7,Wednesday,Morning Rush,11,242,253,4.35
2012-02-29,8,Wednesday,Morning Rush,2,114,116,1.72
2012-02-29,9,Wednesday,Morning Rush,5,33,38,13.16
2012-02-29,10,Wednesday,Mid-Day,0,10,10,0.0
2012-02-29,11,Wednesday,Mid-Day,1,9,10,10.0
2012-02-29,12,Wednesday,Mid-Day,1,69,70,1.43
2012-02-29,13,Wednesday,Mid-Day,4,72,76,5.26
2012-02-29,14,Wednesday,Mid-Day,2,54,56,3.57
2012-02-29,15,Wednesday,Mid-Day,3,87,90,3.33
2012-02-29,16,Wednesday,Evening Rush,5,162,167,2.99
2012-02-29,17,Wednesday,Evening Rush,7,246,253,2.77
2012-02-29,18,Wednesday,Evening Rush,11,181,192,5.73
2012-02-29,19,Wednesday,Evening Rush,0,102,102,0.0
2012-02-29,20,Wednesday,Night,2,95,97,2.06
2012-02-29,21,Wednesday,Night,0,39,39,0.0
2012-02-29,22,Wednesday,Night,2,53,55,3.64
2012-02-29,23,Wednesday,Night,3,30,33,9.09
2012-03-01,0,Thursday,Early Morning,1,10,11,9.09
2012-03-01,1,Thursday,Early Morning,0,12,12,0.0
2012-03-01,2,Thursday,Early Morning,0,6,6,0.0
2012-03-01,3,Thursday,Early Morning,0,3,3,0.0
2012-03-01,4,Thursday,Early Morning,0,5,5,0.0
2012-03-01,5,Thursday,Early Morning,0,18,18,0.0
2012-03-01,6,Thursday,Morning Rush,2,107,109,1.83
2012-03-01,7,Thursday,Morning Rush,8,296,304,2.63
2012-03-01,8,Thursday,Morning Rush,15,579,594,2.53
2012-03-01,9,Thursday,Morning Rush,5,281,286,1.75
2012-03-01,10,Thursday,Mid-Day,11,122,133,8.27
2012-03-01,11,Thursday,Mid-Day,19,149,168,11.31
2012-03-01,12,Thursday,Mid-Day,16,204,220,7.27
2012-03-01,13,Thursday,Mid-Day,24,187,211,11.37
2012-03-01,14,Thursday,Mid-Day,37,174,211,17.54
2012-03-01,15,Thursday,Mid-Day,31,192,223,13.9
2012-03-01,16,Thursday,Evening Rush,38,323,361,10.53
2012-03-01,17,Thursday,Evening Rush,49,551,600,8.17
2012-03-01,18,Thursday,Evening Rush,27,498,525,5.14
2012-03-01,19,Thursday,Evening Rush,11,317,328,3.35
2012-03-01,20,Thursday,Night,12,242,254,4.72
2012-03-01,21,Thursday,Night,7,190,197,3.55
2012-03-01,22,Thursday,Night,3,123,126,2.38
2012-03-01,23,Thursday,Night,9,76,85,10.59
2012-03-02,0,Friday,Early Morning,1,45,46,2.17
2012-03-02,1,Friday,Early Morning,2,18,20,10.0
2012-03-02,2,Friday,Early Morning,2,4,6,33.33
2012-03-02,3,Friday,Early Morning,0,3,3,0.0
2012-03-02,4,Friday,Early Morning,0,2,2,0.0
2012-03-02,5,Friday,Early Morning,0,24,24,0.0
2012-03-02,6,Friday,Morning Rush,4,88,92,4.35
2012-03-02,7,Friday,Morning Rush,4,258,262,1.53
2012-03-02,8,Friday,Morning Rush,16,533,549,2.91
2012-03-02,9,Friday,Morning Rush,15,299,314,4.78
2012-03-02,10,Friday,Mid-Day,14,118,132,10.61
2012-03-02,11,Friday,Mid-Day,40,154,194,20.62
2012-03-02,12,Friday,Mid-Day,40,194,234,17.09
2012-03-02,13,Friday,Mid-Day,31,191,222,13.96
2012-03-02,14,Friday,Mid-Day,29,176,205,14.15
2012-03-02,15,Friday,Mid-Day,5,73,78,6.41
2012-03-02,16,Friday,Evening Rush,1,49,50,2.0
2012-03-02,17,Friday,Evening Rush,5,123,128,3.91
2012-03-02,18,Friday,Evening Rush,6,154,160,3.75
2012-03-02,19,Friday,Evening Rush,12,162,174,6.9
2012-03-02,20,Friday,Night,7,93,100,7.0
2012-03-02,21,Friday,Night,2,99,101,1.98
2012-03-02,22,Friday,Night,6,69,75,8.0
2012-03-02,23,Friday,Night,4,19,23,17.39
2012-03-03,0,Saturday,Early Morning,1,21,22,4.55
2012-03-03,1,Saturday,Early Morning,0,44,44,0.0
2012-03-03,2,Saturday,Early Morning,4,34,38,10.53
2012-03-03,3,Saturday,Early Morning,1,20,21,4.76
2012-03-03,4,Saturday,Early Morning,0,2,2,0.0
2012-03-03,5,Saturday,Early Morning,1,1,2,50.0
2012-03-03,6,Saturday,Morning Rush,1,6,7,14.29
2012-03-03,7,Saturday,Morning Rush,2,14,16,12.5
2012-03-03,8,Saturday,Morning Rush,2,46,48,4.17
2012-03-03,9,Saturday,Morning Rush,7,87,94,7.45
2012-03-03,10,Saturday,Mid-Day,31,137,168,18.45
2012-03-03,11,Saturday,Mid-Day,33,181,214,15.42
2012-03-03,12,Saturday,Mid-Day,47,252,299,15.72
2012-03-03,13,Saturday,Mid-Day,87,252,339,25.66
2012-03-03,14,Saturday,Mid-Day,151,279,430,35.12
2012-03-03,15,Saturday,Mid-Day,145,254,399,36.34
2012-03-03,16,Saturday,Evening Rush,167,300,467,35.76
2012-03-03,17,Saturday,Evening Rush,106,279,385,27.53
2012-03-03,18,Saturday,Evening Rush,53,250,303,17.49
2012-03-03,19,Saturday,Evening Rush,34,191,225,15.11
2012-03-03,20,Saturday,Night,28,121,149,18.79
2012-03-03,21,Saturday,Night,24,130,154,15.58
2012-03-03,22,Saturday,Night,19,115,134,14.18
2012-03-03,23,Saturday,Night,12,94,106,11.32
2012-03-04,0,Sunday,Early Morning,5,67,72,6.94
2012-03-04,1,Sunday,Early Morning,16,60,76,21.05
2012-03-04,2,Sunday,Early Morning,14,66,80,17.5
2012-03-04,3,Sunday,Early Morning,5,21,26,19.23
2012-03-04,4,Sunday,Early Morning,3,11,14,21.43
2012-03-04,5,Sunday,Early Morning,0,5,5,0.0
2012-03-04,6,Sunday,Morning Rush,0,5,5,0.0
2012-03-04,7,Sunday,Morning Rush,2,21,23,8.7
2012-03-04,8,Sunday,Morning Rush,12,54,66,18.18
2012-03-04,9,Sunday,Morning Rush,14,104,118,11.86
2012-03-04,10,Sunday,Mid-Day,31,161,192,16.15
2012-03-04,11,Sunday,Mid-Day,64,192,256,25.0
2012-03-04,12,Sunday,Mid-Day,71,256,327,21.71
2012-03-04,13,Sunday,Mid-Day,108,256,364,29.67
2012-03-04,14,Sunday,Mid-Day,106,226,332,31.93
2012-03-04,15,Sunday,Mid-Day,82,252,334,24.55
2012-03-04,16,Sunday,Evening Rush,68,231,299,22.74
2012-03-04,17,Sunday,Evening Rush,49,214,263,18.63
2012-03-04,18,Sunday,Evening Rush,20,164,184,10.87
2012-03-04,19,Sunday,Evening Rush,12,120,132,9.09
2012-03-04,20,Sunday,Night,8,80,88,9.09
2012-03-04,21,Sunday,Night,9,70,79,11.39
2012-03-04,22,Sunday,Night,9,53,62,14.52
2012-03-04,23,Sunday,Night,2,24,26,7.69
2012-03-05,0,Monday,Early Morning,2,15,17,11.76
2012-03-05,1,Monday,Early Morning,3,3,6,50.0
2012-03-05,2,Monday,Early Morning,1,3,4,25.0
2012-03-05,3,Monday,Early Morning,0,1,1,0.0
2012-03-05,4,Monday,Early Morning,0,1,1,0.0
2012-03-05,5,Monday,Early Morning,1,17,18,5.56
2012-03-05,6,Monday,Morning Rush,2,89,91,2.2
2012-03-05,7,Monday,Morning Rush,7,253,260,2.69
2012-03-05,8,Monday,Morning Rush,13,415,428,3.04
2012-03-05,9,Monday,Morning Rush,11,186,197,5.58
2012-03-05,10,Monday,Mid-Day,12,74,86,13.95
2012-03-05,11,Monday,Mid-Day,17,86,103,16.5
2012-03-05,12,Monday,Mid-Day,15,122,137,10.95
2012-03-05,13,Monday,Mid-Day,11,109,120,9.17
2012-03-05,14,Monday,Mid-Day,13,115,128,10.16
2012-03-05,15,Monday,Mid-Day,20,110,130,15.38
2012-03-05,16,Monday,Evening Rush,30,180,210,14.29
2012-03-05,17,Monday,Evening Rush,11,376,387,2.84
2012-03-05,18,Monday,Evening Rush,12,363,375,3.2
2012-03-05,19,Monday,Evening Rush,6,220,226,2.65
2012-03-05,20,Monday,Night,8,171,179,4.47
2012-03-05,21,Monday,Night,4,116,120,3.33
2012-03-05,22,Monday,Night,2,76,78,2.56
2012-03-05,23,Monday,Night,2,29,31,6.45
2012-03-06,0,Tuesday,Early Morning,0,8,8,0.0
2012-03-06,1,Tuesday,Early Morning,0,6,6,0.0
2012-03-06,2,Tuesday,Early Morning,0,4,4,0.0
2012-03-06,3,Tuesday,Early Morning,0,1,1,0.0
2012-03-06,4,Tuesday,Early Morning,0,3,3,0.0
2012-03-06,5,Tuesday,Early Morning,0,25,25,0.0
2012-03-06,6,Tuesday,Morning Rush,3,99,102,2.94
2012-03-06,7,Tuesday,Morning Rush,5,270,275,1.82
2012-03-06,8,Tuesday,Morning Rush,14,487,501,2.79
2012-03-06,9,Tuesday,Morning Rush,11,222,233,4.72
2012-03-06,10,Tuesday,Mid-Day,16,113,129,12.4
2012-03-06,11,Tuesday,Mid-Day,20,110,130,15.38
2012-03-06,12,Tuesday,Mid-Day,9,129,138,6.52
2012-03-06,13,Tuesday,Mid-Day,16,148,164,9.76
2012-03-06,14,Tuesday,Mid-Day,20,116,136,14.71
2012-03-06,15,Tuesday,Mid-Day,24,142,166,14.46
2012-03-06,16,Tuesday,Evening Rush,22,228,250,8.8
2012-03-06,17,Tuesday,Evening Rush,21,425,446,4.71
2012-03-06,18,Tuesday,Evening Rush,15,442,457,3.28
2012-03-06,19,Tuesday,Evening Rush,9,278,287,3.14
2012-03-06,20,Tuesday,Night,3,184,187,1.6
2012-03-06,21,Tuesday,Night,5,143,148,3.38
2012-03-06,22,Tuesday,Night,5,101,106,4.72
2012-03-06,23,Tuesday,Night,3,51,54,5.56
2012-03-07,0,Wednesday,Early Morning,3,12,15,20.0
2012-03-07,1,Wednesday,Early Morning,1,4,5,20.0
2012-03-07,2,Wednesday,Early Morning,0,4,4,0.0
2012-03-07,3,Wednesday,Early Morning,1,2,3,33.33
2012-03-07,4,Wednesday,Early Morning,0,3,3,0.0
2012-03-07,5,Wednesday,Early Morning,0,18,18,0.0
2012-03-07,6,Wednesday,Morning Rush,4,104,108,3.7
2012-03-07,7,Wednesday,Morning Rush,12,332,344,3.49
2012-03-07,8,Wednesday,Morning Rush,12,554,566,2.12
2012-03-07,9,Wednesday,Morning Rush,12,252,264,4.55
2012-03-07,10,Wednesday,Mid-Day,20,127,147,13.61
2012-03-07,11,Wednesday,Mid-Day,33,128,161,20.5
2012-03-07,12,Wednesday,Mid-Day,40,175,215,18.6
2012-03-07,13,Wednesday,Mid-Day,26,179,205,12.68
2012-03-07,14,Wednesday,Mid-Day,38,137,175,21.71
2012-03-07,15,Wednesday,Mid-Day,44,165,209,21.05
2012-03-07,16,Wednesday,Evening Rush,34,254,288,11.81
2012-03-07,17,Wednesday,Evening Rush,58,554,612,9.48
2012-03-07,18,Wednesday,Evening Rush,35,509,544,6.43
2012-03-07,19,Wednesday,Evening Rush,16,345,361,4.43
2012-03-07,20,Wednesday,Night,18,242,260,6.92
2012-03-07,21,Wednesday,Night,11,177,188,5.85
2012-03-07,22,Wednesday,Night,10,149,159,6.29
2012-03-07,23,Wednesday,Night,4,58,62,6.45
2012-03-08,0,Thursday,Early Morning,11,35,46,23.91
2012-03-08,1,Thursday,Early Morning,4,17,21,19.05
2012-03-08,2,Thursday,Early Morning,6,5,11,54.55
2012-03-08,3,Thursday,Early Morning,0,3,3,0.0
2012-03-08,4,Thursday,Early Morning,0,2,2,0.0
2012-03-08,5,Thursday,Early Morning,1,28,29,3.45
2012-03-08,6,Thursday,Morning Rush,4,105,109,3.67
2012-03-08,7,Thursday,Morning Rush,8,326,334,2.4
2012-03-08,8,Thursday,Morning Rush,12,573,585,2.05
2012-03-08,9,Thursday,Morning Rush,19,282,301,6.31
2012-03-08,10,Thursday,Mid-Day,19,119,138,13.77
2012-03-08,11,Thursday,Mid-Day,48,156,204,23.53
2012-03-08,12,Thursday,Mid-Day,27,224,251,10.76
2012-03-08,13,Thursday,Mid-Day,35,198,233,15.02
2012-03-08,14,Thursday,Mid-Day,48,155,203,23.65
2012-03-08,15,Thursday,Mid-Day,24,161,185,12.97
2012-03-08,16,Thursday,Evening Rush,37,305,342,10.82
2012-03-08,17,Thursday,Evening Rush,52,545,597,8.71
2012-03-08,18,Thursday,Evening Rush,45,545,590,7.63
2012-03-08,19,Thursday,Evening Rush,21,395,416,5.05
2012-03-08,20,Thursday,Night,20,282,302,6.62
2012-03-08,21,Thursday,Night,27,206,233,11.59
2012-03-08,22,Thursday,Night,12,141,153,7.84
2012-03-08,23,Thursday,Night,6,88,94,6.38
2012-03-09,0,Friday,Early Morning,3,51,54,5.56
2012-03-09,1,Friday,Early Morning,4,22,26,15.38
2012-03-09,2,Friday,Early Morning,2,9,11,18.18
2012-03-09,3,Friday,Early Morning,0,7,7,0.0
2012-03-09,4,Friday,Early Morning,0,1,1,0.0
2012-03-09,5,Friday,Early Morning,2,27,29,6.9
2012-03-09,6,Friday,Morning Rush,2,83,85,2.35
2012-03-09,7,Friday,Morning Rush,6,262,268,2.24
2012-03-09,8,Friday,Morning Rush,17,484,501,3.39
2012-03-09,9,Friday,Morning Rush,17,267,284,5.99
2012-03-09,10,Friday,Mid-Day,14,145,159,8.81
2012-03-09,11,Friday,Mid-Day,17,170,187,9.09
2012-03-09,12,Friday,Mid-Day,27,174,201,13.43
2012-03-09,13,Friday,Mid-Day,49,175,224,21.88
2012-03-09,14,Friday,Mid-Day,49,129,178,27.53
2012-03-09,15,Friday,Mid-Day,50,188,238,21.01
2012-03-09,16,Friday,Evening Rush,51,292,343,14.87
2012-03-09,17,Friday,Evening Rush,68,498,566,12.01
2012-03-09,18,Friday,Evening Rush,30,440,470,6.38
2012-03-09,19,Friday,Evening Rush,12,232,244,4.92
2012-03-09,20,Friday,Night,3,156,159,1.89
2012-03-09,21,Friday,Night,8,133,141,5.67
2012-03-09,22,Friday,Night,7,100,107,6.54
2012-03-09,23,Friday,Night,9,77,86,10.47
2012-03-10,0,Saturday,Early Morning,9,68,77,11.69
2012-03-10,1,Saturday,Early Morning,1,50,51,1.96
2012-03-10,2,Saturday,Early Morning,12,30,42,28.57
2012-03-10,3,Saturday,Early Morning,0,16,16,0.0
2012-03-10,4,Saturday,Early Morning,1,3,4,25.0
2012-03-10,5,Saturday,Early Morning,3,7,10,30.0
2012-03-10,6,Saturday,Morning Rush,1,11,12,8.33
2012-03-10,7,Saturday,Morning Rush,4,36,40,10.0
2012-03-10,8,Saturday,Morning Rush,15,96,111,13.51
2012-03-10,9,Saturday,Morning Rush,21,127,148,14.19
2012-03-10,10,Saturday,Mid-Day,47,176,223,21.08
2012-03-10,11,Saturday,Mid-Day,56,218,274,20.44
2012-03-10,12,Saturday,Mid-Day,88,241,329,26.75
2012-03-10,13,Saturday,Mid-Day,89,268,357,24.93
2012-03-10,14,Saturday,Mid-Day,117,262,379,30.87
2012-03-10,15,Saturday,Mid-Day,132,274,406,32.51
2012-03-10,16,Saturday,Evening Rush,115,275,390,29.49
2012-03-10,17,Saturday,Evening Rush,104,250,354,29.38
2012-03-10,18,Saturday,Evening Rush,67,230,297,22.56
2012-03-10,19,Saturday,Evening Rush,25,159,184,13.59
2012-03-10,20,Saturday,Night,20,101,121,16.53
2012-03-10,21,Saturday,Night,16,94,110,14.55
2012-03-10,22,Saturday,Night,19,81,100,19.0
2012-03-10,23,Saturday,Night,6,77,83,7.23
2012-03-11,0,Sunday,Early Morning,7,62,69,10.14
2012-03-11,1,Sunday,Early Morning,4,57,61,6.56
2012-03-11,3,Sunday,Early Morning,15,51,66,22.73
2012-03-11,4,Sunday,Early Morning,7,15,22,31.82
2012-03-11,5,Sunday,Early Morning,2,5,7,28.57
2012-03-11,6,Sunday,Morning Rush,2,8,10,20.0
2012-03-11,7,Sunday,Morning Rush,2,15,17,11.76
2012-03-11,8,Sunday,Morning Rush,4,68,72,5.56
2012-03-11,9,Sunday,Morning Rush,20,70,90,22.22
2012-03-11,10,Sunday,Mid-Day,71,147,218,32.57
2012-03-11,11,Sunday,Mid-Day,90,209,299,30.1
2012-03-11,12,Sunday,Mid-Day,146,264,410,35.61
2012-03-11,13,Sunday,Mid-Day,176,288,464,37.93
2012-03-11,14,Sunday,Mid-Day,212,289,501,42.32
2012-03-11,15,Sunday,Mid-Day,201,286,487,41.27
2012-03-11,16,Sunday,Evening Rush,208,301,509,40.86
2012-03-11,17,Sunday,Evening Rush,199,299,498,39.96
2012-03-11,18,Sunday,Evening Rush,133,256,389,34.19
2012-03-11,19,Sunday,Evening Rush,55,203,258,21.32
2012-03-11,20,Sunday,Night,42,129,171,24.56
2012-03-11,21,Sunday,Night,37,110,147,25.17
2012-03-11,22,Sunday,Night,13,81,94,13.83
2012-03-11,23,Sunday,Night,12,40,52,23.08
2012-03-12,0,Monday,Early Morning,4,20,24,16.67
2012-03-12,1,Monday,Early Morning,1,9,10,10.0
2012-03-12,2,Monday,Early Morning,4,5,9,44.44
2012-03-12,3,Monday,Early Morning,0,2,2,0.0
2012-03-12,4,Monday,Early Morning,0,3,3,0.0
2012-03-12,5,Monday,Early Morning,1,15,16,6.25
2012-03-12,6,Monday,Morning Rush,2,86,88,2.27
2012-03-12,7,Monday,Morning Rush,9,259,268,3.36
2012-03-12,8,Monday,Morning Rush,17,547,564,3.01
2012-03-12,9,Monday,Morning Rush,21,260,281,7.47
2012-03-12,10,Monday,Mid-Day,39,98,137,28.47
2012-03-12,11,Monday,Mid-Day,39,111,150,26.0
2012-03-12,12,Monday,Mid-Day,59,162,221,26.7
2012-03-12,13,Monday,Mid-Day,74,176,250,29.6
2012-03-12,14,Monday,Mid-Day,76,145,221,34.39
2012-03-12,15,Monday,Mid-Day,74,159,233,31.76
2012-03-12,16,Monday,Evening Rush,77,255,332,23.19
2012-03-12,17,Monday,Evening Rush,87,557,644,13.51
2012-03-12,18,Monday,Evening Rush,89,623,712,12.5
2012-03-12,19,Monday,Evening Rush,67,379,446,15.02
2012-03-12,20,Monday,Night,49,237,286,17.13
2012-03-12,21,Monday,Night,22,183,205,10.73
2012-03-12,22,Monday,Night,17,116,133,12.78
2012-03-12,23,Monday,Night,10,53,63,15.87
2012-03-13,0,Tuesday,Early Morning,5,21,26,19.23
2012-03-13,1,Tuesday,Early Morning,2,14,16,12.5
2012-03-13,2,Tuesday,Early Morning,0,1,1,0.0
2012-03-13,3,Tuesday,Early Morning,0,2,2,0.0
2012-03-13,4,Tuesday,Early Morning,0,1,1,0.0
2012-03-13,5,Tuesday,Early Morning,0,24,24,0.0
2012-03-13,6,Tuesday,Morning Rush,5,108,113,4.42
2012-03-13,7,Tuesday,Morning Rush,16,292,308,5.19
2012-03-13,8,Tuesday,Morning Rush,22,571,593,3.71
2012-03-13,9,Tuesday,Morning Rush,18,324,342,5.26
2012-03-13,10,Tuesday,Mid-Day,28,115,143,19.58
2012-03-13,11,Tuesday,Mid-Day,64,155,219,29.22
2012-03-13,12,Tuesday,Mid-Day,47,197,244,19.26
2012-03-13,13,Tuesday,Mid-Day,53,180,233,22.75
2012-03-13,14,Tuesday,Mid-Day,52,160,212,24.53
2012-03-13,15,Tuesday,Mid-Day,68,196,264,25.76
2012-03-13,16,Tuesday,Evening Rush,53,312,365,14.52
2012-03-13,17,Tuesday,Evening Rush,62,614,676,9.17
2012-03-13,18,Tuesday,Evening Rush,96,638,734,13.08
2012-03-13,19,Tuesday,Evening Rush,50,429,479,10.44
2012-03-13,20,Tuesday,Night,45,306,351,12.82
2012-03-13,21,Tuesday,Night,44,200,244,18.03
2012-03-13,22,Tuesday,Night,24,146,170,14.12
2012-03-13,23,Tuesday,Night,8,79,87,9.2
2012-03-14,0,Wednesday,Early Morning,5,34,39,12.82
2012-03-14,1,Wednesday,Early Morning,2,25,27,7.41
2012-03-14,2,Wednesday,Early Morning,0,2,2,0.0
2012-03-14,3,Wednesday,Early Morning,1,3,4,25.0
2012-03-14,4,Wednesday,Early Morning,1,4,5,20.0
2012-03-14,5,Wednesday,Early Morning,2,25,27,7.41
2012-03-14,6,Wednesday,Morning Rush,1,120,121,0.83
2012-03-14,7,Wednesday,Morning Rush,20,348,368,5.43
2012-03-14,8,Wednesday,Morning Rush,34,628,662,5.14
2012-03-14,9,Wednesday,Morning Rush,26,325,351,7.41
2012-03-14,10,Wednesday,Mid-Day,38,150,188,20.21
2012-03-14,11,Wednesday,Mid-Day,65,155,220,29.55
2012-03-14,12,Wednesday,Mid-Day,55,212,267,20.6
2012-03-14,13,Wednesday,Mid-Day,57,197,254,22.44
2012-03-14,14,Wednesday,Mid-Day,61,163,224,27.23
2012-03-14,15,Wednesday,Mid-Day,86,197,283,30.39
2012-03-14,16,Wednesday,Evening Rush,78,278,356,21.91
2012-03-14,17,Wednesday,Evening Rush,140,642,782,17.9
2012-03-14,18,Wednesday,Evening Rush,102,647,749,13.62
2012-03-14,19,Wednesday,Evening Rush,70,402,472,14.83
2012-03-14,20,Wednesday,Night,44,286,330,13.33
2012-03-14,21,Wednesday,Night,47,241,288,16.32
2012-03-14,22,Wednesday,Night,43,159,202,21.29
2012-03-14,23,Wednesday,Night,19,72,91,20.88
2012-03-15,0,Thursday,Early Morning,14,46,60,23.33
2012-03-15,1,Thursday,Early Morning,15,8,23,65.22
2012-03-15,2,Thursday,Early Morning,14,5,19,73.68
2012-03-15,3,Thursday,Early Morning,0,7,7,0.0
2012-03-15,4,Thursday,Early Morning,11,3,14,78.57
2012-03-15,5,Thursday,Early Morning,2,24,26,7.69
2012-03-15,6,Thursday,Morning Rush,4,113,117,3.42
2012-03-15,7,Thursday,Morning Rush,14,367,381,3.67
2012-03-15,8,Thursday,Morning Rush,21,602,623,3.37
2012-03-15,9,Thursday,Morning Rush,30,285,315,9.52
2012-03-15,10,Thursday,Mid-Day,34,130,164,20.73
2012-03-15,11,Thursday,Mid-Day,60,151,211,28.44
2012-03-15,12,Thursday,Mid-Day,59,206,265,22.26
2012-03-15,13,Thursday,Mid-Day,62,211,273,22.71
2012-03-15,14,Thursday,Mid-Day,81,177,258,31.4
2012-03-15,15,Thursday,Mid-Day,100,187,287,34.84
2012-03-15,16,Thursday,Evening Rush,95,331,426,22.3
2012-03-15,17,Thursday,Evening Rush,79,634,713,11.08
2012-03-15,18,Thursday,Evening Rush,98,648,746,13.14
2012-03-15,19,Thursday,Evening Rush,72,353,425,16.94
2012-03-15,20,Thursday,Night,60,270,330,18.18
2012-03-15,21,Thursday,Night,36,207,243,14.81
2012-03-15,22,Thursday,Night,32,137,169,18.93
2012-03-15,23,Thursday,Night,12,85,97,12.37
2012-03-16,0,Friday,Early Morning,8,49,57,14.04
2012-03-16,1,Friday,Early Morning,4,22,26,15.38
2012-03-16,2,Friday,Early Morning,0,4,4,0.0
2012-03-16,3,Friday,Early Morning,0,3,3,0.0
2012-03-16,4,Friday,Early Morning,0,3,3,0.0
2012-03-16,5,Friday,Early Morning,2,30,32,6.25
2012-03-16,6,Friday,Morning Rush,3,96,99,3.03
2012-03-16,7,Friday,Morning Rush,13,265,278,4.68
2012-03-16,8,Friday,Morning Rush,28,534,562,4.98
2012-03-16,9,Friday,Morning Rush,35,277,312,11.22
2012-03-16,10,Friday,Mid-Day,44,136,180,24.44
2012-03-16,11,Friday,Mid-Day,40,167,207,19.32
2012-03-16,12,Friday,Mid-Day,72,222,294,24.49
2012-03-16,13,Friday,Mid-Day,52,208,260,20.0
2012-03-16,14,Friday,Mid-Day,56,146,202,27.72
2012-03-16,15,Friday,Mid-Day,19,88,107,17.76
2012-03-16,16,Friday,Evening Rush,18,111,129,13.95
2012-03-16,17,Friday,Evening Rush,23,235,258,8.91
2012-03-16,18,Friday,Evening Rush,31,377,408,7.6
2012-03-16,19,Friday,Evening Rush,23,273,296,7.77
2012-03-16,20,Friday,Night,31,204,235,13.19
2012-03-16,21,Friday,Night,8,144,152,5.26
2012-03-16,22,Friday,Night,16,132,148,10.81
2012-03-16,23,Friday,Night,22,104,126,17.46
2012-03-17,0,Saturday,Early Morning,13,87,100,13.0
2012-03-17,1,Saturday,Early Morning,12,57,69,17.39
2012-03-17,2,Saturday,Early Morning,10,32,42,23.81
2012-03-17,3,Saturday,Early Morning,2,24,26,7.69
2012-03-17,4,Saturday,Early Morning,0,2,2,0.0
2012-03-17,5,Saturday,Early Morning,5,3,8,62.5
2012-03-17,6,Saturday,Morning Rush,1,29,30,3.33
2012-03-17,7,Saturday,Morning Rush,29,57,86,33.72
2012-03-17,8,Saturday,Morning Rush,63,155,218,28.9
2012-03-17,9,Saturday,Morning Rush,104,217,321,32.4
2012-03-17,10,Saturday,Mid-Day,140,303,443,31.6
2012-03-17,11,Saturday,Mid-Day,226,359,585,38.63
2012-03-17,12,Saturday,Mid-Day,286,365,651,43.93
2012-03-17,13,Saturday,Mid-Day,286,400,686,41.69
2012-03-17,14,Saturday,Mid-Day,352,338,690,51.01
2012-03-17,15,Saturday,Mid-Day,357,322,679,52.58
2012-03-17,16,Saturday,Evening Rush,367,318,685,53.58
2012-03-17,17,Saturday,Evening Rush,291,357,648,44.91
2012-03-17,18,Saturday,Evening Rush,221,339,560,39.46
2012-03-17,19,Saturday,Evening Rush,155,262,417,37.17
2012-03-17,20,Saturday,Night,89,182,271,32.84
2012-03-17,21,Saturday,Night,54,169,223,24.22
2012-03-17,22,Saturday,Night,58,153,211,27.49
2012-03-17,23,Saturday,Night,34,151,185,18.38
2012-03-18,0,Sunday,Early Morning,27,80,107,25.23
2012-03-18,1,Sunday,Early Morning,25,88,113,22.12
2012-03-18,2,Sunday,Early Morning,15,41,56,26.79
2012-03-18,3,Sunday,Early Morning,3,15,18,16.67
2012-03-18,4,Sunday,Early Morning,6,8,14,42.86
2012-03-18,5,Sunday,Early Morning,0,6,6,0.0
2012-03-18,6,Sunday,Morning Rush,2,9,11,18.18
2012-03-18,7,Sunday,Morning Rush,17,25,42,40.48
2012-03-18,8,Sunday,Morning Rush,25,71,96,26.04
2012-03-18,9,Sunday,Morning Rush,65,113,178,36.52
2012-03-18,10,Sunday,Mid-Day,139,212,351,39.6
2012-03-18,11,Sunday,Mid-Day,129,239,368,35.05
2012-03-18,12,Sunday,Mid-Day,222,281,503,44.14
2012-03-18,13,Sunday,Mid-Day,198,346,544,36.4
2012-03-18,14,Sunday,Mid-Day,218,303,521,41.84
2012-03-18,15,Sunday,Mid-Day,240,314,554,43.32
2012-03-18,16,Sunday,Evening Rush,229,312,541,42.33
2012-03-18,17,Sunday,Evening Rush,233,308,541,43.07
2012-03-18,18,Sunday,Evening Rush,165,294,459,35.95
2012-03-18,19,Sunday,Evening Rush,118,234,352,33.52
2012-03-18,20,Sunday,Night,59,139,198,29.8
2012-03-18,21,Sunday,Night,44,129,173,25.43
2012-03-18,22,Sunday,Night,21,79,100,21.0
2012-03-18,23,Sunday,Night,7,39,46,15.22
2012-03-19,0,Monday,Early Morning,4,19,23,17.39
2012-03-19,1,Monday,Early Morning,0,15,15,0.0
2012-03-19,2,Monday,Early Morning,1,7,8,12.5
2012-03-19,3,Monday,Early Morning,0,2,2,0.0
2012-03-19,4,Monday,Early Morning,0,3,3,0.0
2012-03-19,5,Monday,Early Morning,0,31,31,0.0
2012-03-19,6,Monday,Morning Rush,2,118,120,1.67
2012-03-19,7,Monday,Morning Rush,25,329,354,7.06
2012-03-19,8,Monday,Morning Rush,16,563,579,2.76
2012-03-19,9,Monday,Morning Rush,55,276,331,16.62
2012-03-19,10,Monday,Mid-Day,56,128,184,30.43
2012-03-19,11,Monday,Mid-Day,56,145,201,27.86
2012-03-19,12,Monday,Mid-Day,71,211,282,25.18
2012-03-19,13,Monday,Mid-Day,69,194,263,26.24
2012-03-19,14,Monday,Mid-Day,60,200,260,23.08
2012-03-19,15,Monday,Mid-Day,97,189,286,33.92
2012-03-19,16,Monday,Evening Rush,65,320,385,16.88
2012-03-19,17,Monday,Evening Rush,106,615,721,14.7
2012-03-19,18,Monday,Evening Rush,120,681,801,14.98
2012-03-19,19,Monday,Evening Rush,86,463,549,15.66
2012-03-19,20,Monday,Night,34,296,330,10.3
2012-03-19,21,Monday,Night,33,190,223,14.8
2012-03-19,22,Monday,Night,17,131,148,11.49
2012-03-19,23,Monday,Night,9,45,54,16.67
2012-03-20,0,Tuesday,Early Morning,5,24,29,17.24
2012-03-20,1,Tuesday,Early Morning,6,9,15,40.0
2012-03-20,2,Tuesday,Early Morning,2,8,10,20.0
2012-03-20,3,Tuesday,Early Morning,0,3,3,0.0
2012-03-20,4,Tuesday,Early Morning,0,6,6,0.0
2012-03-20,5,Tuesday,Early Morning,0,20,20,0.0
2012-03-20,6,Tuesday,Morning Rush,6,94,100,6.0
2012-03-20,7,Tuesday,Morning Rush,3,167,170,1.76
2012-03-20,8,Tuesday,Morning Rush,28,488,516,5.43
2012-03-20,9,Tuesday,Morning Rush,41,284,325,12.62
2012-03-20,10,Tuesday,Mid-Day,44,119,163,26.99
2012-03-20,11,Tuesday,Mid-Day,74,156,230,32.17
2012-03-20,12,Tuesday,Mid-Day,56,205,261,21.46
2012-03-20,13,Tuesday,Mid-Day,77,207,284,27.11
2012-03-20,14,Tuesday,Mid-Day,66,182,248,26.61
2012-03-20,15,Tuesday,Mid-Day,67,177,244,27.46
2012-03-20,16,Tuesday,Evening Rush,99,332,431,22.97
2012-03-20,17,Tuesday,Evening Rush,108,642,750,14.4
2012-03-20,18,Tuesday,Evening Rush,136,665,801,16.98
2012-03-20,19,Tuesday,Evening Rush,75,480,555,13.51
2012-03-20,20,Tuesday,Night,78,299,377,20.69
2012-03-20,21,Tuesday,Night,38,239,277,13.72
2012-03-20,22,Tuesday,Night,32,156,188,17.02
2012-03-20,23,Tuesday,Night,10,80,90,11.11
2012-03-21,0,Wednesday,Early Morning,4,29,33,12.12
2012-03-21,1,Wednesday,Early Morning,4,22,26,15.38
2012-03-21,2,Wednesday,Early Morning,2,8,10,20.0
2012-03-21,3,Wednesday,Early Morning,1,7,8,12.5
2012-03-21,4,Wednesday,Early Morning,0,4,4,0.0
2012-03-21,5,Wednesday,Early Morning,4,35,39,10.26
2012-03-21,6,Wednesday,Morning Rush,10,139,149,6.71
2012-03-21,7,Wednesday,Morning Rush,34,338,372,9.14
2012-03-21,8,Wednesday,Morning Rush,33,502,535,6.17
2012-03-21,9,Wednesday,Morning Rush,38,255,293,12.97
2012-03-21,10,Wednesday,Mid-Day,30,124,154,19.48
2012-03-21,11,Wednesday,Mid-Day,38,154,192,19.79
2012-03-21,12,Wednesday,Mid-Day,58,171,229,25.33
2012-03-21,13,Wednesday,Mid-Day,81,222,303,26.73
2012-03-21,14,Wednesday,Mid-Day,74,151,225,32.89
2012-03-21,15,Wednesday,Mid-Day,68,175,243,27.98
2012-03-21,16,Wednesday,Evening Rush,91,287,378,24.07
2012-03-21,17,Wednesday,Evening Rush,113,616,729,15.5
2012-03-21,18,Wednesday,Evening Rush,152,627,779,19.51
2012-03-21,19,Wednesday,Evening Rush,86,496,582,14.78
2012-03-21,20,Wednesday,Night,76,298,374,20.32
2012-03-21,21,Wednesday,Night,47,204,251,18.73
2012-03-21,22,Wednesday,Night,41,156,197,20.81
2012-03-21,23,Wednesday,Night,37,88,125,29.6
2012-03-22,0,Thursday,Early Morning,9,32,41,21.95
2012-03-22,1,Thursday,Early Morning,14,16,30,46.67
2012-03-22,2,Thursday,Early Morning,1,5,6,16.67
2012-03-22,3,Thursday,Early Morning,0,7,7,0.0
2012-03-22,4,Thursday,Early Morning,0,6,6,0.0
2012-03-22,5,Thursday,Early Morning,2,32,34,5.88
2012-03-22,6,Thursday,Morning Rush,10,126,136,7.35
2012-03-22,7,Thursday,Morning Rush,29,332,361,8.03
2012-03-22,8,Thursday,Morning Rush,51,598,649,7.86
2012-03-22,9,Thursday,Morning Rush,41,277,318,12.89
2012-03-22,10,Thursday,Mid-Day,32,110,142,22.54
2012-03-22,11,Thursday,Mid-Day,53,166,219,24.2
2012-03-22,12,Thursday,Mid-Day,48,224,272,17.65
2012-03-22,13,Thursday,Mid-Day,83,215,298,27.85
2012-03-22,14,Thursday,Mid-Day,96,161,257,37.35
2012-03-22,15,Thursday,Mid-Day,102,202,304,33.55
2012-03-22,16,Thursday,Evening Rush,125,300,425,29.41
2012-03-22,17,Thursday,Evening Rush,154,656,810,19.01
2012-03-22,18,Thursday,Evening Rush,147,654,801,18.35
2012-03-22,19,Thursday,Evening Rush,117,469,586,19.97
2012-03-22,20,Thursday,Night,64,360,424,15.09
2012-03-22,21,Thursday,Night,66,308,374,17.65
2012-03-22,22,Thursday,Night,56,164,220,25.45
2012-03-22,23,Thursday,Night,34,117,151,22.52
2012-03-23,0,Friday,Early Morning,30,65,95,31.58
2012-03-23,1,Friday,Early Morning,18,32,50,36.0
2012-03-23,2,Friday,Early Morning,12,20,32,37.5
2012-03-23,3,Friday,Early Morning,4,6,10,40.0
2012-03-23,4,Friday,Early Morning,0,3,3,0.0
2012-03-23,5,Friday,Early Morning,5,29,34,14.71
2012-03-23,6,Friday,Morning Rush,6,110,116,5.17
2012-03-23,7,Friday,Morning Rush,28,318,346,8.09
2012-03-23,8,Friday,Morning Rush,47,615,662,7.1
2012-03-23,9,Friday,Morning Rush,75,305,380,19.74
2012-03-23,10,Friday,Mid-Day,125,150,275,45.45
2012-03-23,11,Friday,Mid-Day,131,187,318,41.19
2012-03-23,12,Friday,Mid-Day,199,272,471,42.25
2012-03-23,13,Friday,Mid-Day,172,256,428,40.19
2012-03-23,14,Friday,Mid-Day,208,224,432,48.15
2012-03-23,15,Friday,Mid-Day,191,281,472,40.47
2012-03-23,16,Friday,Evening Rush,219,370,589,37.18
2012-03-23,17,Friday,Evening Rush,264,693,957,27.59
2012-03-23,18,Friday,Evening Rush,237,593,830,28.55
2012-03-23,19,Friday,Evening Rush,213,473,686,31.05
2012-03-23,20,Friday,Night,117,328,445,26.29
2012-03-23,21,Friday,Night,64,220,284,22.54
2012-03-23,22,Friday,Night,53,218,271,19.56
2012-03-23,23,Friday,Night,51,125,176,28.98
2012-03-24,0,Saturday,Early Morning,45,111,156,28.85
2012-03-24,1,Saturday,Early Morning,20,108,128,15.63
2012-03-24,2,Saturday,Early Morning,14,55,69,20.29
2012-03-24,3,Saturday,Early Morning,10,22,32,31.25
2012-03-24,4,Saturday,Early Morning,1,6,7,14.29
2012-03-24,5,Saturday,Early Morning,0,4,4,0.0
2012-03-24,6,Saturday,Morning Rush,4,24,28,14.29
2012-03-24,7,Saturday,Morning Rush,25,45,70,35.71
2012-03-24,8,Saturday,Morning Rush,41,113,154,26.62
2012-03-24,9,Saturday,Morning Rush,96,153,249,38.55
2012-03-24,10,Saturday,Mid-Day,148,197,345,42.9
2012-03-24,11,Saturday,Mid-Day,98,175,273,35.9
2012-03-24,12,Saturday,Mid-Day,61,122,183,33.33
2012-03-24,13,Saturday,Mid-Day,62,134,196,31.63
2012-03-24,14,Saturday,Mid-Day,63,160,223,28.25
2012-03-24,15,Saturday,Mid-Day,118,172,290,40.69
2012-03-24,16,Saturday,Evening Rush,49,128,177,27.68
2012-03-24,17,Saturday,Evening Rush,47,68,115,40.87
2012-03-24,18,Saturday,Evening Rush,27,110,137,19.71
2012-03-24,19,Saturday,Evening Rush,28,105,133,21.05
2012-03-24,20,Saturday,Night,31,80,111,27.93
2012-03-24,21,Saturday,Night,16,88,104,15.38
2012-03-24,22,Saturday,Night,12,71,83,14.46
2012-03-24,23,Saturday,Night,17,88,105,16.19
2012-03-25,0,Sunday,Early Morning,18,62,80,22.5
2012-03-25,1,Sunday,Early Morning,24,65,89,26.97
2012-03-25,2,Sunday,Early Morning,6,29,35,17.14
2012-03-25,3,Sunday,Early Morning,8,10,18,44.44
2012-03-25,4,Sunday,Early Morning,1,7,8,12.5
2012-03-25,5,Sunday,Early Morning,0,6,6,0.0
2012-03-25,6,Sunday,Morning Rush,5,13,18,27.78
2012-03-25,7,Sunday,Morning Rush,14,25,39,35.9
2012-03-25,8,Sunday,Morning Rush,21,68,89,23.6
2012-03-25,9,Sunday,Morning Rush,26,92,118,22.03
2012-03-25,10,Sunday,Mid-Day,78,172,250,31.2
2012-03-25,11,Sunday,Mid-Day,106,217,323,32.82
2012-03-25,12,Sunday,Mid-Day,122,238,360,33.89
2012-03-25,13,Sunday,Mid-Day,110,257,367,29.97
2012-03-25,14,Sunday,Mid-Day,123,291,414,29.71
2012-03-25,15,Sunday,Mid-Day,139,282,421,33.02
2012-03-25,16,Sunday,Evening Rush,153,339,492,31.1
2012-03-25,17,Sunday,Evening Rush,146,273,419,34.84
2012-03-25,18,Sunday,Evening Rush,202,289,491,41.14
2012-03-25,19,Sunday,Evening Rush,114,261,375,30.4
2012-03-25,20,Sunday,Night,63,196,259,24.32
2012-03-25,21,Sunday,Night,25,124,149,16.78
2012-03-25,22,Sunday,Night,19,92,111,17.12
2012-03-25,23,Sunday,Night,9,56,65,13.85
2012-03-26,0,Monday,Early Morning,10,23,33,30.3
2012-03-26,1,Monday,Early Morning,18,10,28,64.29
2012-03-26,2,Monday,Early Morning,14,6,20,70.0
2012-03-26,3,Monday,Early Morning,0,1,1,0.0
2012-03-26,4,Monday,Early Morning,0,4,4,0.0
2012-03-26,5,Monday,Early Morning,0,36,36,0.0
2012-03-26,6,Monday,Morning Rush,7,110,117,5.98
2012-03-26,7,Monday,Morning Rush,15,355,370,4.05
2012-03-26,8,Monday,Morning Rush,32,625,657,4.87
2012-03-26,9,Monday,Morning Rush,37,245,282,13.12
2012-03-26,10,Monday,Mid-Day,55,98,153,35.95
2012-03-26,11,Monday,Mid-Day,47,131,178,26.4
2012-03-26,12,Monday,Mid-Day,63,216,279,22.58
2012-03-26,13,Monday,Mid-Day,79,222,301,26.25
2012-03-26,14,Monday,Mid-Day,58,159,217,26.73
2012-03-26,15,Monday,Mid-Day,66,157,223,29.6
2012-03-26,16,Monday,Evening Rush,60,245,305,19.67
2012-03-26,17,Monday,Evening Rush,65,599,664,9.79
2012-03-26,18,Monday,Evening Rush,90,594,684,13.16
2012-03-26,19,Monday,Evening Rush,41,417,458,8.95
2012-03-26,20,Monday,Night,12,209,221,5.43
2012-03-26,21,Monday,Night,11,175,186,5.91
2012-03-26,22,Monday,Night,13,80,93,13.98
2012-03-26,23,Monday,Night,2,46,48,4.17
2012-03-27,0,Tuesday,Early Morning,1,9,10,10.0
2012-03-27,1,Tuesday,Early Morning,1,4,5,20.0
2012-03-27,2,Tuesday,Early Morning,1,6,7,14.29
2012-03-27,3,Tuesday,Early Morning,0,4,4,0.0
2012-03-27,4,Tuesday,Early Morning,0,3,3,0.0
2012-03-27,5,Tuesday,Early Morning,1,16,17,5.88
2012-03-27,6,Tuesday,Morning Rush,5,96,101,4.95
2012-03-27,7,Tuesday,Morning Rush,9,277,286,3.15
2012-03-27,8,Tuesday,Morning Rush,14,567,581,2.41
2012-03-27,9,Tuesday,Morning Rush,8,259,267,3.0
2012-03-27,10,Tuesday,Mid-Day,20,118,138,14.49
2012-03-27,11,Tuesday,Mid-Day,34,141,175,19.43
2012-03-27,12,Tuesday,Mid-Day,34,186,220,15.45
2012-03-27,13,Tuesday,Mid-Day,46,165,211,21.8
2012-03-27,14,Tuesday,Mid-Day,37,147,184,20.11
2012-03-27,15,Tuesday,Mid-Day,42,158,200,21.0
2012-03-27,16,Tuesday,Evening Rush,38,267,305,12.46
2012-03-27,17,Tuesday,Evening Rush,72,542,614,11.73
2012-03-27,18,Tuesday,Evening Rush,67,577,644,10.4
2012-03-27,19,Tuesday,Evening Rush,40,377,417,9.59
2012-03-27,20,Tuesday,Night,28,266,294,9.52
2012-03-27,21,Tuesday,Night,21,200,221,9.5
2012-03-27,22,Tuesday,Night,7,127,134,5.22
2012-03-27,23,Tuesday,Night,5,59,64,7.81
2012-03-28,0,Wednesday,Early Morning,1,29,30,3.33
2012-03-28,1,Wednesday,Early Morning,0,8,8,0.0
2012-03-28,2,Wednesday,Early Morning,0,3,3,0.0
2012-03-28,3,Wednesday,Early Morning,1,4,5,20.0
2012-03-28,4,Wednesday,Early Morning,1,0,1,100.0
2012-03-28,5,Wednesday,Early Morning,2,38,40,5.0
2012-03-28,6,Wednesday,Morning Rush,4,111,115,3.48
2012-03-28,7,Wednesday,Morning Rush,10,348,358,2.79
2012-03-28,8,Wednesday,Morning Rush,19,639,658,2.89
2012-03-28,9,Wednesday,Morning Rush,16,298,314,5.1
2012-03-28,10,Wednesday,Mid-Day,33,140,173,19.08
2012-03-28,11,Wednesday,Mid-Day,54,168,222,24.32
2012-03-28,12,Wednesday,Mid-Day,50,218,268,18.66
2012-03-28,13,Wednesday,Mid-Day,60,213,273,21.98
2012-03-28,14,Wednesday,Mid-Day,52,169,221,23.53
2012-03-28,15,Wednesday,Mid-Day,47,152,199,23.62
2012-03-28,16,Wednesday,Evening Rush,51,170,221,23.08
2012-03-28,17,Wednesday,Evening Rush,72,532,604,11.92
2012-03-28,18,Wednesday,Evening Rush,61,580,641,9.52
2012-03-28,19,Wednesday,Evening Rush,41,415,456,8.99
2012-03-28,20,Wednesday,Night,38,324,362,10.5
2012-03-28,21,Wednesday,Night,28,233,261,10.73
2012-03-28,22,Wednesday,Night,21,151,172,12.21
2012-03-28,23,Wednesday,Night,12,81,93,12.9
2012-03-29,0,Thursday,Early Morning,10,38,48,20.83
2012-03-29,1,Thursday,Early Morning,15,18,33,45.45
2012-03-29,2,Thursday,Early Morning,0,6,6,0.0
2012-03-29,3,Thursday,Early Morning,1,4,5,20.0
2012-03-29,4,Thursday,Early Morning,1,8,9,11.11
2012-03-29,5,Thursday,Early Morning,2,30,32,6.25
2012-03-29,6,Thursday,Morning Rush,3,114,117,2.56
2012-03-29,7,Thursday,Morning Rush,14,353,367,3.81
2012-03-29,8,Thursday,Morning Rush,26,628,654,3.98
2012-03-29,9,Thursday,Morning Rush,22,299,321,6.85
2012-03-29,10,Thursday,Mid-Day,42,124,166,25.3
2012-03-29,11,Thursday,Mid-Day,54,166,220,24.55
2012-03-29,12,Thursday,Mid-Day,64,228,292,21.92
2012-03-29,13,Thursday,Mid-Day,50,223,273,18.32
2012-03-29,14,Thursday,Mid-Day,63,175,238,26.47
2012-03-29,15,Thursday,Mid-Day,109,198,307,35.5
2012-03-29,16,Thursday,Evening Rush,67,321,388,17.27
2012-03-29,17,Thursday,Evening Rush,83,620,703,11.81
2012-03-29,18,Thursday,Evening Rush,83,598,681,12.19
2012-03-29,19,Thursday,Evening Rush,47,421,468,10.04
2012-03-29,20,Thursday,Night,34,301,335,10.15
2012-03-29,21,Thursday,Night,10,214,224,4.46
2012-03-29,22,Thursday,Night,17,135,152,11.18
2012-03-29,23,Thursday,Night,17,77,94,18.09
2012-03-30,0,Friday,Early Morning,10,49,59,16.95
2012-03-30,1,Friday,Early Morning,6,21,27,22.22
2012-03-30,2,Friday,Early Morning,1,6,7,14.29
2012-03-30,3,Friday,Early Morning,0,7,7,0.0
2012-03-30,4,Friday,Early Morning,1,1,2,50.0
2012-03-30,5,Friday,Early Morning,0,26,26,0.0
2012-03-30,6,Friday,Morning Rush,5,81,86,5.81
2012-03-30,7,Friday,Morning Rush,9,280,289,3.11
2012-03-30,8,Friday,Morning Rush,38,555,593,6.41
2012-03-30,9,Friday,Morning Rush,29,292,321,9.03
2012-03-30,10,Friday,Mid-Day,50,137,187,26.74
2012-03-30,11,Friday,Mid-Day,48,153,201,23.88
2012-03-30,12,Friday,Mid-Day,62,208,270,22.96
2012-03-30,13,Friday,Mid-Day,44,198,242,18.18
2012-03-30,14,Friday,Mid-Day,56,173,229,24.45
2012-03-30,15,Friday,Mid-Day,73,207,280,26.07
2012-03-30,16,Friday,Evening Rush,75,292,367,20.44
2012-03-30,17,Friday,Evening Rush,93,513,606,15.35
2012-03-30,18,Friday,Evening Rush,68,492,560,12.14
2012-03-30,19,Friday,Evening Rush,42,353,395,10.63
2012-03-30,20,Friday,Night,17,192,209,8.13
2012-03-30,21,Friday,Night,30,190,220,13.64
2012-03-30,22,Friday,Night,23,130,153,15.03
2012-03-30,23,Friday,Night,16,107,123,13.01
2012-03-31,0,Saturday,Early Morning,12,80,92,13.04
2012-03-31,1,Saturday,Early Morning,17,65,82,20.73
2012-03-31,2,Saturday,Early Morning,14,55,69,20.29
2012-03-31,3,Saturday,Early Morning,10,21,31,32.26
2012-03-31,4,Saturday,Early Morning,4,4,8,50.0
2012-03-31,5,Saturday,Early Morning,0,5,5,0.0
2012-03-31,6,Saturday,Morning Rush,7,16,23,30.43
2012-03-31,7,Saturday,Morning Rush,5,39,44,11.36
2012-03-31,8,Saturday,Morning Rush,19,126,145,13.1
2012-03-31,9,Saturday,Morning Rush,62,161,223,27.8
2012-03-31,10,Saturday,Mid-Day,108,205,313,34.5
2012-03-31,11,Saturday,Mid-Day,184,279,463,39.74
2012-03-31,12,Saturday,Mid-Day,263,358,621,42.35
2012-03-31,13,Saturday,Mid-Day,265,373,638,41.54
2012-03-31,14,Saturday,Mid-Day,240,311,551,43.56
2012-03-31,15,Saturday,Mid-Day,275,330,605,45.45
2012-03-31,16,Saturday,Evening Rush,243,292,535,45.42
2012-03-31,17,Saturday,Evening Rush,238,305,543,43.83
2012-03-31,18,Saturday,Evening Rush,102,239,341,29.91
2012-03-31,19,Saturday,Evening Rush,93,191,284,32.75
2012-03-31,20,Saturday,Night,52,156,208,25.0
2012-03-31,21,Saturday,Night,36,107,143,25.17
2012-03-31,22,Saturday,Night,40,116,156,25.64
2012-03-31,23,Saturday,Night,12,100,112,10.71
2012-04-01,0,Sunday,Early Morning,8,59,67,11.94
2012-04-01,1,Sunday,Early Morning,13,49,62,20.97
2012-04-01,2,Sunday,Early Morning,20,61,81,24.69
2012-04-01,3,Sunday,Early Morning,4,21,25,16.0
2012-04-01,4,Sunday,Early Morning,3,9,12,25.0
2012-04-01,5,Sunday,Early Morning,8,10,18,44.44
2012-04-01,6,Sunday,Morning Rush,9,88,97,9.28
2012-04-01,7,Sunday,Morning Rush,29,55,84,34.52
2012-04-01,8,Sunday,Morning Rush,37,88,125,29.6
2012-04-01,9,Sunday,Morning Rush,102,173,275,37.09
2012-04-01,10,Sunday,Mid-Day,132,228,360,36.67
2012-04-01,11,Sunday,Mid-Day,180,271,451,39.91
2012-04-01,12,Sunday,Mid-Day,187,258,445,42.02
2012-04-01,13,Sunday,Mid-Day,190,274,464,40.95
2012-04-01,14,Sunday,Mid-Day,283,278,561,50.45
2012-04-01,15,Sunday,Mid-Day,295,278,573,51.48
2012-04-01,16,Sunday,Evening Rush,236,275,511,46.18
2012-04-01,17,Sunday,Evening Rush,232,323,555,41.8
2012-04-01,18,Sunday,Evening Rush,153,279,432,35.42
2012-04-01,19,Sunday,Evening Rush,110,236,346,31.79
2012-04-01,20,Sunday,Night,66,166,232,28.45
2012-04-01,21,Sunday,Night,33,101,134,24.63
2012-04-01,22,Sunday,Night,7,61,68,10.29
2012-04-01,23,Sunday,Night,10,53,63,15.87
2012-04-02,0,Monday,Early Morning,6,11,17,35.29
2012-04-02,1,Monday,Early Morning,0,5,5,0.0
2012-04-02,2,Monday,Early Morning,2,3,5,40.0
2012-04-02,4,Monday,Early Morning,2,2,4,50.0
2012-04-02,5,Monday,Early Morning,2,22,24,8.33
2012-04-02,6,Monday,Morning Rush,6,104,110,5.45
2012-04-02,7,Monday,Morning Rush,12,294,306,3.92
2012-04-02,8,Monday,Morning Rush,36,553,589,6.11
2012-04-02,9,Monday,Morning Rush,52,265,317,16.4
2012-04-02,10,Monday,Mid-Day,85,119,204,41.67
2012-04-02,11,Monday,Mid-Day,81,128,209,38.76
2012-04-02,12,Monday,Mid-Day,100,181,281,35.59
2012-04-02,13,Monday,Mid-Day,97,184,281,34.52
2012-04-02,14,Monday,Mid-Day,127,141,268,47.39
2012-04-02,15,Monday,Mid-Day,132,192,324,40.74
2012-04-02,16,Monday,Evening Rush,104,291,395,26.33
2012-04-02,17,Monday,Evening Rush,128,601,729,17.56
2012-04-02,18,Monday,Evening Rush,75,543,618,12.14
2012-04-02,19,Monday,Evening Rush,66,428,494,13.36
2012-04-02,20,Monday,Night,48,281,329,14.59
2012-04-02,21,Monday,Night,24,214,238,10.08
2012-04-02,22,Monday,Night,17,106,123,13.82
2012-04-02,23,Monday,Night,6,60,66,9.09
2012-04-03,0,Tuesday,Early Morning,1,32,33,3.03
2012-04-03,1,Tuesday,Early Morning,0,11,11,0.0
2012-04-03,2,Tuesday,Early Morning,0,5,5,0.0
2012-04-03,3,Tuesday,Early Morning,0,3,3,0.0
2012-04-03,4,Tuesday,Early Morning,0,1,1,0.0
2012-04-03,5,Tuesday,Early Morning,2,25,27,7.41
2012-04-03,6,Tuesday,Morning Rush,2,98,100,2.0
2012-04-03,7,Tuesday,Morning Rush,14,327,341,4.11
2012-04-03,8,Tuesday,Morning Rush,27,577,604,4.47
2012-04-03,9,Tuesday,Morning Rush,54,354,408,13.24
2012-04-03,10,Tuesday,Mid-Day,77,142,219,35.16
2012-04-03,11,Tuesday,Mid-Day,91,167,258,35.27
2012-04-03,12,Tuesday,Mid-Day,101,230,331,30.51
2012-04-03,13,Tuesday,Mid-Day,120,225,345,34.78
2012-04-03,14,Tuesday,Mid-Day,120,191,311,38.59
2012-04-03,15,Tuesday,Mid-Day,109,207,316,34.49
2012-04-03,16,Tuesday,Evening Rush,145,340,485,29.9
2012-04-03,17,Tuesday,Evening Rush,123,634,757,16.25
2012-04-03,18,Tuesday,Evening Rush,139,661,800,17.38
2012-04-03,19,Tuesday,Evening Rush,98,460,558,17.56
2012-04-03,20,Tuesday,Night,54,325,379,14.25
2012-04-03,21,Tuesday,Night,33,210,243,13.58
2012-04-03,22,Tuesday,Night,25,133,158,15.82
2012-04-03,23,Tuesday,Night,13,66,79,16.46
2012-04-04,0,Wednesday,Early Morning,18,23,41,43.9
2012-04-04,1,Wednesday,Early Morning,0,11,11,0.0
2012-04-04,2,Wednesday,Early Morning,0,5,5,0.0
2012-04-04,3,Wednesday,Early Morning,0,3,3,0.0
2012-04-04,4,Wednesday,Early Morning,0,1,1,0.0
2012-04-04,5,Wednesday,Early Morning,0,27,27,0.0
2012-04-04,6,Wednesday,Morning Rush,6,120,126,4.76
2012-04-04,7,Wednesday,Morning Rush,12,354,366,3.28
2012-04-04,8,Wednesday,Morning Rush,31,653,684,4.53
2012-04-04,9,Wednesday,Morning Rush,47,316,363,12.95
2012-04-04,10,Wednesday,Mid-Day,68,99,167,40.72
2012-04-04,11,Wednesday,Mid-Day,61,152,213,28.64
2012-04-04,12,Wednesday,Mid-Day,73,210,283,25.8
2012-04-04,13,Wednesday,Mid-Day,70,181,251,27.89
2012-04-04,14,Wednesday,Mid-Day,82,176,258,31.78
2012-04-04,15,Wednesday,Mid-Day,86,182,268,32.09
2012-04-04,16,Wednesday,Evening Rush,86,304,390,22.05
2012-04-04,17,Wednesday,Evening Rush,99,645,744,13.31
2012-04-04,18,Wednesday,Evening Rush,113,646,759,14.89
2012-04-04,19,Wednesday,Evening Rush,75,419,494,15.18
2012-04-04,20,Wednesday,Night,39,333,372,10.48
2012-04-04,21,Wednesday,Night,43,255,298,14.43
2012-04-04,22,Wednesday,Night,30,151,181,16.57
2012-04-04,23,Wednesday,Night,19,112,131,14.5
2012-04-05,0,Thursday,Early Morning,12,33,45,26.67
2012-04-05,1,Thursday,Early Morning,4,9,13,30.77
2012-04-05,2,Thursday,Early Morning,7,11,18,38.89
2012-04-05,3,Thursday,Early Morning,0,5,5,0.0
2012-04-05,4,Thursday,Early Morning,0,1,1,0.0
2012-04-05,5,Thursday,Early Morning,1,28,29,3.45
2012-04-05,6,Thursday,Morning Rush,8,118,126,6.35
2012-04-05,7,Thursday,Morning Rush,15,339,354,4.24
2012-04-05,8,Thursday,Morning Rush,28,610,638,4.39
2012-04-05,9,Thursday,Morning Rush,61,290,351,17.38
2012-04-05,10,Thursday,Mid-Day,88,158,246,35.77
2012-04-05,11,Thursday,Mid-Day,109,159,268,40.67
2012-04-05,12,Thursday,Mid-Day,66,210,276,23.91
2012-04-05,13,Thursday,Mid-Day,89,202,291,30.58
2012-04-05,14,Thursday,Mid-Day,143,144,287,49.83
2012-04-05,15,Thursday,Mid-Day,98,171,269,36.43
2012-04-05,16,Thursday,Evening Rush,84,318,402,20.9
2012-04-05,17,Thursday,Evening Rush,145,677,822,17.64
2012-04-05,18,Thursday,Evening Rush,80,618,698,11.46
2012-04-05,19,Thursday,Evening Rush,64,423,487,13.14
2012-04-05,20,Thursday,Night,33,279,312,10.58
2012-04-05,21,Thursday,Night,25,209,234,10.68
2012-04-05,22,Thursday,Night,20,129,149,13.42
2012-04-05,23,Thursday,Night,12,124,136,8.82
2012-04-06,0,Friday,Early Morning,12,49,61,19.67
2012-04-06,1,Friday,Early Morning,10,28,38,26.32
2012-04-06,2,Friday,Early Morning,6,5,11,54.55
2012-04-06,3,Friday,Early Morning,3,5,8,37.5
2012-04-06,4,Friday,Early Morning,2,3,5,40.0
2012-04-06,5,Friday,Early Morning,0,23,23,0.0
2012-04-06,6,Friday,Morning Rush,0,80,80,0.0
2012-04-06,7,Friday,Morning Rush,15,231,246,6.1
2012-04-06,8,Friday,Morning Rush,19,489,508,3.74
2012-04-06,9,Friday,Morning Rush,58,318,376,15.43
2012-04-06,10,Friday,Mid-Day,81,157,238,34.03
2012-04-06,11,Friday,Mid-Day,112,179,291,38.49
2012-04-06,12,Friday,Mid-Day,113,224,337,33.53
2012-04-06,13,Friday,Mid-Day,173,238,411,42.09
2012-04-06,14,Friday,Mid-Day,240,250,490,48.98
2012-04-06,15,Friday,Mid-Day,218,319,537,40.6
2012-04-06,16,Friday,Evening Rush,184,352,536,34.33
2012-04-06,17,Friday,Evening Rush,172,483,655,26.26
2012-04-06,18,Friday,Evening Rush,104,380,484,21.49
2012-04-06,19,Friday,Evening Rush,115,297,412,27.91
2012-04-06,20,Friday,Night,61,191,252,24.21
2012-04-06,21,Friday,Night,54,136,190,28.42
2012-04-06,22,Friday,Night,34,124,158,21.52
2012-04-06,23,Friday,Night,21,92,113,18.58
2012-04-07,0,Saturday,Early Morning,9,85,94,9.57
2012-04-07,1,Saturday,Early Morning,9,60,69,13.04
2012-04-07,2,Saturday,Early Morning,11,25,36,30.56
2012-04-07,3,Saturday,Early Morning,7,21,28,25.0
2012-04-07,4,Saturday,Early Morning,3,4,7,42.86
2012-04-07,5,Saturday,Early Morning,0,2,2,0.0
2012-04-07,6,Saturday,Morning Rush,1,18,19,5.26
2012-04-07,7,Saturday,Morning Rush,14,40,54,25.93
2012-04-07,8,Saturday,Morning Rush,29,94,123,23.58
2012-04-07,9,Saturday,Morning Rush,103,173,276,37.32
2012-04-07,10,Saturday,Mid-Day,187,176,363,51.52
2012-04-07,11,Saturday,Mid-Day,251,244,495,50.71
2012-04-07,12,Saturday,Mid-Day,320,270,590,54.24
2012-04-07,13,Saturday,Mid-Day,355,288,643,55.21
2012-04-07,14,Saturday,Mid-Day,326,252,578,56.4
2012-04-07,15,Saturday,Mid-Day,321,305,626,51.28
2012-04-07,16,Saturday,Evening Rush,354,261,615,57.56
2012-04-07,17,Saturday,Evening Rush,299,268,567,52.73
2012-04-07,18,Saturday,Evening Rush,227,290,517,43.91
2012-04-07,19,Saturday,Evening Rush,170,243,413,41.16
2012-04-07,20,Saturday,Night,73,135,208,35.1
2012-04-07,21,Saturday,Night,75,159,234,32.05
2012-04-07,22,Saturday,Night,76,106,182,41.76
2012-04-07,23,Saturday,Night,32,86,118,27.12
2012-04-08,0,Sunday,Early Morning,21,64,85,24.71
2012-04-08,1,Sunday,Early Morning,14,50,64,21.88
2012-04-08,2,Sunday,Early Morning,7,25,32,21.88
2012-04-08,3,Sunday,Early Morning,8,18,26,30.77
2012-04-08,4,Sunday,Early Morning,0,7,7,0.0
2012-04-08,5,Sunday,Early Morning,4,8,12,33.33
2012-04-08,6,Sunday,Morning Rush,7,21,28,25.0
2012-04-08,7,Sunday,Morning Rush,12,25,37,32.43
2012-04-08,8,Sunday,Morning Rush,19,65,84,22.62
2012-04-08,9,Sunday,Morning Rush,71,108,179,39.66
2012-04-08,10,Sunday,Mid-Day,113,186,299,37.79
2012-04-08,11,Sunday,Mid-Day,195,209,404,48.27
2012-04-08,12,Sunday,Mid-Day,198,259,457,43.33
2012-04-08,13,Sunday,Mid-Day,229,254,483,47.41
2012-04-08,14,Sunday,Mid-Day,254,249,503,50.5
2012-04-08,15,Sunday,Mid-Day,260,226,486,53.5
2012-04-08,16,Sunday,Evening Rush,232,244,476,48.74
2012-04-08,17,Sunday,Evening Rush,185,226,411,45.01
2012-04-08,18,Sunday,Evening Rush,151,159,310,48.71
2012-04-08,19,Sunday,Evening Rush,89,187,276,32.25
2012-04-08,20,Sunday,Night,65,146,211,30.81
2012-04-08,21,Sunday,Night,53,77,130,40.77
2012-04-08,22,Sunday,Night,33,85,118,27.97
2012-04-08,23,Sunday,Night,10,41,51,19.61
2012-04-09,0,Monday,Early Morning,8,29,37,21.62
2012-04-09,1,Monday,Early Morning,4,12,16,25.0
2012-04-09,2,Monday,Early Morning,2,4,6,33.33
2012-04-09,3,Monday,Early Morning,0,3,3,0.0
2012-04-09,4,Monday,Early Morning,2,3,5,40.0
2012-04-09,5,Monday,Early Morning,2,30,32,6.25
2012-04-09,6,Monday,Morning Rush,3,108,111,2.7
2012-04-09,7,Monday,Morning Rush,11,320,331,3.32
2012-04-09,8,Monday,Morning Rush,22,595,617,3.57
2012-04-09,9,Monday,Morning Rush,50,236,286,17.48
2012-04-09,10,Monday,Mid-Day,65,113,178,36.52
2012-04-09,11,Monday,Mid-Day,96,127,223,43.05
2012-04-09,12,Monday,Mid-Day,94,186,280,33.57
2012-04-09,13,Monday,Mid-Day,108,173,281,38.43
2012-04-09,14,Monday,Mid-Day,66,152,218,30.28
2012-04-09,15,Monday,Mid-Day,82,173,255,32.16
2012-04-09,16,Monday,Evening Rush,81,310,391,20.72
2012-04-09,17,Monday,Evening Rush,67,565,632,10.6
2012-04-09,18,Monday,Evening Rush,60,586,646,9.29
2012-04-09,19,Monday,Evening Rush,35,386,421,8.31
2012-04-09,20,Monday,Night,21,255,276,7.61
2012-04-09,21,Monday,Night,14,151,165,8.48
2012-04-09,22,Monday,Night,6,102,108,5.56
2012-04-09,23,Monday,Night,6,61,67,8.96
2012-04-10,0,Tuesday,Early Morning,3,23,26,11.54
2012-04-10,1,Tuesday,Early Morning,0,9,9,0.0
2012-04-10,2,Tuesday,Early Morning,0,2,2,0.0
2012-04-10,3,Tuesday,Early Morning,0,2,2,0.0
2012-04-10,4,Tuesday,Early Morning,0,2,2,0.0
2012-04-10,5,Tuesday,Early Morning,0,24,24,0.0
2012-04-10,6,Tuesday,Morning Rush,3,100,103,2.91
2012-04-10,7,Tuesday,Morning Rush,16,368,384,4.17
2012-04-10,8,Tuesday,Morning Rush,22,670,692,3.18
2012-04-10,9,Tuesday,Morning Rush,16,303,319,5.02
2012-04-10,10,Tuesday,Mid-Day,49,132,181,27.07
2012-04-10,11,Tuesday,Mid-Day,78,161,239,32.64
2012-04-10,12,Tuesday,Mid-Day,75,184,259,28.96
2012-04-10,13,Tuesday,Mid-Day,81,202,283,28.62
2012-04-10,14,Tuesday,Mid-Day,75,149,224,33.48
2012-04-10,15,Tuesday,Mid-Day,46,157,203,22.66
2012-04-10,16,Tuesday,Evening Rush,66,296,362,18.23
2012-04-10,17,Tuesday,Evening Rush,88,656,744,11.83
2012-04-10,18,Tuesday,Evening Rush,78,626,704,11.08
2012-04-10,19,Tuesday,Evening Rush,51,428,479,10.65
2012-04-10,20,Tuesday,Night,34,248,282,12.06
2012-04-10,21,Tuesday,Night,15,191,206,7.28
2012-04-10,22,Tuesday,Night,9,118,127,7.09
2012-04-10,23,Tuesday,Night,14,48,62,22.58
2012-04-11,0,Wednesday,Early Morning,8,22,30,26.67
2012-04-11,1,Wednesday,Early Morning,3,9,12,25.0
2012-04-11,2,Wednesday,Early Morning,0,2,2,0.0
2012-04-11,3,Wednesday,Early Morning,0,2,2,0.0
2012-04-11,5,Wednesday,Early Morning,1,26,27,3.7
2012-04-11,6,Wednesday,Morning Rush,3,103,106,2.83
2012-04-11,7,Wednesday,Morning Rush,18,303,321,5.61
2012-04-11,8,Wednesday,Morning Rush,14,581,595,2.35
2012-04-11,9,Wednesday,Morning Rush,20,282,302,6.62
2012-04-11,10,Wednesday,Mid-Day,26,127,153,16.99
2012-04-11,11,Wednesday,Mid-Day,38,142,180,21.11
2012-04-11,12,Wednesday,Mid-Day,35,147,182,19.23
2012-04-11,13,Wednesday,Mid-Day,16,147,163,9.82
2012-04-11,14,Wednesday,Mid-Day,34,101,135,25.19
2012-04-11,15,Wednesday,Mid-Day,50,152,202,24.75
2012-04-11,16,Wednesday,Evening Rush,51,256,307,16.61
2012-04-11,17,Wednesday,Evening Rush,52,527,579,8.98
2012-04-11,18,Wednesday,Evening Rush,39,546,585,6.67
2012-04-11,19,Wednesday,Evening Rush,28,356,384,7.29
2012-04-11,20,Wednesday,Night,22,213,235,9.36
2012-04-11,21,Wednesday,Night,11,154,165,6.67
2012-04-11,22,Wednesday,Night,4,130,134,2.99
2012-04-11,23,Wednesday,Night,9,52,61,14.75
2012-04-12,0,Thursday,Early Morning,1,22,23,4.35
2012-04-12,1,Thursday,Early Morning,2,7,9,22.22
2012-04-12,2,Thursday,Early Morning,0,4,4,0.0
2012-04-12,3,Thursday,Early Morning,2,3,5,40.0
2012-04-12,4,Thursday,Early Morning,0,1,1,0.0
2012-04-12,5,Thursday,Early Morning,0,21,21,0.0
2012-04-12,6,Thursday,Morning Rush,2,94,96,2.08
2012-04-12,7,Thursday,Morning Rush,12,294,306,3.92
2012-04-12,8,Thursday,Morning Rush,20,604,624,3.21
2012-04-12,9,Thursday,Morning Rush,16,271,287,5.57
2012-04-12,10,Thursday,Mid-Day,38,103,141,26.95
2012-04-12,11,Thursday,Mid-Day,50,174,224,22.32
2012-04-12,12,Thursday,Mid-Day,60,199,259,23.17
2012-04-12,13,Thursday,Mid-Day,55,148,203,27.09
2012-04-12,14,Thursday,Mid-Day,74,150,224,33.04
2012-04-12,15,Thursday,Mid-Day,42,169,211,19.91
2012-04-12,16,Thursday,Evening Rush,54,299,353,15.3
2012-04-12,17,Thursday,Evening Rush,60,596,656,9.15
2012-04-12,18,Thursday,Evening Rush,63,547,610,10.33
2012-04-12,19,Thursday,Evening Rush,50,383,433,11.55
2012-04-12,20,Thursday,Night,26,254,280,9.29
2012-04-12,21,Thursday,Night,13,174,187,6.95
2012-04-12,22,Thursday,Night,15,143,158,9.49
2012-04-12,23,Thursday,Night,8,86,94,8.51
2012-04-13,0,Friday,Early Morning,14,41,55,25.45
2012-04-13,1,Friday,Early Morning,2,28,30,6.67
2012-04-13,2,Friday,Early Morning,6,5,11,54.55
2012-04-13,3,Friday,Early Morning,3,8,11,27.27
2012-04-13,4,Friday,Early Morning,1,4,5,20.0
2012-04-13,5,Friday,Early Morning,2,19,21,9.52
2012-04-13,6,Friday,Morning Rush,0,84,84,0.0
2012-04-13,7,Friday,Morning Rush,13,283,296,4.39
2012-04-13,8,Friday,Morning Rush,24,539,563,4.26
2012-04-13,9,Friday,Morning Rush,36,294,330,10.91
2012-04-13,10,Friday,Mid-Day,59,133,192,30.73
2012-04-13,11,Friday,Mid-Day,75,158,233,32.19
2012-04-13,12,Friday,Mid-Day,104,218,322,32.3
2012-04-13,13,Friday,Mid-Day,112,246,358,31.28
2012-04-13,14,Friday,Mid-Day,125,223,348,35.92
2012-04-13,15,Friday,Mid-Day,115,237,352,32.67
2012-04-13,16,Friday,Evening Rush,113,350,463,24.41
2012-04-13,17,Friday,Evening Rush,117,621,738,15.85
2012-04-13,18,Friday,Evening Rush,107,564,671,15.95
2012-04-13,19,Friday,Evening Rush,75,352,427,17.56
2012-04-13,20,Friday,Night,44,242,286,15.38
2012-04-13,21,Friday,Night,36,153,189,19.05
2012-04-13,22,Friday,Night,34,181,215,15.81
2012-04-13,23,Friday,Night,35,163,198,17.68
2012-04-14,0,Saturday,Early Morning,11,85,96,11.46
2012-04-14,1,Saturday,Early Morning,10,60,70,14.29
2012-04-14,2,Saturday,Early Morning,3,53,56,5.36
2012-04-14,3,Saturday,Early Morning,6,26,32,18.75
2012-04-14,4,Saturday,Early Morning,5,9,14,35.71
2012-04-14,5,Saturday,Early Morning,2,5,7,28.57
2012-04-14,6,Saturday,Morning Rush,2,19,21,9.52
2012-04-14,7,Saturday,Morning Rush,8,56,64,12.5
2012-04-14,8,Saturday,Morning Rush,24,136,160,15.0
2012-04-14,9,Saturday,Morning Rush,59,206,265,22.26
2012-04-14,10,Saturday,Mid-Day,139,267,406,34.24
2012-04-14,11,Saturday,Mid-Day,207,357,564,36.7
2012-04-14,12,Saturday,Mid-Day,274,404,678,40.41
2012-04-14,13,Saturday,Mid-Day,308,370,678,45.43
2012-04-14,14,Saturday,Mid-Day,288,372,660,43.64
2012-04-14,15,Saturday,Mid-Day,311,347,658,47.26
2012-04-14,16,Saturday,Evening Rush,253,329,582,43.47
2012-04-14,17,Saturday,Evening Rush,251,309,560,44.82
2012-04-14,18,Saturday,Evening Rush,197,284,481,40.96
2012-04-14,19,Saturday,Evening Rush,163,296,459,35.51
2012-04-14,20,Saturday,Night,112,209,321,34.89
2012-04-14,21,Saturday,Night,53,167,220,24.09
2012-04-14,22,Saturday,Night,64,148,212,30.19
2012-04-14,23,Saturday,Night,45,151,196,22.96
2012-04-15,0,Sunday,Early Morning,30,94,124,24.19
2012-04-15,1,Sunday,Early Morning,17,89,106,16.04
2012-04-15,2,Sunday,Early Morning,20,54,74,27.03
2012-04-15,3,Sunday,Early Morning,18,27,45,40.0
2012-04-15,4,Sunday,Early Morning,2,10,12,16.67
2012-04-15,5,Sunday,Early Morning,4,6,10,40.0
2012-04-15,6,Sunday,Morning Rush,5,11,16,31.25
2012-04-15,7,Sunday,Morning Rush,16,30,46,34.78
2012-04-15,8,Sunday,Morning Rush,33,64,97,34.02
2012-04-15,9,Sunday,Morning Rush,97,154,251,38.65
2012-04-15,10,Sunday,Mid-Day,186,235,421,44.18
2012-04-15,11,Sunday,Mid-Day,227,301,528,42.99
2012-04-15,12,Sunday,Mid-Day,275,360,635,43.31
2012-04-15,13,Sunday,Mid-Day,298,383,681,43.76
2012-04-15,14,Sunday,Mid-Day,282,346,628,44.9
2012-04-15,15,Sunday,Mid-Day,266,351,617,43.11
2012-04-15,16,Sunday,Evening Rush,286,330,616,46.43
2012-04-15,17,Sunday,Evening Rush,262,361,623,42.05
2012-04-15,18,Sunday,Evening Rush,184,295,479,38.41
2012-04-15,19,Sunday,Evening Rush,114,265,379,30.08
2012-04-15,20,Sunday,Night,86,205,291,29.55
2012-04-15,21,Sunday,Night,76,153,229,33.19
2012-04-15,22,Sunday,Night,37,97,134,27.61
2012-04-15,23,Sunday,Night,25,65,90,27.78
2012-04-16,0,Monday,Early Morning,15,26,41,36.59
2012-04-16,1,Monday,Early Morning,7,21,28,25.0
2012-04-16,2,Monday,Early Morning,5,9,14,35.71
2012-04-16,3,Monday,Early Morning,3,5,8,37.5
2012-04-16,4,Monday,Early Morning,0,6,6,0.0
2012-04-16,5,Monday,Early Morning,4,34,38,10.53
2012-04-16,6,Monday,Morning Rush,10,123,133,7.52
2012-04-16,7,Monday,Morning Rush,20,367,387,5.17
2012-04-16,8,Monday,Morning Rush,48,549,597,8.04
2012-04-16,9,Monday,Morning Rush,59,238,297,19.87
2012-04-16,10,Monday,Mid-Day,75,149,224,33.48
2012-04-16,11,Monday,Mid-Day,115,136,251,45.82
2012-04-16,12,Monday,Mid-Day,75,196,271,27.68
2012-04-16,13,Monday,Mid-Day,79,184,263,30.04
2012-04-16,14,Monday,Mid-Day,105,183,288,36.46
2012-04-16,15,Monday,Mid-Day,81,194,275,29.45
2012-04-16,16,Monday,Evening Rush,92,266,358,25.7
2012-04-16,17,Monday,Evening Rush,111,601,712,15.59
2012-04-16,18,Monday,Evening Rush,87,589,676,12.87
2012-04-16,19,Monday,Evening Rush,61,461,522,11.69
2012-04-16,20,Monday,Night,48,327,375,12.8
2012-04-16,21,Monday,Night,39,232,271,14.39
2012-04-16,22,Monday,Night,35,179,214,16.36
2012-04-16,23,Monday,Night,24,97,121,19.83
2012-04-17,0,Tuesday,Early Morning,10,33,43,23.26
2012-04-17,1,Tuesday,Early Morning,6,5,11,54.55
2012-04-17,2,Tuesday,Early Morning,1,3,4,25.0
2012-04-17,3,Tuesday,Early Morning,0,6,6,0.0
2012-04-17,4,Tuesday,Early Morning,3,6,9,33.33
2012-04-17,5,Tuesday,Early Morning,1,29,30,3.33
2012-04-17,6,Tuesday,Morning Rush,8,136,144,5.56
2012-04-17,7,Tuesday,Morning Rush,18,443,461,3.9
2012-04-17,8,Tuesday,Morning Rush,42,631,673,6.24
2012-04-17,9,Tuesday,Morning Rush,71,329,400,17.75
2012-04-17,10,Tuesday,Mid-Day,52,165,217,23.96
2012-04-17,11,Tuesday,Mid-Day,65,174,239,27.2
2012-04-17,12,Tuesday,Mid-Day,65,179,244,26.64
2012-04-17,13,Tuesday,Mid-Day,52,187,239,21.76
2012-04-17,14,Tuesday,Mid-Day,59,198,257,22.96
2012-04-17,15,Tuesday,Mid-Day,91,217,308,29.55
2012-04-17,16,Tuesday,Evening Rush,50,320,370,13.51
2012-04-17,17,Tuesday,Evening Rush,108,673,781,13.83
2012-04-17,18,Tuesday,Evening Rush,105,670,775,13.55
2012-04-17,19,Tuesday,Evening Rush,73,464,537,13.59
2012-04-17,20,Tuesday,Night,44,358,402,10.95
2012-04-17,21,Tuesday,Night,37,260,297,12.46
2012-04-17,22,Tuesday,Night,18,144,162,11.11
2012-04-17,23,Tuesday,Night,10,72,82,12.2
2012-04-18,0,Wednesday,Early Morning,3,35,38,7.89
2012-04-18,1,Wednesday,Early Morning,1,13,14,7.14
2012-04-18,2,Wednesday,Early Morning,1,8,9,11.11
2012-04-18,3,Wednesday,Early Morning,0,6,6,0.0
2012-04-18,4,Wednesday,Early Morning,0,7,7,0.0
2012-04-18,5,Wednesday,Early Morning,0,34,34,0.0
2012-04-18,6,Wednesday,Morning Rush,6,128,134,4.48
2012-04-18,7,Wednesday,Morning Rush,10,408,418,2.39
2012-04-18,8,Wednesday,Morning Rush,25,551,576,4.34
2012-04-18,9,Wednesday,Morning Rush,20,245,265,7.55
2012-04-18,10,Wednesday,Mid-Day,31,116,147,21.09
2012-04-18,11,Wednesday,Mid-Day,14,105,119,11.76
2012-04-18,12,Wednesday,Mid-Day,15,95,110,13.64
2012-04-18,13,Wednesday,Mid-Day,13,51,64,20.31
2012-04-18,14,Wednesday,Mid-Day,8,43,51,15.69
2012-04-18,15,Wednesday,Mid-Day,10,88,98,10.2
2012-04-18,16,Wednesday,Evening Rush,36,199,235,15.32
2012-04-18,17,Wednesday,Evening Rush,46,442,488,9.43
2012-04-18,18,Wednesday,Evening Rush,27,478,505,5.35
2012-04-18,19,Wednesday,Evening Rush,26,342,368,7.07
2012-04-18,20,Wednesday,Night,8,252,260,3.08
2012-04-18,21,Wednesday,Night,24,165,189,12.7
2012-04-18,22,Wednesday,Night,9,153,162,5.56
2012-04-18,23,Wednesday,Night,14,56,70,20.0
2012-04-19,0,Thursday,Early Morning,5,20,25,20.0
2012-04-19,1,Thursday,Early Morning,2,11,13,15.38
2012-04-19,2,Thursday,Early Morning,2,4,6,33.33
2012-04-19,3,Thursday,Early Morning,1,3,4,25.0
2012-04-19,4,Thursday,Early Morning,0,4,4,0.0
2012-04-19,5,Thursday,Early Morning,0,30,30,0.0
2012-04-19,6,Thursday,Morning Rush,4,116,120,3.33
2012-04-19,7,Thursday,Morning Rush,15,391,406,3.69
2012-04-19,8,Thursday,Morning Rush,26,651,677,3.84
2012-04-19,9,Thursday,Morning Rush,31,270,301,10.3
2012-04-19,10,Thursday,Mid-Day,46,143,189,24.34
2012-04-19,11,Thursday,Mid-Day,46,183,229,20.09
2012-04-19,12,Thursday,Mid-Day,51,213,264,19.32
2012-04-19,13,Thursday,Mid-Day,52,186,238,21.85
2012-04-19,14,Thursday,Mid-Day,54,183,237,22.78
2012-04-19,15,Thursday,Mid-Day,66,196,262,25.19
2012-04-19,16,Thursday,Evening Rush,63,324,387,16.28
2012-04-19,17,Thursday,Evening Rush,85,663,748,11.36
2012-04-19,18,Thursday,Evening Rush,99,677,776,12.76
2012-04-19,19,Thursday,Evening Rush,70,516,586,11.95
2012-04-19,20,Thursday,Night,52,352,404,12.87
2012-04-19,21,Thursday,Night,27,240,267,10.11
2012-04-19,22,Thursday,Night,29,219,248,11.69
2012-04-19,23,Thursday,Night,20,124,144,13.89
2012-04-20,0,Friday,Early Morning,5,59,64,7.81
2012-04-20,1,Friday,Early Morning,3,22,25,12.0
2012-04-20,2,Friday,Early Morning,3,18,21,14.29
2012-04-20,3,Friday,Early Morning,1,9,10,10.0
2012-04-20,4,Friday,Early Morning,0,3,3,0.0
2012-04-20,5,Friday,Early Morning,1,24,25,4.0
2012-04-20,6,Friday,Morning Rush,8,105,113,7.08
2012-04-20,7,Friday,Morning Rush,9,350,359,2.51
2012-04-20,8,Friday,Morning Rush,32,668,700,4.57
2012-04-20,9,Friday,Morning Rush,30,329,359,8.36
2012-04-20,10,Friday,Mid-Day,67,170,237,28.27
2012-04-20,11,Friday,Mid-Day,64,190,254,25.2
2012-04-20,12,Friday,Mid-Day,102,260,362,28.18
2012-04-20,13,Friday,Mid-Day,105,276,381,27.56
2012-04-20,14,Friday,Mid-Day,156,238,394,39.59
2012-04-20,15,Friday,Mid-Day,145,262,407,35.63
2012-04-20,16,Friday,Evening Rush,151,429,580,26.03
2012-04-20,17,Friday,Evening Rush,122,697,819,14.9
2012-04-20,18,Friday,Evening Rush,110,558,668,16.47
2012-04-20,19,Friday,Evening Rush,82,410,492,16.67
2012-04-20,20,Friday,Night,52,289,341,15.25
2012-04-20,21,Friday,Night,35,252,287,12.2
2012-04-20,22,Friday,Night,26,176,202,12.87
2012-04-20,23,Friday,Night,31,156,187,16.58
2012-04-21,0,Saturday,Early Morning,31,111,142,21.83
2012-04-21,1,Saturday,Early Morning,24,64,88,27.27
2012-04-21,2,Saturday,Early Morning,12,69,81,14.81
2012-04-21,3,Saturday,Early Morning,4,25,29,13.79
2012-04-21,4,Saturday,Early Morning,0,9,9,0.0
2012-04-21,5,Saturday,Early Morning,0,1,1,0.0
2012-04-21,6,Saturday,Morning Rush,10,21,31,32.26
2012-04-21,7,Saturday,Morning Rush,21,55,76,27.63
2012-04-21,8,Saturday,Morning Rush,52,149,201,25.87
2012-04-21,9,Saturday,Morning Rush,115,216,331,34.74
2012-04-21,10,Saturday,Mid-Day,183,299,482,37.97
2012-04-21,11,Saturday,Mid-Day,260,348,608,42.76
2012-04-21,12,Saturday,Mid-Day,262,378,640,40.94
2012-04-21,13,Saturday,Mid-Day,291,358,649,44.84
2012-04-21,14,Saturday,Mid-Day,278,331,609,45.65
2012-04-21,15,Saturday,Mid-Day,267,361,628,42.52
2012-04-21,16,Saturday,Evening Rush,267,372,639,41.78
2012-04-21,17,Saturday,Evening Rush,259,309,568,45.6
2012-04-21,18,Saturday,Evening Rush,133,283,416,31.97
2012-04-21,19,Saturday,Evening Rush,9,45,54,16.67
2012-04-21,20,Saturday,Night,5,34,39,12.82
2012-04-21,21,Saturday,Night,20,82,102,19.61
2012-04-21,22,Saturday,Night,20,90,110,18.18
2012-04-21,23,Saturday,Night,18,73,91,19.78
2012-04-22,0,Sunday,Early Morning,32,85,117,27.35
2012-04-22,1,Sunday,Early Morning,10,63,73,13.7
2012-04-22,2,Sunday,Early Morning,7,49,56,12.5
2012-04-22,3,Sunday,Early Morning,7,33,40,17.5
2012-04-22,4,Sunday,Early Morning,0,7,7,0.0
2012-04-22,5,Sunday,Early Morning,0,6,6,0.0
2012-04-22,6,Sunday,Morning Rush,6,6,12,50.0
2012-04-22,7,Sunday,Morning Rush,2,22,24,8.33
2012-04-22,8,Sunday,Morning Rush,8,43,51,15.69
2012-04-22,9,Sunday,Morning Rush,8,71,79,10.13
2012-04-22,10,Sunday,Mid-Day,11,57,68,16.18
2012-04-22,11,Sunday,Mid-Day,7,70,77,9.09
2012-04-22,12,Sunday,Mid-Day,5,56,61,8.2
2012-04-22,13,Sunday,Mid-Day,5,47,52,9.62
2012-04-22,14,Sunday,Mid-Day,3,50,53,5.66
2012-04-22,15,Sunday,Mid-Day,0,38,38,0.0
2012-04-22,16,Sunday,Evening Rush,4,32,36,11.11
2012-04-22,17,Sunday,Evening Rush,2,25,27,7.41
2012-04-22,18,Sunday,Evening Rush,1,38,39,2.56
2012-04-22,19,Sunday,Evening Rush,1,34,35,2.86
2012-04-22,20,Sunday,Night,1,34,35,2.86
2012-04-22,21,Sunday,Night,0,11,11,0.0
2012-04-22,22,Sunday,Night,0,13,13,0.0
2012-04-22,23,Sunday,Night,0,17,17,0.0
2012-04-23,0,Monday,Early Morning,0,6,6,0.0
2012-04-23,1,Monday,Early Morning,1,1,2,50.0
2012-04-23,2,Monday,Early Morning,1,3,4,25.0
2012-04-23,3,Monday,Early Morning,0,1,1,0.0
2012-04-23,4,Monday,Early Morning,0,3,3,0.0
2012-04-23,5,Monday,Early Morning,0,14,14,0.0
2012-04-23,6,Monday,Morning Rush,2,43,45,4.44
2012-04-23,7,Monday,Morning Rush,1,206,207,0.48
2012-04-23,8,Monday,Morning Rush,11,471,482,2.28
2012-04-23,9,Monday,Morning Rush,17,255,272,6.25
2012-04-23,10,Monday,Mid-Day,12,88,100,12.0
2012-04-23,11,Monday,Mid-Day,10,91,101,9.9
2012-04-23,12,Monday,Mid-Day,12,117,129,9.3
2012-04-23,13,Monday,Mid-Day,9,98,107,8.41
2012-04-23,14,Monday,Mid-Day,12,102,114,10.53
2012-04-23,15,Monday,Mid-Day,11,101,112,9.82
2012-04-23,16,Monday,Evening Rush,10,93,103,9.71
2012-04-23,17,Monday,Evening Rush,13,219,232,5.6
2012-04-23,18,Monday,Evening Rush,10,369,379,2.64
2012-04-23,19,Monday,Evening Rush,11,287,298,3.69
2012-04-23,20,Monday,Night,17,186,203,8.37
2012-04-23,21,Monday,Night,7,145,152,4.61
2012-04-23,22,Monday,Night,18,71,89,20.22
2012-04-23,23,Monday,Night,10,49,59,16.95
2012-04-24,0,Tuesday,Early Morning,0,13,13,0.0
2012-04-24,1,Tuesday,Early Morning,1,6,7,14.29
2012-04-24,2,Tuesday,Early Morning,0,3,3,0.0
2012-04-24,3,Tuesday,Early Morning,0,2,2,0.0
2012-04-24,4,Tuesday,Early Morning,0,3,3,0.0
2012-04-24,5,Tuesday,Early Morning,0,22,22,0.0
2012-04-24,6,Tuesday,Morning Rush,3,117,120,2.5
2012-04-24,7,Tuesday,Morning Rush,3,387,390,0.77
2012-04-24,8,Tuesday,Morning Rush,12,599,611,1.96
2012-04-24,9,Tuesday,Morning Rush,6,302,308,1.95
2012-04-24,10,Tuesday,Mid-Day,33,129,162,20.37
2012-04-24,11,Tuesday,Mid-Day,27,157,184,14.67
2012-04-24,12,Tuesday,Mid-Day,36,188,224,16.07
2012-04-24,13,Tuesday,Mid-Day,35,189,224,15.63
2012-04-24,14,Tuesday,Mid-Day,50,166,216,23.15
2012-04-24,15,Tuesday,Mid-Day,60,176,236,25.42
2012-04-24,16,Tuesday,Evening Rush,54,308,362,14.92
2012-04-24,17,Tuesday,Evening Rush,72,619,691,10.42
2012-04-24,18,Tuesday,Evening Rush,52,580,632,8.23
2012-04-24,19,Tuesday,Evening Rush,33,449,482,6.85
2012-04-24,20,Tuesday,Night,16,269,285,5.61
2012-04-24,21,Tuesday,Night,13,213,226,5.75
2012-04-24,22,Tuesday,Night,8,149,157,5.1
2012-04-24,23,Tuesday,Night,4,69,73,5.48
2012-04-25,0,Wednesday,Early Morning,13,23,36,36.11
2012-04-25,1,Wednesday,Early Morning,8,17,25,32.0
2012-04-25,2,Wednesday,Early Morning,1,6,7,14.29
2012-04-25,3,Wednesday,Early Morning,0,3,3,0.0
2012-04-25,4,Wednesday,Early Morning,0,6,6,0.0
2012-04-25,5,Wednesday,Early Morning,0,24,24,0.0
2012-04-25,6,Wednesday,Morning Rush,3,103,106,2.83
2012-04-25,7,Wednesday,Morning Rush,13,376,389,3.34
2012-04-25,8,Wednesday,Morning Rush,20,634,654,3.06
2012-04-25,9,Wednesday,Morning Rush,33,288,321,10.28
2012-04-25,10,Wednesday,Mid-Day,44,138,182,24.18
2012-04-25,11,Wednesday,Mid-Day,42,177,219,19.18
2012-04-25,12,Wednesday,Mid-Day,49,220,269,18.22
2012-04-25,13,Wednesday,Mid-Day,35,193,228,15.35
2012-04-25,14,Wednesday,Mid-Day,47,176,223,21.08
2012-04-25,15,Wednesday,Mid-Day,47,182,229,20.52
2012-04-25,16,Wednesday,Evening Rush,49,327,376,13.03
2012-04-25,17,Wednesday,Evening Rush,68,664,732,9.29
2012-04-25,18,Wednesday,Evening Rush,60,649,709,8.46
2012-04-25,19,Wednesday,Evening Rush,42,501,543,7.73
2012-04-25,20,Wednesday,Night,22,358,380,5.79
2012-04-25,21,Wednesday,Night,27,212,239,11.3
2012-04-25,22,Wednesday,Night,22,170,192,11.46
2012-04-25,23,Wednesday,Night,10,94,104,9.62
2012-04-26,0,Thursday,Early Morning,1,42,43,2.33
2012-04-26,1,Thursday,Early Morning,1,22,23,4.35
2012-04-26,2,Thursday,Early Morning,3,10,13,23.08
2012-04-26,3,Thursday,Early Morning,1,5,6,16.67
2012-04-26,4,Thursday,Early Morning,1,2,3,33.33
2012-04-26,5,Thursday,Early Morning,0,17,17,0.0
2012-04-26,6,Thursday,Morning Rush,5,122,127,3.94
2012-04-26,7,Thursday,Morning Rush,3,222,225,1.33
2012-04-26,8,Thursday,Morning Rush,4,358,362,1.1
2012-04-26,9,Thursday,Morning Rush,12,189,201,5.97
2012-04-26,10,Thursday,Mid-Day,14,125,139,10.07
2012-04-26,11,Thursday,Mid-Day,16,135,151,10.6
2012-04-26,12,Thursday,Mid-Day,24,180,204,11.76
2012-04-26,13,Thursday,Mid-Day,19,178,197,9.64
2012-04-26,14,Thursday,Mid-Day,37,132,169,21.89
2012-04-26,15,Thursday,Mid-Day,39,165,204,19.12
2012-04-26,16,Thursday,Evening Rush,37,281,318,11.64
2012-04-26,17,Thursday,Evening Rush,49,565,614,7.98
2012-04-26,18,Thursday,Evening Rush,75,589,664,11.3
2012-04-26,19,Thursday,Evening Rush,57,407,464,12.28
2012-04-26,20,Thursday,Night,23,314,337,6.82
2012-04-26,21,Thursday,Night,28,222,250,11.2
2012-04-26,22,Thursday,Night,20,163,183,10.93
2012-04-26,23,Thursday,Night,6,106,112,5.36
2012-04-27,0,Friday,Early Morning,12,61,73,16.44
2012-04-27,1,Friday,Early Morning,3,32,35,8.57
2012-04-27,2,Friday,Early Morning,4,18,22,18.18
2012-04-27,3,Friday,Early Morning,1,2,3,33.33
2012-04-27,4,Friday,Early Morning,0,6,6,0.0
2012-04-27,5,Friday,Early Morning,0,19,19,0.0
2012-04-27,6,Friday,Morning Rush,5,115,120,4.17
2012-04-27,7,Friday,Morning Rush,10,305,315,3.17
2012-04-27,8,Friday,Morning Rush,17,575,592,2.87
2012-04-27,9,Friday,Morning Rush,42,292,334,12.57
2012-04-27,10,Friday,Mid-Day,64,172,236,27.12
2012-04-27,11,Friday,Mid-Day,47,186,233,20.17
2012-04-27,12,Friday,Mid-Day,63,244,307,20.52
2012-04-27,13,Friday,Mid-Day,94,212,306,30.72
2012-04-27,14,Friday,Mid-Day,94,206,300,31.33
2012-04-27,15,Friday,Mid-Day,101,223,324,31.17
2012-04-27,16,Friday,Evening Rush,105,335,440,23.86
2012-04-27,17,Friday,Evening Rush,89,613,702,12.68
2012-04-27,18,Friday,Evening Rush,94,560,654,14.37
2012-04-27,19,Friday,Evening Rush,62,379,441,14.06
2012-04-27,20,Friday,Night,49,240,289,16.96
2012-04-27,21,Friday,Night,23,185,208,11.06
2012-04-27,22,Friday,Night,24,134,158,15.19
2012-04-27,23,Friday,Night,11,105,116,9.48
2012-04-28,0,Saturday,Early Morning,4,99,103,3.88
2012-04-28,1,Saturday,Early Morning,7,60,67,10.45
2012-04-28,2,Saturday,Early Morning,8,49,57,14.04
2012-04-28,3,Saturday,Early Morning,3,23,26,11.54
2012-04-28,4,Saturday,Early Morning,0,2,2,0.0
2012-04-28,5,Saturday,Early Morning,2,3,5,40.0
2012-04-28,6,Saturday,Morning Rush,10,18,28,35.71
2012-04-28,7,Saturday,Morning Rush,10,45,55,18.18
2012-04-28,8,Saturday,Morning Rush,24,134,158,15.19
2012-04-28,9,Saturday,Morning Rush,45,169,214,21.03
2012-04-28,10,Saturday,Mid-Day,60,231,291,20.62
2012-04-28,11,Saturday,Mid-Day,96,262,358,26.82
2012-04-28,12,Saturday,Mid-Day,105,276,381,27.56
2012-04-28,13,Saturday,Mid-Day,120,269,389,30.85
2012-04-28,14,Saturday,Mid-Day,147,293,440,33.41
2012-04-28,15,Saturday,Mid-Day,148,260,408,36.27
2012-04-28,16,Saturday,Evening Rush,132,244,376,35.11
2012-04-28,17,Saturday,Evening Rush,98,224,322,30.43
2012-04-28,18,Saturday,Evening Rush,17,73,90,18.89
2012-04-28,19,Saturday,Evening Rush,29,110,139,20.86
2012-04-28,20,Saturday,Night,21,81,102,20.59
2012-04-28,21,Saturday,Night,12,72,84,14.29
2012-04-28,22,Saturday,Night,17,66,83,20.48
2012-04-28,23,Saturday,Night,5,37,42,11.9
2012-04-29,0,Sunday,Early Morning,0,36,36,0.0
2012-04-29,1,Sunday,Early Morning,5,37,42,11.9
2012-04-29,2,Sunday,Early Morning,4,36,40,10.0
2012-04-29,3,Sunday,Early Morning,2,14,16,12.5
2012-04-29,4,Sunday,Early Morning,0,4,4,0.0
2012-04-29,5,Sunday,Early Morning,0,6,6,0.0
2012-04-29,6,Sunday,Morning Rush,1,6,7,14.29
2012-04-29,7,Sunday,Morning Rush,7,20,27,25.93
2012-04-29,8,Sunday,Morning Rush,26,81,107,24.3
2012-04-29,9,Sunday,Morning Rush,52,133,185,28.11
2012-04-29,10,Sunday,Mid-Day,127,253,380,33.42
2012-04-29,11,Sunday,Mid-Day,128,283,411,31.14
2012-04-29,12,Sunday,Mid-Day,223,361,584,38.18
2012-04-29,13,Sunday,Mid-Day,226,369,595,37.98
2012-04-29,14,Sunday,Mid-Day,281,372,653,43.03
2012-04-29,15,Sunday,Mid-Day,279,324,603,46.27
2012-04-29,16,Sunday,Evening Rush,240,347,587,40.89
2012-04-29,17,Sunday,Evening Rush,188,334,522,36.02
2012-04-29,18,Sunday,Evening Rush,164,323,487,33.68
2012-04-29,19,Sunday,Evening Rush,128,247,375,34.13
2012-04-29,20,Sunday,Night,45,198,243,18.52
2012-04-29,21,Sunday,Night,65,139,204,31.86
2012-04-29,22,Sunday,Night,23,85,108,21.3
2012-04-29,23,Sunday,Night,15,67,82,18.29
2012-04-30,0,Monday,Early Morning,12,36,48,25.0
2012-04-30,1,Monday,Early Morning,9,15,24,37.5
2012-04-30,2,Monday,Early Morning,3,5,8,37.5
2012-04-30,3,Monday,Early Morning,0,4,4,0.0
2012-04-30,4,Monday,Early Morning,0,2,2,0.0
2012-04-30,5,Monday,Early Morning,1,19,20,5.0
2012-04-30,6,Monday,Morning Rush,2,121,123,1.63
2012-04-30,7,Monday,Morning Rush,6,343,349,1.72
2012-04-30,8,Monday,Morning Rush,17,579,596,2.85
2012-04-30,9,Monday,Morning Rush,29,239,268,10.82
2012-04-30,10,Monday,Mid-Day,41,116,157,26.11
2012-04-30,11,Monday,Mid-Day,52,111,163,31.9
2012-04-30,12,Monday,Mid-Day,45,180,225,20.0
2012-04-30,13,Monday,Mid-Day,48,199,247,19.43
2012-04-30,14,Monday,Mid-Day,56,162,218,25.69
2012-04-30,15,Monday,Mid-Day,55,176,231,23.81
2012-04-30,16,Monday,Evening Rush,44,303,347,12.68
2012-04-30,17,Monday,Evening Rush,66,617,683,9.66
2012-04-30,18,Monday,Evening Rush,53,611,664,7.98
2012-04-30,19,Monday,Evening Rush,51,420,471,10.83
2012-04-30,20,Monday,Night,28,281,309,9.06
2012-04-30,21,Monday,Night,26,195,221,11.76
2012-04-30,22,Monday,Night,11,123,134,8.21
2012-04-30,23,Monday,Night,10,50,60,16.67
2012-05-01,0,Tuesday,Early Morning,7,28,35,20.0
2012-05-01,1,Tuesday,Early Morning,0,21,21,0.0
2012-05-01,2,Tuesday,Early Morning,1,7,8,12.5
2012-05-01,3,Tuesday,Early Morning,1,2,3,33.33
2012-05-01,4,Tuesday,Early Morning,1,7,8,12.5
2012-05-01,5,Tuesday,Early Morning,0,17,17,0.0
2012-05-01,6,Tuesday,Morning Rush,2,24,26,7.69
2012-05-01,7,Tuesday,Morning Rush,8,161,169,4.73
2012-05-01,8,Tuesday,Morning Rush,19,538,557,3.41
2012-05-01,9,Tuesday,Morning Rush,18,331,349,5.16
2012-05-01,10,Tuesday,Mid-Day,30,144,174,17.24
2012-05-01,11,Tuesday,Mid-Day,50,179,229,21.83
2012-05-01,12,Tuesday,Mid-Day,41,228,269,15.24
2012-05-01,13,Tuesday,Mid-Day,41,208,249,16.47
2012-05-01,14,Tuesday,Mid-Day,37,167,204,18.14
2012-05-01,15,Tuesday,Mid-Day,48,186,234,20.51
2012-05-01,16,Tuesday,Evening Rush,41,313,354,11.58
2012-05-01,17,Tuesday,Evening Rush,65,616,681,9.54
2012-05-01,18,Tuesday,Evening Rush,81,662,743,10.9
2012-05-01,19,Tuesday,Evening Rush,58,429,487,11.91
2012-05-01,20,Tuesday,Night,36,299,335,10.75
2012-05-01,21,Tuesday,Night,31,251,282,10.99
2012-05-01,22,Tuesday,Night,21,190,211,9.95
2012-05-01,23,Tuesday,Night,16,79,95,16.84
2012-05-02,0,Wednesday,Early Morning,4,43,47,8.51
2012-05-02,1,Wednesday,Early Morning,8,7,15,53.33
2012-05-02,2,Wednesday,Early Morning,7,9,16,43.75
2012-05-02,3,Wednesday,Early Morning,0,6,6,0.0
2012-05-02,4,Wednesday,Early Morning,2,2,4,50.0
2012-05-02,5,Wednesday,Early Morning,2,31,33,6.06
2012-05-02,6,Wednesday,Morning Rush,3,117,120,2.5
2012-05-02,7,Wednesday,Morning Rush,14,344,358,3.91
2012-05-02,8,Wednesday,Morning Rush,26,640,666,3.9
2012-05-02,9,Wednesday,Morning Rush,26,289,315,8.25
2012-05-02,10,Wednesday,Mid-Day,28,147,175,16.0
2012-05-02,11,Wednesday,Mid-Day,39,145,184,21.2
2012-05-02,12,Wednesday,Mid-Day,35,210,245,14.29
2012-05-02,13,Wednesday,Mid-Day,49,179,228,21.49
2012-05-02,14,Wednesday,Mid-Day,51,189,240,21.25
2012-05-02,15,Wednesday,Mid-Day,52,204,256,20.31
2012-05-02,16,Wednesday,Evening Rush,54,313,367,14.71
2012-05-02,17,Wednesday,Evening Rush,70,659,729,9.6
2012-05-02,18,Wednesday,Evening Rush,43,770,813,5.29
2012-05-02,19,Wednesday,Evening Rush,43,461,504,8.53
2012-05-02,20,Wednesday,Night,42,296,338,12.43
2012-05-02,21,Wednesday,Night,21,218,239,8.79
2012-05-02,22,Wednesday,Night,27,146,173,15.61
2012-05-02,23,Wednesday,Night,21,77,98,21.43
2012-05-03,0,Thursday,Early Morning,15,75,90,16.67
2012-05-03,1,Thursday,Early Morning,9,15,24,37.5
2012-05-03,2,Thursday,Early Morning,4,13,17,23.53
2012-05-03,3,Thursday,Early Morning,2,4,6,33.33
2012-05-03,4,Thursday,Early Morning,0,2,2,0.0
2012-05-03,5,Thursday,Early Morning,1,20,21,4.76
2012-05-03,6,Thursday,Morning Rush,8,128,136,5.88
2012-05-03,7,Thursday,Morning Rush,8,376,384,2.08
2012-05-03,8,Thursday,Morning Rush,19,608,627,3.03
2012-05-03,9,Thursday,Morning Rush,25,279,304,8.22
2012-05-03,10,Thursday,Mid-Day,36,132,168,21.43
2012-05-03,11,Thursday,Mid-Day,34,167,201,16.92
2012-05-03,12,Thursday,Mid-Day,64,237,301,21.26
2012-05-03,13,Thursday,Mid-Day,48,217,265,18.11
2012-05-03,14,Thursday,Mid-Day,33,171,204,16.18
2012-05-03,15,Thursday,Mid-Day,63,220,283,22.26
2012-05-03,16,Thursday,Evening Rush,45,325,370,12.16
2012-05-03,17,Thursday,Evening Rush,87,617,704,12.36
2012-05-03,18,Thursday,Evening Rush,64,642,706,9.07
2012-05-03,19,Thursday,Evening Rush,55,467,522,10.54
2012-05-03,20,Thursday,Night,52,368,420,12.38
2012-05-03,21,Thursday,Night,42,257,299,14.05
2012-05-03,22,Thursday,Night,29,217,246,11.79
2012-05-03,23,Thursday,Night,21,100,121,17.36
2012-05-04,0,Friday,Early Morning,19,70,89,21.35
2012-05-04,1,Friday,Early Morning,15,33,48,31.25
2012-05-04,2,Friday,Early Morning,0,11,11,0.0
2012-05-04,3,Friday,Early Morning,0,14,14,0.0
2012-05-04,4,Friday,Early Morning,0,4,4,0.0
2012-05-04,5,Friday,Early Morning,0,24,24,0.0
2012-05-04,6,Friday,Morning Rush,8,127,135,5.93
2012-05-04,7,Friday,Morning Rush,9,347,356,2.53
2012-05-04,8,Friday,Morning Rush,34,584,618,5.5
2012-05-04,9,Friday,Morning Rush,32,262,294,10.88
2012-05-04,10,Friday,Mid-Day,45,154,199,22.61
2012-05-04,11,Friday,Mid-Day,77,181,258,29.84
2012-05-04,12,Friday,Mid-Day,46,125,171,26.9
2012-05-04,13,Friday,Mid-Day,71,207,278,25.54
2012-05-04,14,Friday,Mid-Day,83,159,242,34.3
2012-05-04,15,Friday,Mid-Day,103,240,343,30.03
2012-05-04,16,Friday,Evening Rush,82,358,440,18.64
2012-05-04,17,Friday,Evening Rush,96,547,643,14.93
2012-05-04,18,Friday,Evening Rush,77,564,641,12.01
2012-05-04,19,Friday,Evening Rush,64,388,452,14.16
2012-05-04,20,Friday,Night,58,255,313,18.53
2012-05-04,21,Friday,Night,49,186,235,20.85
2012-05-04,22,Friday,Night,50,182,232,21.55
2012-05-04,23,Friday,Night,51,205,256,19.92
2012-05-05,0,Saturday,Early Morning,42,111,153,27.45
2012-05-05,1,Saturday,Early Morning,28,79,107,26.17
2012-05-05,2,Saturday,Early Morning,24,51,75,32.0
2012-05-05,3,Saturday,Early Morning,11,21,32,34.38
2012-05-05,4,Saturday,Early Morning,0,9,9,0.0
2012-05-05,5,Saturday,Early Morning,8,14,22,36.36
2012-05-05,6,Saturday,Morning Rush,9,33,42,21.43
2012-05-05,7,Saturday,Morning Rush,8,79,87,9.2
2012-05-05,8,Saturday,Morning Rush,42,155,197,21.32
2012-05-05,9,Saturday,Morning Rush,61,223,284,21.48
2012-05-05,10,Saturday,Mid-Day,148,284,432,34.26
2012-05-05,11,Saturday,Mid-Day,221,354,575,38.43
2012-05-05,12,Saturday,Mid-Day,220,330,550,40.0
2012-05-05,13,Saturday,Mid-Day,217,307,524,41.41
2012-05-05,14,Saturday,Mid-Day,187,241,428,43.69
2012-05-05,15,Saturday,Mid-Day,241,300,541,44.55
2012-05-05,16,Saturday,Evening Rush,230,310,540,42.59
2012-05-05,17,Saturday,Evening Rush,204,298,502,40.64
2012-05-05,18,Saturday,Evening Rush,156,278,434,35.94
2012-05-05,19,Saturday,Evening Rush,151,254,405,37.28
2012-05-05,20,Saturday,Night,100,209,309,32.36
2012-05-05,21,Saturday,Night,86,183,269,31.97
2012-05-05,22,Saturday,Night,67,150,217,30.88
2012-05-05,23,Saturday,Night,35,114,149,23.49
2012-05-06,0,Sunday,Early Morning,23,111,134,17.16
2012-05-06,1,Sunday,Early Morning,37,84,121,30.58
2012-05-06,2,Sunday,Early Morning,29,64,93,31.18
2012-05-06,3,Sunday,Early Morning,9,19,28,32.14
2012-05-06,4,Sunday,Early Morning,9,7,16,56.25
2012-05-06,5,Sunday,Early Morning,1,10,11,9.09
2012-05-06,6,Sunday,Morning Rush,3,14,17,17.65
2012-05-06,7,Sunday,Morning Rush,5,31,36,13.89
2012-05-06,8,Sunday,Morning Rush,23,91,114,20.18
2012-05-06,9,Sunday,Morning Rush,63,128,191,32.98
2012-05-06,10,Sunday,Mid-Day,112,221,333,33.63
2012-05-06,11,Sunday,Mid-Day,144,270,414,34.78
2012-05-06,12,Sunday,Mid-Day,207,351,558,37.1
2012-05-06,13,Sunday,Mid-Day,197,368,565,34.87
2012-05-06,14,Sunday,Mid-Day,226,292,518,43.63
2012-05-06,15,Sunday,Mid-Day,229,342,571,40.11
2012-05-06,16,Sunday,Evening Rush,181,363,544,33.27
2012-05-06,17,Sunday,Evening Rush,195,316,511,38.16
2012-05-06,18,Sunday,Evening Rush,131,332,463,28.29
2012-05-06,19,Sunday,Evening Rush,117,266,383,30.55
2012-05-06,20,Sunday,Night,73,203,276,26.45
2012-05-06,21,Sunday,Night,55,148,203,27.09
2012-05-06,22,Sunday,Night,44,113,157,28.03
2012-05-06,23,Sunday,Night,22,80,102,21.57
2012-05-07,0,Monday,Early Morning,13,21,34,38.24
2012-05-07,1,Monday,Early Morning,1,8,9,11.11
2012-05-07,2,Monday,Early Morning,1,5,6,16.67
2012-05-07,3,Monday,Early Morning,2,3,5,40.0
2012-05-07,4,Monday,Early Morning,0,2,2,0.0
2012-05-07,5,Monday,Early Morning,2,21,23,8.7
2012-05-07,6,Monday,Morning Rush,8,134,142,5.63
2012-05-07,7,Monday,Morning Rush,18,367,385,4.68
2012-05-07,8,Monday,Morning Rush,31,608,639,4.85
2012-05-07,9,Monday,Morning Rush,61,289,350,17.43
2012-05-07,10,Monday,Mid-Day,62,128,190,32.63
2012-05-07,11,Monday,Mid-Day,64,149,213,30.05
2012-05-07,12,Monday,Mid-Day,74,189,263,28.14
2012-05-07,13,Monday,Mid-Day,75,197,272,27.57
2012-05-07,14,Monday,Mid-Day,59,180,239,24.69
2012-05-07,15,Monday,Mid-Day,76,186,262,29.01
2012-05-07,16,Monday,Evening Rush,68,320,388,17.53
2012-05-07,17,Monday,Evening Rush,102,667,769,13.26
2012-05-07,18,Monday,Evening Rush,78,602,680,11.47
2012-05-07,19,Monday,Evening Rush,83,463,546,15.2
2012-05-07,20,Monday,Night,46,277,323,14.24
2012-05-07,21,Monday,Night,37,210,247,14.98
2012-05-07,22,Monday,Night,26,147,173,15.03
2012-05-07,23,Monday,Night,21,92,113,18.58
2012-05-08,0,Tuesday,Early Morning,10,28,38,26.32
2012-05-08,1,Tuesday,Early Morning,6,3,9,66.67
2012-05-08,2,Tuesday,Early Morning,9,7,16,56.25
2012-05-08,3,Tuesday,Early Morning,2,4,6,33.33
2012-05-08,4,Tuesday,Early Morning,0,5,5,0.0
2012-05-08,5,Tuesday,Early Morning,0,20,20,0.0
2012-05-08,6,Tuesday,Morning Rush,7,158,165,4.24
2012-05-08,7,Tuesday,Morning Rush,21,442,463,4.54
2012-05-08,8,Tuesday,Morning Rush,36,605,641,5.62
2012-05-08,9,Tuesday,Morning Rush,37,258,295,12.54
2012-05-08,10,Tuesday,Mid-Day,46,111,157,29.3
2012-05-08,11,Tuesday,Mid-Day,60,157,217,27.65
2012-05-08,12,Tuesday,Mid-Day,60,203,263,22.81
2012-05-08,13,Tuesday,Mid-Day,53,166,219,24.2
2012-05-08,14,Tuesday,Mid-Day,8,63,71,11.27
2012-05-08,15,Tuesday,Mid-Day,40,94,134,29.85
2012-05-08,16,Tuesday,Evening Rush,54,335,389,13.88
2012-05-08,17,Tuesday,Evening Rush,77,640,717,10.74
2012-05-08,18,Tuesday,Evening Rush,69,641,710,9.72
2012-05-08,19,Tuesday,Evening Rush,59,399,458,12.88
2012-05-08,20,Tuesday,Night,40,262,302,13.25
2012-05-08,21,Tuesday,Night,21,202,223,9.42
2012-05-08,22,Tuesday,Night,13,134,147,8.84
2012-05-08,23,Tuesday,Night,10,53,63,15.87
2012-05-09,0,Wednesday,Early Morning,8,27,35,22.86
2012-05-09,1,Wednesday,Early Morning,3,11,14,21.43
2012-05-09,2,Wednesday,Early Morning,0,1,1,0.0
2012-05-09,3,Wednesday,Early Morning,0,2,2,0.0
2012-05-09,4,Wednesday,Early Morning,0,5,5,0.0
2012-05-09,5,Wednesday,Early Morning,1,27,28,3.57
2012-05-09,6,Wednesday,Morning Rush,5,121,126,3.97
2012-05-09,7,Wednesday,Morning Rush,17,401,418,4.07
2012-05-09,8,Wednesday,Morning Rush,28,594,622,4.5
2012-05-09,9,Wednesday,Morning Rush,40,285,325,12.31
2012-05-09,10,Wednesday,Mid-Day,40,113,153,26.14
2012-05-09,11,Wednesday,Mid-Day,45,156,201,22.39
2012-05-09,12,Wednesday,Mid-Day,58,222,280,20.71
2012-05-09,13,Wednesday,Mid-Day,50,216,266,18.8
2012-05-09,14,Wednesday,Mid-Day,68,175,243,27.98
2012-05-09,15,Wednesday,Mid-Day,68,191,259,26.25
2012-05-09,16,Wednesday,Evening Rush,68,289,357,19.05
2012-05-09,17,Wednesday,Evening Rush,76,629,705,10.78
2012-05-09,18,Wednesday,Evening Rush,23,349,372,6.18
2012-05-09,19,Wednesday,Evening Rush,2,96,98,2.04
2012-05-09,20,Wednesday,Night,3,48,51,5.88
2012-05-09,21,Wednesday,Night,4,30,34,11.76
2012-05-09,22,Wednesday,Night,5,62,67,7.46
2012-05-09,23,Wednesday,Night,8,47,55,14.55
2012-05-10,0,Thursday,Early Morning,2,31,33,6.06
2012-05-10,1,Thursday,Early Morning,2,9,11,18.18
2012-05-10,2,Thursday,Early Morning,0,3,3,0.0
2012-05-10,3,Thursday,Early Morning,0,3,3,0.0
2012-05-10,4,Thursday,Early Morning,0,2,2,0.0
2012-05-10,5,Thursday,Early Morning,1,23,24,4.17
2012-05-10,6,Thursday,Morning Rush,9,130,139,6.47
2012-05-10,7,Thursday,Morning Rush,8,393,401,2.0
2012-05-10,8,Thursday,Morning Rush,27,603,630,4.29
2012-05-10,9,Thursday,Morning Rush,62,299,361,17.17
2012-05-10,10,Thursday,Mid-Day,42,112,154,27.27
2012-05-10,11,Thursday,Mid-Day,77,179,256,30.08
2012-05-10,12,Thursday,Mid-Day,65,207,272,23.9
2012-05-10,13,Thursday,Mid-Day,90,228,318,28.3
2012-05-10,14,Thursday,Mid-Day,61,186,247,24.7
2012-05-10,15,Thursday,Mid-Day,79,192,271,29.15
2012-05-10,16,Thursday,Evening Rush,87,334,421,20.67
2012-05-10,17,Thursday,Evening Rush,84,648,732,11.48
2012-05-10,18,Thursday,Evening Rush,109,661,770,14.16
2012-05-10,19,Thursday,Evening Rush,84,469,553,15.19
2012-05-10,20,Thursday,Night,59,315,374,15.78
2012-05-10,21,Thursday,Night,19,211,230,8.26
2012-05-10,22,Thursday,Night,36,196,232,15.52
2012-05-10,23,Thursday,Night,23,112,135,17.04
2012-05-11,0,Friday,Early Morning,17,47,64,26.56
2012-05-11,1,Friday,Early Morning,14,32,46,30.43
2012-05-11,2,Friday,Early Morning,15,16,31,48.39
2012-05-11,3,Friday,Early Morning,5,8,13,38.46
2012-05-11,4,Friday,Early Morning,3,6,9,33.33
2012-05-11,5,Friday,Early Morning,3,23,26,11.54
2012-05-11,6,Friday,Morning Rush,7,128,135,5.19
2012-05-11,7,Friday,Morning Rush,6,345,351,1.71
2012-05-11,8,Friday,Morning Rush,41,579,620,6.61
2012-05-11,9,Friday,Morning Rush,34,288,322,10.56
2012-05-11,10,Friday,Mid-Day,69,141,210,32.86
2012-05-11,11,Friday,Mid-Day,88,203,291,30.24
2012-05-11,12,Friday,Mid-Day,89,259,348,25.57
2012-05-11,13,Friday,Mid-Day,100,263,363,27.55
2012-05-11,14,Friday,Mid-Day,116,218,334,34.73
2012-05-11,15,Friday,Mid-Day,140,299,439,31.89
2012-05-11,16,Friday,Evening Rush,128,397,525,24.38
2012-05-11,17,Friday,Evening Rush,102,677,779,13.09
2012-05-11,18,Friday,Evening Rush,78,518,596,13.09
2012-05-11,19,Friday,Evening Rush,73,430,503,14.51
2012-05-11,20,Friday,Night,64,277,341,18.77
2012-05-11,21,Friday,Night,45,225,270,16.67
2012-05-11,22,Friday,Night,44,190,234,18.8
2012-05-11,23,Friday,Night,38,142,180,21.11
2012-05-12,0,Saturday,Early Morning,25,111,136,18.38
2012-05-12,1,Saturday,Early Morning,14,79,93,15.05
2012-05-12,2,Saturday,Early Morning,10,46,56,17.86
2012-05-12,3,Saturday,Early Morning,14,20,34,41.18
2012-05-12,4,Saturday,Early Morning,3,6,9,33.33
2012-05-12,5,Saturday,Early Morning,5,8,13,38.46
2012-05-12,6,Saturday,Morning Rush,10,23,33,30.3
2012-05-12,7,Saturday,Morning Rush,10,57,67,14.93
2012-05-12,8,Saturday,Morning Rush,22,156,178,12.36
2012-05-12,9,Saturday,Morning Rush,87,248,335,25.97
2012-05-12,10,Saturday,Mid-Day,132,279,411,32.12
2012-05-12,11,Saturday,Mid-Day,157,365,522,30.08
2012-05-12,12,Saturday,Mid-Day,206,353,559,36.85
2012-05-12,13,Saturday,Mid-Day,293,366,659,44.46
2012-05-12,14,Saturday,Mid-Day,257,358,615,41.79
2012-05-12,15,Saturday,Mid-Day,269,321,590,45.59
2012-05-12,16,Saturday,Evening Rush,254,337,591,42.98
2012-05-12,17,Saturday,Evening Rush,233,343,576,40.45
2012-05-12,18,Saturday,Evening Rush,164,382,546,30.04
2012-05-12,19,Saturday,Evening Rush,166,273,439,37.81
2012-05-12,20,Saturday,Night,113,174,287,39.37
2012-05-12,21,Saturday,Night,74,156,230,32.17
2012-05-12,22,Saturday,Night,62,212,274,22.63
2012-05-12,23,Saturday,Night,42,134,176,23.86
2012-05-13,0,Sunday,Early Morning,19,79,98,19.39
2012-05-13,1,Sunday,Early Morning,22,72,94,23.4
2012-05-13,2,Sunday,Early Morning,22,60,82,26.83
2012-05-13,3,Sunday,Early Morning,2,26,28,7.14
2012-05-13,4,Sunday,Early Morning,2,7,9,22.22
2012-05-13,5,Sunday,Early Morning,4,8,12,33.33
2012-05-13,6,Sunday,Morning Rush,6,15,21,28.57
2012-05-13,7,Sunday,Morning Rush,18,42,60,30.0
2012-05-13,8,Sunday,Morning Rush,32,124,156,20.51
2012-05-13,9,Sunday,Morning Rush,79,143,222,35.59
2012-05-13,10,Sunday,Mid-Day,128,222,350,36.57
2012-05-13,11,Sunday,Mid-Day,150,278,428,35.05
2012-05-13,12,Sunday,Mid-Day,189,342,531,35.59
2012-05-13,13,Sunday,Mid-Day,255,347,602,42.36
2012-05-13,14,Sunday,Mid-Day,228,324,552,41.3
2012-05-13,15,Sunday,Mid-Day,190,309,499,38.08
2012-05-13,16,Sunday,Evening Rush,225,339,564,39.89
2012-05-13,17,Sunday,Evening Rush,191,287,478,39.96
2012-05-13,18,Sunday,Evening Rush,129,260,389,33.16
2012-05-13,19,Sunday,Evening Rush,107,232,339,31.56
2012-05-13,20,Sunday,Night,67,163,230,29.13
2012-05-13,21,Sunday,Night,48,121,169,28.4
2012-05-13,22,Sunday,Night,42,89,131,32.06
2012-05-13,23,Sunday,Night,17,57,74,22.97
2012-05-14,0,Monday,Early Morning,21,14,35,60.0
2012-05-14,1,Monday,Early Morning,5,6,11,45.45
2012-05-14,2,Monday,Early Morning,1,1,2,50.0
2012-05-14,3,Monday,Early Morning,0,2,2,0.0
2012-05-14,4,Monday,Early Morning,3,3,6,50.0
2012-05-14,5,Monday,Early Morning,1,25,26,3.85
2012-05-14,6,Monday,Morning Rush,3,62,65,4.62
2012-05-14,7,Monday,Morning Rush,3,72,75,4.0
2012-05-14,8,Monday,Morning Rush,1,155,156,0.64
2012-05-14,9,Monday,Morning Rush,5,105,110,4.55
2012-05-14,10,Monday,Mid-Day,6,53,59,10.17
2012-05-14,11,Monday,Mid-Day,12,67,79,15.19
2012-05-14,12,Monday,Mid-Day,53,132,185,28.65
2012-05-14,13,Monday,Mid-Day,33,143,176,18.75
2012-05-14,14,Monday,Mid-Day,43,128,171,25.15
2012-05-14,15,Monday,Mid-Day,40,156,196,20.41
2012-05-14,16,Monday,Evening Rush,20,91,111,18.02
2012-05-14,17,Monday,Evening Rush,25,204,229,10.92
2012-05-14,18,Monday,Evening Rush,17,283,300,5.67
2012-05-14,19,Monday,Evening Rush,10,294,304,3.29
2012-05-14,20,Monday,Night,11,178,189,5.82
2012-05-14,21,Monday,Night,7,145,152,4.61
2012-05-14,22,Monday,Night,11,118,129,8.53
2012-05-14,23,Monday,Night,11,64,75,14.67
2012-05-15,0,Tuesday,Early Morning,7,25,32,21.88
2012-05-15,1,Tuesday,Early Morning,5,14,19,26.32
2012-05-15,2,Tuesday,Early Morning,1,3,4,25.0
2012-05-15,3,Tuesday,Early Morning,1,5,6,16.67
2012-05-15,4,Tuesday,Early Morning,1,4,5,20.0
2012-05-15,5,Tuesday,Early Morning,0,8,8,0.0
2012-05-15,6,Tuesday,Morning Rush,2,22,24,8.33
2012-05-15,7,Tuesday,Morning Rush,1,91,92,1.09
2012-05-15,8,Tuesday,Morning Rush,8,401,409,1.96
2012-05-15,9,Tuesday,Morning Rush,28,327,355,7.89
2012-05-15,10,Tuesday,Mid-Day,27,144,171,15.79
2012-05-15,11,Tuesday,Mid-Day,38,186,224,16.96
2012-05-15,12,Tuesday,Mid-Day,44,220,264,16.67
2012-05-15,13,Tuesday,Mid-Day,35,204,239,14.64
2012-05-15,14,Tuesday,Mid-Day,39,145,184,21.2
2012-05-15,15,Tuesday,Mid-Day,51,205,256,19.92
2012-05-15,16,Tuesday,Evening Rush,74,300,374,19.79
2012-05-15,17,Tuesday,Evening Rush,75,603,678,11.06
2012-05-15,18,Tuesday,Evening Rush,68,665,733,9.28
2012-05-15,19,Tuesday,Evening Rush,57,455,512,11.13
2012-05-15,20,Tuesday,Night,30,233,263,11.41
2012-05-15,21,Tuesday,Night,11,98,109,10.09
2012-05-15,22,Tuesday,Night,9,74,83,10.84
2012-05-15,23,Tuesday,Night,13,58,71,18.31
2012-05-16,0,Wednesday,Early Morning,12,27,39,30.77
2012-05-16,1,Wednesday,Early Morning,7,14,21,33.33
2012-05-16,2,Wednesday,Early Morning,5,14,19,26.32
2012-05-16,3,Wednesday,Early Morning,1,5,6,16.67
2012-05-16,4,Wednesday,Early Morning,1,3,4,25.0
2012-05-16,5,Wednesday,Early Morning,4,34,38,10.53
2012-05-16,6,Wednesday,Morning Rush,8,150,158,5.06
2012-05-16,7,Wednesday,Morning Rush,14,426,440,3.18
2012-05-16,8,Wednesday,Morning Rush,33,617,650,5.08
2012-05-16,9,Wednesday,Morning Rush,33,314,347,9.51
2012-05-16,10,Wednesday,Mid-Day,43,149,192,22.4
2012-05-16,11,Wednesday,Mid-Day,55,212,267,20.6
2012-05-16,12,Wednesday,Mid-Day,59,271,330,17.88
2012-05-16,13,Wednesday,Mid-Day,77,273,350,22.0
2012-05-16,14,Wednesday,Mid-Day,42,221,263,15.97
2012-05-16,15,Wednesday,Mid-Day,52,222,274,18.98
2012-05-16,16,Wednesday,Evening Rush,70,376,446,15.7
2012-05-16,17,Wednesday,Evening Rush,104,769,873,11.91
2012-05-16,18,Wednesday,Evening Rush,97,749,846,11.47
2012-05-16,19,Wednesday,Evening Rush,91,499,590,15.42
2012-05-16,20,Wednesday,Night,61,398,459,13.29
2012-05-16,21,Wednesday,Night,63,330,393,16.03
2012-05-16,22,Wednesday,Night,33,253,286,11.54
2012-05-16,23,Wednesday,Night,26,107,133,19.55
2012-05-17,0,Thursday,Early Morning,30,49,79,37.97
2012-05-17,1,Thursday,Early Morning,12,16,28,42.86
2012-05-17,2,Thursday,Early Morning,8,8,16,50.0
2012-05-17,3,Thursday,Early Morning,0,3,3,0.0
2012-05-17,4,Thursday,Early Morning,3,13,16,18.75
2012-05-17,5,Thursday,Early Morning,1,34,35,2.86
2012-05-17,6,Thursday,Morning Rush,10,149,159,6.29
2012-05-17,7,Thursday,Morning Rush,25,449,474,5.27
2012-05-17,8,Thursday,Morning Rush,29,605,634,4.57
2012-05-17,9,Thursday,Morning Rush,57,289,346,16.47
2012-05-17,10,Thursday,Mid-Day,43,162,205,20.98
2012-05-17,11,Thursday,Mid-Day,77,202,279,27.6
2012-05-17,12,Thursday,Mid-Day,72,276,348,20.69
2012-05-17,13,Thursday,Mid-Day,86,241,327,26.3
2012-05-17,14,Thursday,Mid-Day,68,202,270,25.19
2012-05-17,15,Thursday,Mid-Day,83,233,316,26.27
2012-05-17,16,Thursday,Evening Rush,86,344,430,20.0
2012-05-17,17,Thursday,Evening Rush,133,719,852,15.61
2012-05-17,18,Thursday,Evening Rush,134,734,868,15.44
2012-05-17,19,Thursday,Evening Rush,86,451,537,16.01
2012-05-17,20,Thursday,Night,83,363,446,18.61
2012-05-17,21,Thursday,Night,45,254,299,15.05
2012-05-17,22,Thursday,Night,42,209,251,16.73
2012-05-17,23,Thursday,Night,29,137,166,17.47
2012-05-18,0,Friday,Early Morning,13,57,70,18.57
2012-05-18,1,Friday,Early Morning,16,33,49,32.65
2012-05-18,2,Friday,Early Morning,12,9,21,57.14
2012-05-18,3,Friday,Early Morning,6,8,14,42.86
2012-05-18,4,Friday,Early Morning,0,11,11,0.0
2012-05-18,5,Friday,Early Morning,1,33,34,2.94
2012-05-18,6,Friday,Morning Rush,14,168,182,7.69
2012-05-18,7,Friday,Morning Rush,40,475,515,7.77
2012-05-18,8,Friday,Morning Rush,49,696,745,6.58
2012-05-18,9,Friday,Morning Rush,57,304,361,15.79
2012-05-18,10,Friday,Mid-Day,74,181,255,29.02
2012-05-18,11,Friday,Mid-Day,109,225,334,32.63
2012-05-18,12,Friday,Mid-Day,108,252,360,30.0
2012-05-18,13,Friday,Mid-Day,98,297,395,24.81
2012-05-18,14,Friday,Mid-Day,108,242,350,30.86
2012-05-18,15,Friday,Mid-Day,131,260,391,33.5
2012-05-18,16,Friday,Evening Rush,151,417,568,26.58
2012-05-18,17,Friday,Evening Rush,124,688,812,15.27
2012-05-18,18,Friday,Evening Rush,99,570,669,14.8
2012-05-18,19,Friday,Evening Rush,91,392,483,18.84
2012-05-18,20,Friday,Night,73,264,337,21.66
2012-05-18,21,Friday,Night,49,209,258,18.99
2012-05-18,22,Friday,Night,57,194,251,22.71
2012-05-18,23,Friday,Night,41,133,174,23.56
2012-05-19,0,Saturday,Early Morning,30,118,148,20.27
2012-05-19,1,Saturday,Early Morning,20,84,104,19.23
2012-05-19,2,Saturday,Early Morning,13,56,69,18.84
2012-05-19,3,Saturday,Early Morning,10,23,33,30.3
2012-05-19,4,Saturday,Early Morning,6,8,14,42.86
2012-05-19,5,Saturday,Early Morning,1,11,12,8.33
2012-05-19,6,Saturday,Morning Rush,12,38,50,24.0
2012-05-19,7,Saturday,Morning Rush,28,67,95,29.47
2012-05-19,8,Saturday,Morning Rush,33,162,195,16.92
2012-05-19,9,Saturday,Morning Rush,79,213,292,27.05
2012-05-19,10,Saturday,Mid-Day,177,275,452,39.16
2012-05-19,11,Saturday,Mid-Day,235,351,586,40.1
2012-05-19,12,Saturday,Mid-Day,276,366,642,42.99
2012-05-19,13,Saturday,Mid-Day,332,372,704,47.16
2012-05-19,14,Saturday,Mid-Day,361,369,730,49.45
2012-05-19,15,Saturday,Mid-Day,356,316,672,52.98
2012-05-19,16,Saturday,Evening Rush,331,311,642,51.56
2012-05-19,17,Saturday,Evening Rush,279,347,626,44.57
2012-05-19,18,Saturday,Evening Rush,254,391,645,39.38
2012-05-19,19,Saturday,Evening Rush,203,229,432,46.99
2012-05-19,20,Saturday,Night,118,197,315,37.46
2012-05-19,21,Saturday,Night,81,178,259,31.27
2012-05-19,22,Saturday,Night,104,234,338,30.77
2012-05-19,23,Saturday,Night,71,168,239,29.71
2012-05-20,0,Sunday,Early Morning,42,128,170,24.71
2012-05-20,1,Sunday,Early Morning,28,102,130,21.54
2012-05-20,2,Sunday,Early Morning,36,62,98,36.73
2012-05-20,3,Sunday,Early Morning,26,40,66,39.39
2012-05-20,4,Sunday,Early Morning,2,14,16,12.5
2012-05-20,5,Sunday,Early Morning,1,7,8,12.5
2012-05-20,6,Sunday,Morning Rush,4,21,25,16.0
2012-05-20,7,Sunday,Morning Rush,35,55,90,38.89
2012-05-20,8,Sunday,Morning Rush,51,120,171,29.82
2012-05-20,9,Sunday,Morning Rush,129,184,313,41.21
2012-05-20,10,Sunday,Mid-Day,174,258,432,40.28
2012-05-20,11,Sunday,Mid-Day,258,323,581,44.41
2012-05-20,12,Sunday,Mid-Day,247,390,637,38.78
2012-05-20,13,Sunday,Mid-Day,244,363,607,40.2
2012-05-20,14,Sunday,Mid-Day,236,307,543,43.46
2012-05-20,15,Sunday,Mid-Day,246,256,502,49.0
2012-05-20,16,Sunday,Evening Rush,238,339,577,41.25
2012-05-20,17,Sunday,Evening Rush,209,340,549,38.07
2012-05-20,18,Sunday,Evening Rush,146,328,474,30.8
2012-05-20,19,Sunday,Evening Rush,142,260,402,35.32
2012-05-20,20,Sunday,Night,83,191,274,30.29
2012-05-20,21,Sunday,Night,51,182,233,21.89
2012-05-20,22,Sunday,Night,44,101,145,30.34
2012-05-20,23,Sunday,Night,32,54,86,37.21
2012-05-21,0,Monday,Early Morning,12,28,40,30.0
2012-05-21,1,Monday,Early Morning,4,11,15,26.67
2012-05-21,2,Monday,Early Morning,2,9,11,18.18
2012-05-21,3,Monday,Early Morning,0,2,2,0.0
2012-05-21,4,Monday,Early Morning,2,5,7,28.57
2012-05-21,5,Monday,Early Morning,1,14,15,6.67
2012-05-21,6,Monday,Morning Rush,3,76,79,3.8
2012-05-21,7,Monday,Morning Rush,7,146,153,4.58
2012-05-21,8,Monday,Morning Rush,12,258,270,4.44
2012-05-21,9,Monday,Morning Rush,14,172,186,7.53
2012-05-21,10,Monday,Mid-Day,28,71,99,28.28
2012-05-21,11,Monday,Mid-Day,24,82,106,22.64
2012-05-21,12,Monday,Mid-Day,46,124,170,27.06
2012-05-21,13,Monday,Mid-Day,49,135,184,26.63
2012-05-21,14,Monday,Mid-Day,45,135,180,25.0
2012-05-21,15,Monday,Mid-Day,67,158,225,29.78
2012-05-21,16,Monday,Evening Rush,46,269,315,14.6
2012-05-21,17,Monday,Evening Rush,40,468,508,7.87
2012-05-21,18,Monday,Evening Rush,52,478,530,9.81
2012-05-21,19,Monday,Evening Rush,57,391,448,12.72
2012-05-21,20,Monday,Night,44,292,336,13.1
2012-05-21,21,Monday,Night,31,210,241,12.86
2012-05-21,22,Monday,Night,26,116,142,18.31
2012-05-21,23,Monday,Night,18,79,97,18.56
2012-05-22,0,Tuesday,Early Morning,10,26,36,27.78
2012-05-22,1,Tuesday,Early Morning,11,16,27,40.74
2012-05-22,2,Tuesday,Early Morning,1,10,11,9.09
2012-05-22,3,Tuesday,Early Morning,0,5,5,0.0
2012-05-22,4,Tuesday,Early Morning,0,7,7,0.0
2012-05-22,5,Tuesday,Early Morning,0,17,17,0.0
2012-05-22,6,Tuesday,Morning Rush,8,129,137,5.84
2012-05-22,7,Tuesday,Morning Rush,9,315,324,2.78
2012-05-22,8,Tuesday,Morning Rush,20,570,590,3.39
2012-05-22,9,Tuesday,Morning Rush,46,287,333,13.81
2012-05-22,10,Tuesday,Mid-Day,52,148,200,26.0
2012-05-22,11,Tuesday,Mid-Day,39,150,189,20.63
2012-05-22,12,Tuesday,Mid-Day,76,178,254,29.92
2012-05-22,13,Tuesday,Mid-Day,48,195,243,19.75
2012-05-22,14,Tuesday,Mid-Day,73,149,222,32.88
2012-05-22,15,Tuesday,Mid-Day,54,191,245,22.04
2012-05-22,16,Tuesday,Evening Rush,70,316,386,18.13
2012-05-22,17,Tuesday,Evening Rush,69,716,785,8.79
2012-05-22,18,Tuesday,Evening Rush,76,709,785,9.68
2012-05-22,19,Tuesday,Evening Rush,44,320,364,12.09
2012-05-22,20,Tuesday,Night,54,319,373,14.48
2012-05-22,21,Tuesday,Night,28,233,261,10.73
2012-05-22,22,Tuesday,Night,17,157,174,9.77
2012-05-22,23,Tuesday,Night,14,91,105,13.33
2012-05-23,0,Wednesday,Early Morning,19,28,47,40.43
2012-05-23,1,Wednesday,Early Morning,23,9,32,71.88
2012-05-23,2,Wednesday,Early Morning,2,10,12,16.67
2012-05-23,3,Wednesday,Early Morning,0,5,5,0.0
2012-05-23,4,Wednesday,Early Morning,0,3,3,0.0
2012-05-23,5,Wednesday,Early Morning,6,29,35,17.14
2012-05-23,6,Wednesday,Morning Rush,6,154,160,3.75
2012-05-23,7,Wednesday,Morning Rush,16,452,468,3.42
2012-05-23,8,Wednesday,Morning Rush,38,681,719,5.29
2012-05-23,9,Wednesday,Morning Rush,39,258,297,13.13
2012-05-23,10,Wednesday,Mid-Day,52,139,191,27.23
2012-05-23,11,Wednesday,Mid-Day,46,151,197,23.35
2012-05-23,12,Wednesday,Mid-Day,42,206,248,16.94
2012-05-23,13,Wednesday,Mid-Day,69,201,270,25.56
2012-05-23,14,Wednesday,Mid-Day,67,181,248,27.02
2012-05-23,15,Wednesday,Mid-Day,65,192,257,25.29
2012-05-23,16,Wednesday,Evening Rush,62,216,278,22.3
2012-05-23,17,Wednesday,Evening Rush,45,240,285,15.79
2012-05-23,18,Wednesday,Evening Rush,31,296,327,9.48
2012-05-23,19,Wednesday,Evening Rush,40,336,376,10.64
2012-05-23,20,Wednesday,Night,28,267,295,9.49
2012-05-23,21,Wednesday,Night,24,221,245,9.8
2012-05-23,22,Wednesday,Night,23,136,159,14.47
2012-05-23,23,Wednesday,Night,23,83,106,21.7
2012-05-24,0,Thursday,Early Morning,7,49,56,12.5
2012-05-24,1,Thursday,Early Morning,9,21,30,30.0
2012-05-24,2,Thursday,Early Morning,1,15,16,6.25
2012-05-24,3,Thursday,Early Morning,1,3,4,25.0
2012-05-24,4,Thursday,Early Morning,0,5,5,0.0
2012-05-24,5,Thursday,Early Morning,1,29,30,3.33
2012-05-24,6,Thursday,Morning Rush,10,146,156,6.41
2012-05-24,7,Thursday,Morning Rush,22,393,415,5.3
2012-05-24,8,Thursday,Morning Rush,33,659,692,4.77
2012-05-24,9,Thursday,Morning Rush,34,267,301,11.3
2012-05-24,10,Thursday,Mid-Day,47,138,185,25.41
2012-05-24,11,Thursday,Mid-Day,61,160,221,27.6
2012-05-24,12,Thursday,Mid-Day,76,213,289,26.3
2012-05-24,13,Thursday,Mid-Day,69,233,302,22.85
2012-05-24,14,Thursday,Mid-Day,72,180,252,28.57
2012-05-24,15,Thursday,Mid-Day,69,222,291,23.71
2012-05-24,16,Thursday,Evening Rush,61,329,390,15.64
2012-05-24,17,Thursday,Evening Rush,120,678,798,15.04
2012-05-24,18,Thursday,Evening Rush,118,634,752,15.69
2012-05-24,19,Thursday,Evening Rush,76,416,492,15.45
2012-05-24,20,Thursday,Night,55,343,398,13.82
2012-05-24,21,Thursday,Night,48,237,285,16.84
2012-05-24,22,Thursday,Night,33,210,243,13.58
2012-05-24,23,Thursday,Night,36,131,167,21.56
2012-05-25,0,Friday,Early Morning,10,63,73,13.7
2012-05-25,1,Friday,Early Morning,8,34,42,19.05
2012-05-25,2,Friday,Early Morning,7,16,23,30.43
2012-05-25,3,Friday,Early Morning,8,6,14,57.14
2012-05-25,4,Friday,Early Morning,3,6,9,33.33
2012-05-25,5,Friday,Early Morning,2,28,30,6.67
2012-05-25,6,Friday,Morning Rush,5,108,113,4.42
2012-05-25,7,Friday,Morning Rush,7,352,359,1.95
2012-05-25,8,Friday,Morning Rush,32,551,583,5.49
2012-05-25,9,Friday,Morning Rush,52,288,340,15.29
2012-05-25,10,Friday,Mid-Day,69,163,232,29.74
2012-05-25,11,Friday,Mid-Day,90,193,283,31.8
2012-05-25,12,Friday,Mid-Day,84,237,321,26.17
2012-05-25,13,Friday,Mid-Day,86,247,333,25.83
2012-05-25,14,Friday,Mid-Day,104,263,367,28.34
2012-05-25,15,Friday,Mid-Day,106,360,466,22.75
2012-05-25,16,Friday,Evening Rush,137,447,584,23.46
2012-05-25,17,Friday,Evening Rush,124,529,653,18.99
2012-05-25,18,Friday,Evening Rush,131,391,522,25.1
2012-05-25,19,Friday,Evening Rush,111,293,404,27.48
2012-05-25,20,Friday,Night,80,270,350,22.86
2012-05-25,21,Friday,Night,62,193,255,24.31
2012-05-25,22,Friday,Night,65,147,212,30.66
2012-05-25,23,Friday,Night,34,132,166,20.48
2012-05-26,0,Saturday,Early Morning,18,98,116,15.52
2012-05-26,1,Saturday,Early Morning,18,64,82,21.95
2012-05-26,2,Saturday,Early Morning,9,55,64,14.06
2012-05-26,3,Saturday,Early Morning,9,22,31,29.03
2012-05-26,4,Saturday,Early Morning,0,2,2,0.0
2012-05-26,5,Saturday,Early Morning,0,10,10,0.0
2012-05-26,6,Saturday,Morning Rush,6,25,31,19.35
2012-05-26,7,Saturday,Morning Rush,10,44,54,18.52
2012-05-26,8,Saturday,Morning Rush,38,103,141,26.95
2012-05-26,9,Saturday,Morning Rush,97,192,289,33.56
2012-05-26,10,Saturday,Mid-Day,181,256,437,41.42
2012-05-26,11,Saturday,Mid-Day,208,312,520,40.0
2012-05-26,12,Saturday,Mid-Day,236,293,529,44.61
2012-05-26,13,Saturday,Mid-Day,265,274,539,49.17
2012-05-26,14,Saturday,Mid-Day,307,257,564,54.43
2012-05-26,15,Saturday,Mid-Day,274,239,513,53.41
2012-05-26,16,Saturday,Evening Rush,261,243,504,51.79
2012-05-26,17,Saturday,Evening Rush,235,227,462,50.87
2012-05-26,18,Saturday,Evening Rush,199,216,415,47.95
2012-05-26,19,Saturday,Evening Rush,159,214,373,42.63
2012-05-26,20,Saturday,Night,103,152,255,40.39
2012-05-26,21,Saturday,Night,100,151,251,39.84
2012-05-26,22,Saturday,Night,86,118,204,42.16
2012-05-26,23,Saturday,Night,36,114,150,24.0
2012-05-27,0,Sunday,Early Morning,48,89,137,35.04
2012-05-27,1,Sunday,Early Morning,17,61,78,21.79
2012-05-27,2,Sunday,Early Morning,16,45,61,26.23
2012-05-27,3,Sunday,Early Morning,11,25,36,30.56
2012-05-27,4,Sunday,Early Morning,4,7,11,36.36
2012-05-27,5,Sunday,Early Morning,2,5,7,28.57
2012-05-27,6,Sunday,Morning Rush,8,14,22,36.36
2012-05-27,7,Sunday,Morning Rush,22,30,52,42.31
2012-05-27,8,Sunday,Morning Rush,69,82,151,45.7
2012-05-27,9,Sunday,Morning Rush,130,140,270,48.15
2012-05-27,10,Sunday,Mid-Day,209,215,424,49.29
2012-05-27,11,Sunday,Mid-Day,268,251,519,51.64
2012-05-27,12,Sunday,Mid-Day,301,269,570,52.81
2012-05-27,13,Sunday,Mid-Day,270,228,498,54.22
2012-05-27,14,Sunday,Mid-Day,317,230,547,57.95
2012-05-27,15,Sunday,Mid-Day,290,245,535,54.21
2012-05-27,16,Sunday,Evening Rush,258,243,501,51.5
2012-05-27,17,Sunday,Evening Rush,275,247,522,52.68
2012-05-27,18,Sunday,Evening Rush,266,252,518,51.35
2012-05-27,19,Sunday,Evening Rush,230,212,442,52.04
2012-05-27,20,Sunday,Night,168,224,392,42.86
2012-05-27,21,Sunday,Night,64,79,143,44.76
2012-05-27,22,Sunday,Night,9,50,59,15.25
2012-05-27,23,Sunday,Night,31,65,96,32.29
2012-05-28,0,Monday,Early Morning,21,44,65,32.31
2012-05-28,1,Monday,Early Morning,14,45,59,23.73
2012-05-28,2,Monday,Early Morning,20,28,48,41.67
2012-05-28,3,Monday,Early Morning,6,12,18,33.33
2012-05-28,4,Monday,Early Morning,2,4,6,33.33
2012-05-28,5,Monday,Early Morning,4,5,9,44.44
2012-05-28,6,Monday,Morning Rush,6,14,20,30.0
2012-05-28,7,Monday,Morning Rush,24,43,67,35.82
2012-05-28,8,Monday,Morning Rush,62,93,155,40.0
2012-05-28,9,Monday,Morning Rush,121,142,263,46.01
2012-05-28,10,Monday,Mid-Day,189,175,364,51.92
2012-05-28,11,Monday,Mid-Day,254,222,476,53.36
2012-05-28,12,Monday,Mid-Day,233,292,525,44.38
2012-05-28,13,Monday,Mid-Day,272,284,556,48.92
2012-05-28,14,Monday,Mid-Day,238,227,465,51.18
2012-05-28,15,Monday,Mid-Day,181,279,460,39.35
2012-05-28,16,Monday,Evening Rush,223,278,501,44.51
2012-05-28,17,Monday,Evening Rush,158,247,405,39.01
2012-05-28,18,Monday,Evening Rush,132,251,383,34.46
2012-05-28,19,Monday,Evening Rush,148,247,395,37.47
2012-05-28,20,Monday,Night,114,203,317,35.96
2012-05-28,21,Monday,Night,66,181,247,26.72
2012-05-28,22,Monday,Night,47,110,157,29.94
2012-05-28,23,Monday,Night,22,60,82,26.83
2012-05-29,0,Tuesday,Early Morning,12,33,45,26.67
2012-05-29,1,Tuesday,Early Morning,1,13,14,7.14
2012-05-29,2,Tuesday,Early Morning,0,8,8,0.0
2012-05-29,3,Tuesday,Early Morning,1,2,3,33.33
2012-05-29,4,Tuesday,Early Morning,0,5,5,0.0
2012-05-29,5,Tuesday,Early Morning,1,32,33,3.03
2012-05-29,6,Tuesday,Morning Rush,9,145,154,5.84
2012-05-29,7,Tuesday,Morning Rush,19,431,450,4.22
2012-05-29,8,Tuesday,Morning Rush,46,588,634,7.26
2012-05-29,9,Tuesday,Morning Rush,26,231,257,10.12
2012-05-29,10,Tuesday,Mid-Day,67,116,183,36.61
2012-05-29,11,Tuesday,Mid-Day,50,147,197,25.38
2012-05-29,12,Tuesday,Mid-Day,56,181,237,23.63
2012-05-29,13,Tuesday,Mid-Day,63,176,239,26.36
2012-05-29,14,Tuesday,Mid-Day,80,158,238,33.61
2012-05-29,15,Tuesday,Mid-Day,71,185,256,27.73
2012-05-29,16,Tuesday,Evening Rush,73,320,393,18.58
2012-05-29,17,Tuesday,Evening Rush,107,674,781,13.7
2012-05-29,18,Tuesday,Evening Rush,78,632,710,10.99
2012-05-29,19,Tuesday,Evening Rush,69,457,526,13.12
2012-05-29,20,Tuesday,Night,36,168,204,17.65
2012-05-29,21,Tuesday,Night,3,68,71,4.23
2012-05-29,22,Tuesday,Night,2,53,55,3.64
2012-05-29,23,Tuesday,Night,10,40,50,20.0
2012-05-30,0,Wednesday,Early Morning,4,32,36,11.11
2012-05-30,1,Wednesday,Early Morning,0,4,4,0.0
2012-05-30,2,Wednesday,Early Morning,1,4,5,20.0
2012-05-30,3,Wednesday,Early Morning,0,5,5,0.0
2012-05-30,4,Wednesday,Early Morning,0,6,6,0.0
2012-05-30,5,Wednesday,Early Morning,1,40,41,2.44
2012-05-30,6,Wednesday,Morning Rush,5,139,144,3.47
2012-05-30,7,Wednesday,Morning Rush,14,469,483,2.9
2012-05-30,8,Wednesday,Morning Rush,29,642,671,4.32
2012-05-30,9,Wednesday,Morning Rush,23,282,305,7.54
2012-05-30,10,Wednesday,Mid-Day,39,138,177,22.03
2012-05-30,11,Wednesday,Mid-Day,53,155,208,25.48
2012-05-30,12,Wednesday,Mid-Day,33,220,253,13.04
2012-05-30,13,Wednesday,Mid-Day,53,236,289,18.34
2012-05-30,14,Wednesday,Mid-Day,44,208,252,17.46
2012-05-30,15,Wednesday,Mid-Day,54,221,275,19.64
2012-05-30,16,Wednesday,Evening Rush,46,352,398,11.56
2012-05-30,17,Wednesday,Evening Rush,83,756,839,9.89
2012-05-30,18,Wednesday,Evening Rush,50,746,796,6.28
2012-05-30,19,Wednesday,Evening Rush,50,506,556,8.99
2012-05-30,20,Wednesday,Night,57,374,431,13.23
2012-05-30,21,Wednesday,Night,41,263,304,13.49
2012-05-30,22,Wednesday,Night,26,191,217,11.98
2012-05-30,23,Wednesday,Night,39,121,160,24.38
2012-05-31,0,Thursday,Early Morning,13,48,61,21.31
2012-05-31,1,Thursday,Early Morning,4,22,26,15.38
2012-05-31,2,Thursday,Early Morning,6,8,14,42.86
2012-05-31,3,Thursday,Early Morning,0,8,8,0.0
2012-05-31,4,Thursday,Early Morning,0,8,8,0.0
2012-05-31,5,Thursday,Early Morning,1,32,33,3.03
2012-05-31,6,Thursday,Morning Rush,7,171,178,3.93
2012-05-31,7,Thursday,Morning Rush,18,489,507,3.55
2012-05-31,8,Thursday,Morning Rush,18,675,693,2.6
2012-05-31,9,Thursday,Morning Rush,47,264,311,15.11
2012-05-31,10,Thursday,Mid-Day,65,155,220,29.55
2012-05-31,11,Thursday,Mid-Day,65,153,218,29.82
2012-05-31,12,Thursday,Mid-Day,62,230,292,21.23
2012-05-31,13,Thursday,Mid-Day,77,216,293,26.28
2012-05-31,14,Thursday,Mid-Day,61,193,254,24.02
2012-05-31,15,Thursday,Mid-Day,81,209,290,27.93
2012-05-31,16,Thursday,Evening Rush,103,384,487,21.15
2012-05-31,17,Thursday,Evening Rush,85,742,827,10.28
2012-05-31,18,Thursday,Evening Rush,85,700,785,10.83
2012-05-31,19,Thursday,Evening Rush,104,487,591,17.6
2012-05-31,20,Thursday,Night,88,391,479,18.37
2012-05-31,21,Thursday,Night,41,318,359,11.42
2012-05-31,22,Thursday,Night,43,221,264,16.29
2012-05-31,23,Thursday,Night,26,114,140,18.57
2012-06-01,0,Friday,Early Morning,10,76,86,11.63
2012-06-01,1,Friday,Early Morning,0,34,34,0.0
2012-06-01,2,Friday,Early Morning,3,13,16,18.75
2012-06-01,3,Friday,Early Morning,0,4,4,0.0
2012-06-01,4,Friday,Early Morning,1,5,6,16.67
2012-06-01,5,Friday,Early Morning,4,41,45,8.89
2012-06-01,6,Friday,Morning Rush,5,136,141,3.55
2012-06-01,7,Friday,Morning Rush,33,369,402,8.21
2012-06-01,8,Friday,Morning Rush,19,675,694,2.74
2012-06-01,9,Friday,Morning Rush,24,274,298,8.05
2012-06-01,10,Friday,Mid-Day,49,155,204,24.02
2012-06-01,11,Friday,Mid-Day,42,193,235,17.87
2012-06-01,12,Friday,Mid-Day,72,238,310,23.23
2012-06-01,13,Friday,Mid-Day,76,240,316,24.05
2012-06-01,14,Friday,Mid-Day,55,199,254,21.65
2012-06-01,15,Friday,Mid-Day,45,213,258,17.44
2012-06-01,16,Friday,Evening Rush,36,186,222,16.22
2012-06-01,17,Friday,Evening Rush,25,202,227,11.01
2012-06-01,18,Friday,Evening Rush,10,100,110,9.09
2012-06-01,19,Friday,Evening Rush,4,41,45,8.89
2012-06-01,20,Friday,Night,1,38,39,2.56
2012-06-01,21,Friday,Night,12,73,85,14.12
2012-06-01,22,Friday,Night,1,22,23,4.35
2012-06-01,23,Friday,Night,6,67,73,8.22
2012-06-02,0,Saturday,Early Morning,5,81,86,5.81
2012-06-02,1,Saturday,Early Morning,15,61,76,19.74
2012-06-02,2,Saturday,Early Morning,3,38,41,7.32
2012-06-02,3,Saturday,Early Morning,8,18,26,30.77
2012-06-02,4,Saturday,Early Morning,2,11,13,15.38
2012-06-02,5,Saturday,Early Morning,1,11,12,8.33
2012-06-02,6,Saturday,Morning Rush,5,31,36,13.89
2012-06-02,7,Saturday,Morning Rush,9,77,86,10.47
2012-06-02,8,Saturday,Morning Rush,30,180,210,14.29
2012-06-02,9,Saturday,Morning Rush,89,243,332,26.81
2012-06-02,10,Saturday,Mid-Day,145,348,493,29.41
2012-06-02,11,Saturday,Mid-Day,179,357,536,33.4
2012-06-02,12,Saturday,Mid-Day,250,418,668,37.43
2012-06-02,13,Saturday,Mid-Day,279,400,679,41.09
2012-06-02,14,Saturday,Mid-Day,259,388,647,40.03
2012-06-02,15,Saturday,Mid-Day,297,405,702,42.31
2012-06-02,16,Saturday,Evening Rush,275,369,644,42.7
2012-06-02,17,Saturday,Evening Rush,248,338,586,42.32
2012-06-02,18,Saturday,Evening Rush,171,341,512,33.4
2012-06-02,19,Saturday,Evening Rush,185,369,554,33.39
2012-06-02,20,Saturday,Night,139,260,399,34.84
2012-06-02,21,Saturday,Night,96,220,316,30.38
2012-06-02,22,Saturday,Night,52,176,228,22.81
2012-06-02,23,Saturday,Night,53,185,238,22.27
2012-06-03,0,Sunday,Early Morning,27,142,169,15.98
2012-06-03,1,Sunday,Early Morning,21,100,121,17.36
2012-06-03,2,Sunday,Early Morning,22,67,89,24.72
2012-06-03,3,Sunday,Early Morning,16,34,50,32.0
2012-06-03,4,Sunday,Early Morning,1,12,13,7.69
2012-06-03,5,Sunday,Early Morning,1,11,12,8.33
2012-06-03,6,Sunday,Morning Rush,6,16,22,27.27
2012-06-03,7,Sunday,Morning Rush,6,29,35,17.14
2012-06-03,8,Sunday,Morning Rush,30,110,140,21.43
2012-06-03,9,Sunday,Morning Rush,70,230,300,23.33
2012-06-03,10,Sunday,Mid-Day,127,277,404,31.44
2012-06-03,11,Sunday,Mid-Day,199,312,511,38.94
2012-06-03,12,Sunday,Mid-Day,276,408,684,40.35
2012-06-03,13,Sunday,Mid-Day,265,421,686,38.63
2012-06-03,14,Sunday,Mid-Day,267,411,678,39.38
2012-06-03,15,Sunday,Mid-Day,236,408,644,36.65
2012-06-03,16,Sunday,Evening Rush,226,436,662,34.14
2012-06-03,17,Sunday,Evening Rush,192,386,578,33.22
2012-06-03,18,Sunday,Evening Rush,153,343,496,30.85
2012-06-03,19,Sunday,Evening Rush,116,337,453,25.61
2012-06-03,20,Sunday,Night,84,230,314,26.75
2012-06-03,21,Sunday,Night,66,180,246,26.83
2012-06-03,22,Sunday,Night,61,165,226,26.99
2012-06-03,23,Sunday,Night,26,82,108,24.07
2012-06-04,0,Monday,Early Morning,11,38,49,22.45
2012-06-04,1,Monday,Early Morning,4,10,14,28.57
2012-06-04,2,Monday,Early Morning,1,10,11,9.09
2012-06-04,3,Monday,Early Morning,0,5,5,0.0
2012-06-04,4,Monday,Early Morning,2,6,8,25.0
2012-06-04,5,Monday,Early Morning,2,33,35,5.71
2012-06-04,6,Monday,Morning Rush,4,135,139,2.88
2012-06-04,7,Monday,Morning Rush,13,504,517,2.51
2012-06-04,8,Monday,Morning Rush,22,643,665,3.31
2012-06-04,9,Monday,Morning Rush,38,244,282,13.48
2012-06-04,10,Monday,Mid-Day,67,120,187,35.83
2012-06-04,11,Monday,Mid-Day,71,168,239,29.71
2012-06-04,12,Monday,Mid-Day,62,220,282,21.99
2012-06-04,13,Monday,Mid-Day,85,189,274,31.02
2012-06-04,14,Monday,Mid-Day,84,186,270,31.11
2012-06-04,15,Monday,Mid-Day,77,215,292,26.37
2012-06-04,16,Monday,Evening Rush,73,375,448,16.29
2012-06-04,17,Monday,Evening Rush,101,733,834,12.11
2012-06-04,18,Monday,Evening Rush,103,719,822,12.53
2012-06-04,19,Monday,Evening Rush,91,554,645,14.11
2012-06-04,20,Monday,Night,71,390,461,15.4
2012-06-04,21,Monday,Night,40,225,265,15.09
2012-06-04,22,Monday,Night,41,127,168,24.4
2012-06-04,23,Monday,Night,8,78,86,9.3
2012-06-05,0,Tuesday,Early Morning,6,28,34,17.65
2012-06-05,1,Tuesday,Early Morning,2,18,20,10.0
2012-06-05,2,Tuesday,Early Morning,0,8,8,0.0
2012-06-05,3,Tuesday,Early Morning,0,5,5,0.0
2012-06-05,4,Tuesday,Early Morning,1,4,5,20.0
2012-06-05,5,Tuesday,Early Morning,1,35,36,2.78
2012-06-05,6,Tuesday,Morning Rush,7,177,184,3.8
2012-06-05,7,Tuesday,Morning Rush,29,540,569,5.1
2012-06-05,8,Tuesday,Morning Rush,30,680,710,4.23
2012-06-05,9,Tuesday,Morning Rush,50,285,335,14.93
2012-06-05,10,Tuesday,Mid-Day,58,118,176,32.95
2012-06-05,11,Tuesday,Mid-Day,65,162,227,28.63
2012-06-05,12,Tuesday,Mid-Day,45,202,247,18.22
2012-06-05,13,Tuesday,Mid-Day,66,201,267,24.72
2012-06-05,14,Tuesday,Mid-Day,82,194,276,29.71
2012-06-05,15,Tuesday,Mid-Day,54,218,272,19.85
2012-06-05,16,Tuesday,Evening Rush,91,382,473,19.24
2012-06-05,17,Tuesday,Evening Rush,86,764,850,10.12
2012-06-05,18,Tuesday,Evening Rush,111,679,790,14.05
2012-06-05,19,Tuesday,Evening Rush,68,445,513,13.26
2012-06-05,20,Tuesday,Night,44,371,415,10.6
2012-06-05,21,Tuesday,Night,30,253,283,10.6
2012-06-05,22,Tuesday,Night,22,171,193,11.4
2012-06-05,23,Tuesday,Night,20,93,113,17.7
2012-06-06,0,Wednesday,Early Morning,3,46,49,6.12
2012-06-06,1,Wednesday,Early Morning,6,21,27,22.22
2012-06-06,2,Wednesday,Early Morning,4,7,11,36.36
2012-06-06,3,Wednesday,Early Morning,0,8,8,0.0
2012-06-06,4,Wednesday,Early Morning,3,7,10,30.0
2012-06-06,5,Wednesday,Early Morning,1,37,38,2.63
2012-06-06,6,Wednesday,Morning Rush,7,165,172,4.07
2012-06-06,7,Wednesday,Morning Rush,16,531,547,2.93
2012-06-06,8,Wednesday,Morning Rush,31,637,668,4.64
2012-06-06,9,Wednesday,Morning Rush,35,268,303,11.55
2012-06-06,10,Wednesday,Mid-Day,55,148,203,27.09
2012-06-06,11,Wednesday,Mid-Day,65,161,226,28.76
2012-06-06,12,Wednesday,Mid-Day,80,235,315,25.4
2012-06-06,13,Wednesday,Mid-Day,73,230,303,24.09
2012-06-06,14,Wednesday,Mid-Day,111,191,302,36.75
2012-06-06,15,Wednesday,Mid-Day,75,225,300,25.0
2012-06-06,16,Wednesday,Evening Rush,107,345,452,23.67
2012-06-06,17,Wednesday,Evening Rush,72,652,724,9.94
2012-06-06,18,Wednesday,Evening Rush,94,688,782,12.02
2012-06-06,19,Wednesday,Evening Rush,52,486,538,9.67
2012-06-06,20,Wednesday,Night,59,349,408,14.46
2012-06-06,21,Wednesday,Night,38,260,298,12.75
2012-06-06,22,Wednesday,Night,27,221,248,10.89
2012-06-06,23,Wednesday,Night,13,110,123,10.57
2012-06-07,0,Thursday,Early Morning,9,50,59,15.25
2012-06-07,1,Thursday,Early Morning,5,17,22,22.73
2012-06-07,2,Thursday,Early Morning,0,12,12,0.0
2012-06-07,3,Thursday,Early Morning,0,5,5,0.0
2012-06-07,4,Thursday,Early Morning,0,6,6,0.0
2012-06-07,5,Thursday,Early Morning,0,34,34,0.0
2012-06-07,6,Thursday,Morning Rush,5,165,170,2.94
2012-06-07,7,Thursday,Morning Rush,20,506,526,3.8
2012-06-07,8,Thursday,Morning Rush,20,661,681,2.94
2012-06-07,9,Thursday,Morning Rush,37,300,337,10.98
2012-06-07,10,Thursday,Mid-Day,56,154,210,26.67
2012-06-07,11,Thursday,Mid-Day,67,170,237,28.27
2012-06-07,12,Thursday,Mid-Day,62,274,336,18.45
2012-06-07,13,Thursday,Mid-Day,65,250,315,20.63
2012-06-07,14,Thursday,Mid-Day,67,198,265,25.28
2012-06-07,15,Thursday,Mid-Day,99,234,333,29.73
2012-06-07,16,Thursday,Evening Rush,77,389,466,16.52
2012-06-07,17,Thursday,Evening Rush,91,778,869,10.47
2012-06-07,18,Thursday,Evening Rush,110,703,813,13.53
2012-06-07,19,Thursday,Evening Rush,65,537,602,10.8
2012-06-07,20,Thursday,Night,76,402,478,15.9
2012-06-07,21,Thursday,Night,30,283,313,9.58
2012-06-07,22,Thursday,Night,35,193,228,15.35
2012-06-07,23,Thursday,Night,42,135,177,23.73
2012-06-08,0,Friday,Early Morning,18,59,77,23.38
2012-06-08,1,Friday,Early Morning,4,25,29,13.79
2012-06-08,2,Friday,Early Morning,2,17,19,10.53
2012-06-08,3,Friday,Early Morning,0,8,8,0.0
2012-06-08,4,Friday,Early Morning,1,9,10,10.0
2012-06-08,5,Friday,Early Morning,1,28,29,3.45
2012-06-08,6,Friday,Morning Rush,8,131,139,5.76
2012-06-08,7,Friday,Morning Rush,19,409,428,4.44
2012-06-08,8,Friday,Morning Rush,37,663,700,5.29
2012-06-08,9,Friday,Morning Rush,47,335,382,12.3
2012-06-08,10,Friday,Mid-Day,62,187,249,24.9
2012-06-08,11,Friday,Mid-Day,65,199,264,24.62
2012-06-08,12,Friday,Mid-Day,89,280,369,24.12
2012-06-08,13,Friday,Mid-Day,129,287,416,31.01
2012-06-08,14,Friday,Mid-Day,128,245,373,34.32
2012-06-08,15,Friday,Mid-Day,98,299,397,24.69
2012-06-08,16,Friday,Evening Rush,111,412,523,21.22
2012-06-08,17,Friday,Evening Rush,114,679,793,14.38
2012-06-08,18,Friday,Evening Rush,147,576,723,20.33
2012-06-08,19,Friday,Evening Rush,95,460,555,17.12
2012-06-08,20,Friday,Night,117,291,408,28.68
2012-06-08,21,Friday,Night,83,256,339,24.48
2012-06-08,22,Friday,Night,61,230,291,20.96
2012-06-08,23,Friday,Night,52,163,215,24.19
2012-06-09,0,Saturday,Early Morning,54,152,206,26.21
2012-06-09,1,Saturday,Early Morning,34,89,123,27.64
2012-06-09,2,Saturday,Early Morning,21,68,89,23.6
2012-06-09,3,Saturday,Early Morning,12,28,40,30.0
2012-06-09,4,Saturday,Early Morning,2,6,8,25.0
2012-06-09,5,Saturday,Early Morning,4,15,19,21.05
2012-06-09,6,Saturday,Morning Rush,17,63,80,21.25
2012-06-09,7,Saturday,Morning Rush,26,61,87,29.89
2012-06-09,8,Saturday,Morning Rush,42,202,244,17.21
2012-06-09,9,Saturday,Morning Rush,99,241,340,29.12
2012-06-09,10,Saturday,Mid-Day,168,298,466,36.05
2012-06-09,11,Saturday,Mid-Day,218,351,569,38.31
2012-06-09,12,Saturday,Mid-Day,196,335,531,36.91
2012-06-09,13,Saturday,Mid-Day,236,349,585,40.34
2012-06-09,14,Saturday,Mid-Day,239,354,593,40.3
2012-06-09,15,Saturday,Mid-Day,218,337,555,39.28
2012-06-09,16,Saturday,Evening Rush,219,315,534,41.01
2012-06-09,17,Saturday,Evening Rush,238,257,495,48.08
2012-06-09,18,Saturday,Evening Rush,175,276,451,38.8
2012-06-09,19,Saturday,Evening Rush,128,232,360,35.56
2012-06-09,20,Saturday,Night,125,238,363,34.44
2012-06-09,21,Saturday,Night,105,211,316,33.23
2012-06-09,22,Saturday,Night,63,151,214,29.44
2012-06-09,23,Saturday,Night,69,161,230,30.0
2012-06-10,0,Sunday,Early Morning,33,125,158,20.89
2012-06-10,1,Sunday,Early Morning,32,84,116,27.59
2012-06-10,2,Sunday,Early Morning,17,56,73,23.29
2012-06-10,3,Sunday,Early Morning,6,23,29,20.69
2012-06-10,4,Sunday,Early Morning,1,9,10,10.0
2012-06-10,5,Sunday,Early Morning,3,10,13,23.08
2012-06-10,6,Sunday,Morning Rush,3,27,30,10.0
2012-06-10,7,Sunday,Morning Rush,21,41,62,33.87
2012-06-10,8,Sunday,Morning Rush,59,122,181,32.6
2012-06-10,9,Sunday,Morning Rush,91,175,266,34.21
2012-06-10,10,Sunday,Mid-Day,148,265,413,35.84
2012-06-10,11,Sunday,Mid-Day,184,315,499,36.87
2012-06-10,12,Sunday,Mid-Day,173,329,502,34.46
2012-06-10,13,Sunday,Mid-Day,204,288,492,41.46
2012-06-10,14,Sunday,Mid-Day,186,314,500,37.2
2012-06-10,15,Sunday,Mid-Day,159,316,475,33.47
2012-06-10,16,Sunday,Evening Rush,173,335,508,34.06
2012-06-10,17,Sunday,Evening Rush,184,337,521,35.32
2012-06-10,18,Sunday,Evening Rush,164,326,490,33.47
2012-06-10,19,Sunday,Evening Rush,115,260,375,30.67
2012-06-10,20,Sunday,Night,113,250,363,31.13
2012-06-10,21,Sunday,Night,83,170,253,32.81
2012-06-10,22,Sunday,Night,42,117,159,26.42
2012-06-10,23,Sunday,Night,30,80,110,27.27
2012-06-11,0,Monday,Early Morning,8,33,41,19.51
2012-06-11,1,Monday,Early Morning,9,15,24,37.5
2012-06-11,2,Monday,Early Morning,5,12,17,29.41
2012-06-11,3,Monday,Early Morning,2,4,6,33.33
2012-06-11,4,Monday,Early Morning,0,7,7,0.0
2012-06-11,5,Monday,Early Morning,1,36,37,2.7
2012-06-11,6,Monday,Morning Rush,8,136,144,5.56
2012-06-11,7,Monday,Morning Rush,25,478,503,4.97
2012-06-11,8,Monday,Morning Rush,38,613,651,5.84
2012-06-11,9,Monday,Morning Rush,57,259,316,18.04
2012-06-11,10,Monday,Mid-Day,52,95,147,35.37
2012-06-11,11,Monday,Mid-Day,59,143,202,29.21
2012-06-11,12,Monday,Mid-Day,63,198,261,24.14
2012-06-11,13,Monday,Mid-Day,63,185,248,25.4
2012-06-11,14,Monday,Mid-Day,66,193,259,25.48
2012-06-11,15,Monday,Mid-Day,72,187,259,27.8
2012-06-11,16,Monday,Evening Rush,87,340,427,20.37
2012-06-11,17,Monday,Evening Rush,85,715,800,10.63
2012-06-11,18,Monday,Evening Rush,105,726,831,12.64
2012-06-11,19,Monday,Evening Rush,89,507,596,14.93
2012-06-11,20,Monday,Night,61,333,394,15.48
2012-06-11,21,Monday,Night,32,218,250,12.8
2012-06-11,22,Monday,Night,22,142,164,13.41
2012-06-11,23,Monday,Night,8,72,80,10.0
2012-06-12,0,Tuesday,Early Morning,2,26,28,7.14
2012-06-12,1,Tuesday,Early Morning,5,11,16,31.25
2012-06-12,2,Tuesday,Early Morning,0,6,6,0.0
2012-06-12,3,Tuesday,Early Morning,3,9,12,25.0
2012-06-12,4,Tuesday,Early Morning,0,4,4,0.0
2012-06-12,5,Tuesday,Early Morning,1,28,29,3.45
2012-06-12,6,Tuesday,Morning Rush,6,130,136,4.41
2012-06-12,7,Tuesday,Morning Rush,16,287,303,5.28
2012-06-12,8,Tuesday,Morning Rush,15,598,613,2.45
2012-06-12,9,Tuesday,Morning Rush,31,254,285,10.88
2012-06-12,10,Tuesday,Mid-Day,29,96,125,23.2
2012-06-12,11,Tuesday,Mid-Day,8,57,65,12.31
2012-06-12,12,Tuesday,Mid-Day,19,76,95,20.0
2012-06-12,13,Tuesday,Mid-Day,11,48,59,18.64
2012-06-12,14,Tuesday,Mid-Day,12,48,60,20.0
2012-06-12,15,Tuesday,Mid-Day,22,94,116,18.97
2012-06-12,16,Tuesday,Evening Rush,30,209,239,12.55
2012-06-12,17,Tuesday,Evening Rush,56,625,681,8.22
2012-06-12,18,Tuesday,Evening Rush,57,596,653,8.73
2012-06-12,19,Tuesday,Evening Rush,47,444,491,9.57
2012-06-12,20,Tuesday,Night,36,350,386,9.33
2012-06-12,21,Tuesday,Night,41,233,274,14.96
2012-06-12,22,Tuesday,Night,19,188,207,9.18
2012-06-12,23,Tuesday,Night,11,78,89,12.36
2012-06-13,0,Wednesday,Early Morning,7,27,34,20.59
2012-06-13,1,Wednesday,Early Morning,7,21,28,25.0
2012-06-13,2,Wednesday,Early Morning,0,4,4,0.0
2012-06-13,3,Wednesday,Early Morning,1,7,8,12.5
2012-06-13,4,Wednesday,Early Morning,1,9,10,10.0
2012-06-13,5,Wednesday,Early Morning,2,38,40,5.0
2012-06-13,6,Wednesday,Morning Rush,6,188,194,3.09
2012-06-13,7,Wednesday,Morning Rush,25,480,505,4.95
2012-06-13,8,Wednesday,Morning Rush,41,672,713,5.75
2012-06-13,9,Wednesday,Morning Rush,54,298,352,15.34
2012-06-13,10,Wednesday,Mid-Day,64,134,198,32.32
2012-06-13,11,Wednesday,Mid-Day,64,182,246,26.02
2012-06-13,12,Wednesday,Mid-Day,93,241,334,27.84
2012-06-13,13,Wednesday,Mid-Day,52,203,255,20.39
2012-06-13,14,Wednesday,Mid-Day,98,222,320,30.63
2012-06-13,15,Wednesday,Mid-Day,65,216,281,23.13
2012-06-13,16,Wednesday,Evening Rush,72,320,392,18.37
2012-06-13,17,Wednesday,Evening Rush,75,782,857,8.75
2012-06-13,18,Wednesday,Evening Rush,104,640,744,13.98
2012-06-13,19,Wednesday,Evening Rush,123,548,671,18.33
2012-06-13,20,Wednesday,Night,86,362,448,19.2
2012-06-13,21,Wednesday,Night,79,317,396,19.95
2012-06-13,22,Wednesday,Night,29,209,238,12.18
2012-06-13,23,Wednesday,Night,25,128,153,16.34
2012-06-14,0,Thursday,Early Morning,3,45,48,6.25
2012-06-14,1,Thursday,Early Morning,4,17,21,19.05
2012-06-14,2,Thursday,Early Morning,1,8,9,11.11
2012-06-14,3,Thursday,Early Morning,1,4,5,20.0
2012-06-14,4,Thursday,Early Morning,0,6,6,0.0
2012-06-14,5,Thursday,Early Morning,0,40,40,0.0
2012-06-14,6,Thursday,Morning Rush,12,169,181,6.63
2012-06-14,7,Thursday,Morning Rush,26,480,506,5.14
2012-06-14,8,Thursday,Morning Rush,37,682,719,5.15
2012-06-14,9,Thursday,Morning Rush,45,312,357,12.61
2012-06-14,10,Thursday,Mid-Day,47,132,179,26.26
2012-06-14,11,Thursday,Mid-Day,60,168,228,26.32
2012-06-14,12,Thursday,Mid-Day,55,210,265,20.75
2012-06-14,13,Thursday,Mid-Day,71,213,284,25.0
2012-06-14,14,Thursday,Mid-Day,84,214,298,28.19
2012-06-14,15,Thursday,Mid-Day,111,213,324,34.26
2012-06-14,16,Thursday,Evening Rush,70,368,438,15.98
2012-06-14,17,Thursday,Evening Rush,117,750,867,13.49
2012-06-14,18,Thursday,Evening Rush,107,716,823,13.0
2012-06-14,19,Thursday,Evening Rush,96,483,579,16.58
2012-06-14,20,Thursday,Night,84,351,435,19.31
2012-06-14,21,Thursday,Night,67,270,337,19.88
2012-06-14,22,Thursday,Night,46,196,242,19.01
2012-06-14,23,Thursday,Night,36,136,172,20.93
2012-06-15,0,Friday,Early Morning,26,68,94,27.66
2012-06-15,1,Friday,Early Morning,9,42,51,17.65
2012-06-15,2,Friday,Early Morning,0,15,15,0.0
2012-06-15,3,Friday,Early Morning,2,3,5,40.0
2012-06-15,4,Friday,Early Morning,1,13,14,7.14
2012-06-15,5,Friday,Early Morning,2,31,33,6.06
2012-06-15,6,Friday,Morning Rush,9,142,151,5.96
2012-06-15,7,Friday,Morning Rush,17,413,430,3.95
2012-06-15,8,Friday,Morning Rush,44,609,653,6.74
2012-06-15,9,Friday,Morning Rush,58,308,366,15.85
2012-06-15,10,Friday,Mid-Day,56,160,216,25.93
2012-06-15,11,Friday,Mid-Day,106,180,286,37.06
2012-06-15,12,Friday,Mid-Day,111,292,403,27.54
2012-06-15,13,Friday,Mid-Day,121,272,393,30.79
2012-06-15,14,Friday,Mid-Day,121,255,376,32.18
2012-06-15,15,Friday,Mid-Day,107,270,377,28.38
2012-06-15,16,Friday,Evening Rush,132,426,558,23.66
2012-06-15,17,Friday,Evening Rush,125,698,823,15.19
2012-06-15,18,Friday,Evening Rush,121,572,693,17.46
2012-06-15,19,Friday,Evening Rush,98,369,467,20.99
2012-06-15,20,Friday,Night,89,296,385,23.12
2012-06-15,21,Friday,Night,83,250,333,24.92
2012-06-15,22,Friday,Night,79,242,321,24.61
2012-06-15,23,Friday,Night,46,176,222,20.72
2012-06-16,0,Saturday,Early Morning,25,112,137,18.25
2012-06-16,1,Saturday,Early Morning,16,79,95,16.84
2012-06-16,2,Saturday,Early Morning,12,55,67,17.91
2012-06-16,3,Saturday,Early Morning,8,19,27,29.63
2012-06-16,4,Saturday,Early Morning,3,5,8,37.5
2012-06-16,5,Saturday,Early Morning,2,21,23,8.7
2012-06-16,6,Saturday,Morning Rush,11,36,47,23.4
2012-06-16,7,Saturday,Morning Rush,10,68,78,12.82
2012-06-16,8,Saturday,Morning Rush,47,157,204,23.04
2012-06-16,9,Saturday,Morning Rush,88,279,367,23.98
2012-06-16,10,Saturday,Mid-Day,139,296,435,31.95
2012-06-16,11,Saturday,Mid-Day,213,353,566,37.63
2012-06-16,12,Saturday,Mid-Day,254,349,603,42.12
2012-06-16,13,Saturday,Mid-Day,293,324,617,47.49
2012-06-16,14,Saturday,Mid-Day,264,309,573,46.07
2012-06-16,15,Saturday,Mid-Day,295,288,583,50.6
2012-06-16,16,Saturday,Evening Rush,238,304,542,43.91
2012-06-16,17,Saturday,Evening Rush,244,349,593,41.15
2012-06-16,18,Saturday,Evening Rush,256,315,571,44.83
2012-06-16,19,Saturday,Evening Rush,184,277,461,39.91
2012-06-16,20,Saturday,Night,123,229,352,34.94
2012-06-16,21,Saturday,Night,98,192,290,33.79
2012-06-16,22,Saturday,Night,91,189,280,32.5
2012-06-16,23,Saturday,Night,49,134,183,26.78
2012-06-17,0,Sunday,Early Morning,31,117,148,20.95
2012-06-17,1,Sunday,Early Morning,21,67,88,23.86
2012-06-17,2,Sunday,Early Morning,19,55,74,25.68
2012-06-17,3,Sunday,Early Morning,6,22,28,21.43
2012-06-17,4,Sunday,Early Morning,2,16,18,11.11
2012-06-17,5,Sunday,Early Morning,4,13,17,23.53
2012-06-17,6,Sunday,Morning Rush,7,16,23,30.43
2012-06-17,7,Sunday,Morning Rush,18,30,48,37.5
2012-06-17,8,Sunday,Morning Rush,24,95,119,20.17
2012-06-17,9,Sunday,Morning Rush,91,183,274,33.21
2012-06-17,10,Sunday,Mid-Day,148,288,436,33.94
2012-06-17,11,Sunday,Mid-Day,196,350,546,35.9
2012-06-17,12,Sunday,Mid-Day,260,355,615,42.28
2012-06-17,13,Sunday,Mid-Day,267,347,614,43.49
2012-06-17,14,Sunday,Mid-Day,255,327,582,43.81
2012-06-17,15,Sunday,Mid-Day,203,260,463,43.84
2012-06-17,16,Sunday,Evening Rush,240,340,580,41.38
2012-06-17,17,Sunday,Evening Rush,232,361,593,39.12
2012-06-17,18,Sunday,Evening Rush,203,310,513,39.57
2012-06-17,19,Sunday,Evening Rush,146,244,390,37.44
2012-06-17,20,Sunday,Night,101,201,302,33.44
2012-06-17,21,Sunday,Night,76,170,246,30.89
2012-06-17,22,Sunday,Night,55,98,153,35.95
2012-06-17,23,Sunday,Night,29,79,108,26.85
2012-06-18,0,Monday,Early Morning,12,28,40,30.0
2012-06-18,1,Monday,Early Morning,9,5,14,64.29
2012-06-18,2,Monday,Early Morning,3,6,9,33.33
2012-06-18,3,Monday,Early Morning,1,3,4,25.0
2012-06-18,4,Monday,Early Morning,0,9,9,0.0
2012-06-18,5,Monday,Early Morning,1,22,23,4.35
2012-06-18,6,Monday,Morning Rush,0,37,37,0.0
2012-06-18,7,Monday,Morning Rush,10,135,145,6.9
2012-06-18,8,Monday,Morning Rush,27,447,474,5.7
2012-06-18,9,Monday,Morning Rush,28,222,250,11.2
2012-06-18,10,Monday,Mid-Day,13,78,91,14.29
2012-06-18,11,Monday,Mid-Day,25,96,121,20.66
2012-06-18,12,Monday,Mid-Day,29,139,168,17.26
2012-06-18,13,Monday,Mid-Day,51,174,225,22.67
2012-06-18,14,Monday,Mid-Day,59,160,219,26.94
2012-06-18,15,Monday,Mid-Day,61,176,237,25.74
2012-06-18,16,Monday,Evening Rush,53,279,332,15.96
2012-06-18,17,Monday,Evening Rush,54,669,723,7.47
2012-06-18,18,Monday,Evening Rush,47,595,642,7.32
2012-06-18,19,Monday,Evening Rush,52,411,463,11.23
2012-06-18,20,Monday,Night,45,317,362,12.43
2012-06-18,21,Monday,Night,35,238,273,12.82
2012-06-18,22,Monday,Night,21,143,164,12.8
2012-06-18,23,Monday,Night,17,57,74,22.97
2012-06-19,0,Tuesday,Early Morning,5,30,35,14.29
2012-06-19,1,Tuesday,Early Morning,1,13,14,7.14
2012-06-19,2,Tuesday,Early Morning,1,14,15,6.67
2012-06-19,3,Tuesday,Early Morning,1,7,8,12.5
2012-06-19,4,Tuesday,Early Morning,1,9,10,10.0
2012-06-19,5,Tuesday,Early Morning,3,34,37,8.11
2012-06-19,6,Tuesday,Morning Rush,9,152,161,5.59
2012-06-19,7,Tuesday,Morning Rush,18,462,480,3.75
2012-06-19,8,Tuesday,Morning Rush,40,633,673,5.94
2012-06-19,9,Tuesday,Morning Rush,40,288,328,12.2
2012-06-19,10,Tuesday,Mid-Day,44,136,180,24.44
2012-06-19,11,Tuesday,Mid-Day,56,174,230,24.35
2012-06-19,12,Tuesday,Mid-Day,70,222,292,23.97
2012-06-19,13,Tuesday,Mid-Day,69,203,272,25.37
2012-06-19,14,Tuesday,Mid-Day,61,166,227,26.87
2012-06-19,15,Tuesday,Mid-Day,72,187,259,27.8
2012-06-19,16,Tuesday,Evening Rush,48,286,334,14.37
2012-06-19,17,Tuesday,Evening Rush,86,725,811,10.6
2012-06-19,18,Tuesday,Evening Rush,91,704,795,11.45
2012-06-19,19,Tuesday,Evening Rush,82,432,514,15.95
2012-06-19,20,Tuesday,Night,59,399,458,12.88
2012-06-19,21,Tuesday,Night,37,239,276,13.41
2012-06-19,22,Tuesday,Night,51,240,291,17.53
2012-06-19,23,Tuesday,Night,23,102,125,18.4
2012-06-20,0,Wednesday,Early Morning,5,48,53,9.43
2012-06-20,1,Wednesday,Early Morning,7,20,27,25.93
2012-06-20,2,Wednesday,Early Morning,1,5,6,16.67
2012-06-20,3,Wednesday,Early Morning,2,6,8,25.0
2012-06-20,4,Wednesday,Early Morning,1,6,7,14.29
2012-06-20,5,Wednesday,Early Morning,2,37,39,5.13
2012-06-20,6,Wednesday,Morning Rush,9,156,165,5.45
2012-06-20,7,Wednesday,Morning Rush,20,444,464,4.31
2012-06-20,8,Wednesday,Morning Rush,43,600,643,6.69
2012-06-20,9,Wednesday,Morning Rush,40,276,316,12.66
2012-06-20,10,Wednesday,Mid-Day,41,126,167,24.55
2012-06-20,11,Wednesday,Mid-Day,54,134,188,28.72
2012-06-20,12,Wednesday,Mid-Day,30,150,180,16.67
2012-06-20,13,Wednesday,Mid-Day,48,163,211,22.75
2012-06-20,14,Wednesday,Mid-Day,56,134,190,29.47
2012-06-20,15,Wednesday,Mid-Day,36,143,179,20.11
2012-06-20,16,Wednesday,Evening Rush,51,284,335,15.22
2012-06-20,17,Wednesday,Evening Rush,80,611,691,11.58
2012-06-20,18,Wednesday,Evening Rush,81,591,672,12.05
2012-06-20,19,Wednesday,Evening Rush,90,449,539,16.7
2012-06-20,20,Wednesday,Night,81,326,407,19.9
2012-06-20,21,Wednesday,Night,42,302,344,12.21
2012-06-20,22,Wednesday,Night,31,226,257,12.06
2012-06-20,23,Wednesday,Night,21,102,123,17.07
2012-06-21,0,Thursday,Early Morning,16,53,69,23.19
2012-06-21,1,Thursday,Early Morning,2,16,18,11.11
2012-06-21,2,Thursday,Early Morning,11,7,18,61.11
2012-06-21,3,Thursday,Early Morning,3,8,11,27.27
2012-06-21,4,Thursday,Early Morning,1,11,12,8.33
2012-06-21,5,Thursday,Early Morning,3,37,40,7.5
2012-06-21,6,Thursday,Morning Rush,3,147,150,2.0
2012-06-21,7,Thursday,Morning Rush,26,437,463,5.62
2012-06-21,8,Thursday,Morning Rush,27,563,590,4.58
2012-06-21,9,Thursday,Morning Rush,32,224,256,12.5
2012-06-21,10,Thursday,Mid-Day,36,114,150,24.0
2012-06-21,11,Thursday,Mid-Day,40,121,161,24.84
2012-06-21,12,Thursday,Mid-Day,33,182,215,15.35
2012-06-21,13,Thursday,Mid-Day,31,141,172,18.02
2012-06-21,14,Thursday,Mid-Day,27,149,176,15.34
2012-06-21,15,Thursday,Mid-Day,40,154,194,20.62
2012-06-21,16,Thursday,Evening Rush,37,283,320,11.56
2012-06-21,17,Thursday,Evening Rush,80,535,615,13.01
2012-06-21,18,Thursday,Evening Rush,78,562,640,12.19
2012-06-21,19,Thursday,Evening Rush,84,415,499,16.83
2012-06-21,20,Thursday,Night,79,357,436,18.12
2012-06-21,21,Thursday,Night,55,256,311,17.68
2012-06-21,22,Thursday,Night,22,221,243,9.05
2012-06-21,23,Thursday,Night,12,134,146,8.22
2012-06-22,0,Friday,Early Morning,16,77,93,17.2
2012-06-22,1,Friday,Early Morning,3,28,31,9.68
2012-06-22,2,Friday,Early Morning,0,12,12,0.0
2012-06-22,3,Friday,Early Morning,1,6,7,14.29
2012-06-22,4,Friday,Early Morning,3,7,10,30.0
2012-06-22,5,Friday,Early Morning,3,35,38,7.89
2012-06-22,6,Friday,Morning Rush,4,118,122,3.28
2012-06-22,7,Friday,Morning Rush,19,340,359,5.29
2012-06-22,8,Friday,Morning Rush,49,564,613,7.99
2012-06-22,9,Friday,Morning Rush,55,278,333,16.52
2012-06-22,10,Friday,Mid-Day,52,133,185,28.11
2012-06-22,11,Friday,Mid-Day,76,160,236,32.2
2012-06-22,12,Friday,Mid-Day,63,191,254,24.8
2012-06-22,13,Friday,Mid-Day,72,228,300,24.0
2012-06-22,14,Friday,Mid-Day,65,198,263,24.71
2012-06-22,15,Friday,Mid-Day,72,212,284,25.35
2012-06-22,16,Friday,Evening Rush,67,313,380,17.63
2012-06-22,17,Friday,Evening Rush,95,551,646,14.71
2012-06-22,18,Friday,Evening Rush,62,443,505,12.28
2012-06-22,19,Friday,Evening Rush,45,317,362,12.43
2012-06-22,20,Friday,Night,31,171,202,15.35
2012-06-22,21,Friday,Night,40,177,217,18.43
2012-06-22,22,Friday,Night,42,155,197,21.32
2012-06-22,23,Friday,Night,29,145,174,16.67
2012-06-23,0,Saturday,Early Morning,14,102,116,12.07
2012-06-23,1,Saturday,Early Morning,16,107,123,13.01
2012-06-23,2,Saturday,Early Morning,18,75,93,19.35
2012-06-23,3,Saturday,Early Morning,10,32,42,23.81
2012-06-23,4,Saturday,Early Morning,6,13,19,31.58
2012-06-23,5,Saturday,Early Morning,1,11,12,8.33
2012-06-23,6,Saturday,Morning Rush,10,37,47,21.28
2012-06-23,7,Saturday,Morning Rush,19,59,78,24.36
2012-06-23,8,Saturday,Morning Rush,34,133,167,20.36
2012-06-23,9,Saturday,Morning Rush,85,247,332,25.6
2012-06-23,10,Saturday,Mid-Day,177,317,494,35.83
2012-06-23,11,Saturday,Mid-Day,167,349,516,32.36
2012-06-23,12,Saturday,Mid-Day,203,399,602,33.72
2012-06-23,13,Saturday,Mid-Day,226,338,564,40.07
2012-06-23,14,Saturday,Mid-Day,238,371,609,39.08
2012-06-23,15,Saturday,Mid-Day,217,266,483,44.93
2012-06-23,16,Saturday,Evening Rush,196,317,513,38.21
2012-06-23,17,Saturday,Evening Rush,214,316,530,40.38
2012-06-23,18,Saturday,Evening Rush,194,287,481,40.33
2012-06-23,19,Saturday,Evening Rush,185,240,425,43.53
2012-06-23,20,Saturday,Night,158,228,386,40.93
2012-06-23,21,Saturday,Night,99,223,322,30.75
2012-06-23,22,Saturday,Night,101,178,279,36.2
2012-06-23,23,Saturday,Night,69,156,225,30.67
2012-06-24,0,Sunday,Early Morning,31,132,163,19.02
2012-06-24,1,Sunday,Early Morning,39,88,127,30.71
2012-06-24,2,Sunday,Early Morning,34,80,114,29.82
2012-06-24,3,Sunday,Early Morning,19,41,60,31.67
2012-06-24,4,Sunday,Early Morning,4,9,13,30.77
2012-06-24,5,Sunday,Early Morning,1,7,8,12.5
2012-06-24,6,Sunday,Morning Rush,6,19,25,24.0
2012-06-24,7,Sunday,Morning Rush,23,48,71,32.39
2012-06-24,8,Sunday,Morning Rush,38,103,141,26.95
2012-06-24,9,Sunday,Morning Rush,63,169,232,27.16
2012-06-24,10,Sunday,Mid-Day,161,291,452,35.62
2012-06-24,11,Sunday,Mid-Day,215,291,506,42.49
2012-06-24,12,Sunday,Mid-Day,227,329,556,40.83
2012-06-24,13,Sunday,Mid-Day,237,348,585,40.51
2012-06-24,14,Sunday,Mid-Day,253,298,551,45.92
2012-06-24,15,Sunday,Mid-Day,197,290,487,40.45
2012-06-24,16,Sunday,Evening Rush,181,280,461,39.26
2012-06-24,17,Sunday,Evening Rush,203,329,532,38.16
2012-06-24,18,Sunday,Evening Rush,186,348,534,34.83
2012-06-24,19,Sunday,Evening Rush,176,247,423,41.61
2012-06-24,20,Sunday,Night,108,224,332,32.53
2012-06-24,21,Sunday,Night,76,177,253,30.04
2012-06-24,22,Sunday,Night,53,125,178,29.78
2012-06-24,23,Sunday,Night,20,67,87,22.99
2012-06-25,0,Monday,Early Morning,31,37,68,45.59
2012-06-25,1,Monday,Early Morning,11,20,31,35.48
2012-06-25,2,Monday,Early Morning,4,10,14,28.57
2012-06-25,3,Monday,Early Morning,1,4,5,20.0
2012-06-25,4,Monday,Early Morning,0,4,4,0.0
2012-06-25,5,Monday,Early Morning,1,42,43,2.33
2012-06-25,6,Monday,Morning Rush,11,147,158,6.96
2012-06-25,7,Monday,Morning Rush,30,455,485,6.19
2012-06-25,8,Monday,Morning Rush,53,555,608,8.72
2012-06-25,9,Monday,Morning Rush,37,231,268,13.81
2012-06-25,10,Monday,Mid-Day,58,126,184,31.52
2012-06-25,11,Monday,Mid-Day,54,127,181,29.83
2012-06-25,12,Monday,Mid-Day,74,196,270,27.41
2012-06-25,13,Monday,Mid-Day,79,181,260,30.38
2012-06-25,14,Monday,Mid-Day,90,161,251,35.86
2012-06-25,15,Monday,Mid-Day,65,168,233,27.9
2012-06-25,16,Monday,Evening Rush,104,310,414,25.12
2012-06-25,17,Monday,Evening Rush,76,757,833,9.12
2012-06-25,18,Monday,Evening Rush,100,691,791,12.64
2012-06-25,19,Monday,Evening Rush,74,508,582,12.71
2012-06-25,20,Monday,Night,100,375,475,21.05
2012-06-25,21,Monday,Night,50,281,331,15.11
2012-06-25,22,Monday,Night,21,166,187,11.23
2012-06-25,23,Monday,Night,15,88,103,14.56
2012-06-26,0,Tuesday,Early Morning,8,29,37,21.62
2012-06-26,1,Tuesday,Early Morning,11,19,30,36.67
2012-06-26,2,Tuesday,Early Morning,2,7,9,22.22
2012-06-26,3,Tuesday,Early Morning,2,7,9,22.22
2012-06-26,4,Tuesday,Early Morning,1,9,10,10.0
2012-06-26,5,Tuesday,Early Morning,3,36,39,7.69
2012-06-26,6,Tuesday,Morning Rush,12,176,188,6.38
2012-06-26,7,Tuesday,Morning Rush,21,531,552,3.8
2012-06-26,8,Tuesday,Morning Rush,34,622,656,5.18
2012-06-26,9,Tuesday,Morning Rush,30,298,328,9.15
2012-06-26,10,Tuesday,Mid-Day,37,153,190,19.47
2012-06-26,11,Tuesday,Mid-Day,46,189,235,19.57
2012-06-26,12,Tuesday,Mid-Day,80,228,308,25.97
2012-06-26,13,Tuesday,Mid-Day,74,232,306,24.18
2012-06-26,14,Tuesday,Mid-Day,81,186,267,30.34
2012-06-26,15,Tuesday,Mid-Day,88,229,317,27.76
2012-06-26,16,Tuesday,Evening Rush,67,349,416,16.11
2012-06-26,17,Tuesday,Evening Rush,104,796,900,11.56
2012-06-26,18,Tuesday,Evening Rush,105,719,824,12.74
2012-06-26,19,Tuesday,Evening Rush,83,529,612,13.56
2012-06-26,20,Tuesday,Night,88,417,505,17.43
2012-06-26,21,Tuesday,Night,61,267,328,18.6
2012-06-26,22,Tuesday,Night,26,219,245,10.61
2012-06-26,23,Tuesday,Night,13,118,131,9.92
2012-06-27,0,Wednesday,Early Morning,15,39,54,27.78
2012-06-27,1,Wednesday,Early Morning,5,18,23,21.74
2012-06-27,2,Wednesday,Early Morning,2,12,14,14.29
2012-06-27,3,Wednesday,Early Morning,1,7,8,12.5
2012-06-27,4,Wednesday,Early Morning,0,11,11,0.0
2012-06-27,5,Wednesday,Early Morning,2,34,36,5.56
2012-06-27,6,Wednesday,Morning Rush,7,193,200,3.5
2012-06-27,7,Wednesday,Morning Rush,29,498,527,5.5
2012-06-27,8,Wednesday,Morning Rush,49,638,687,7.13
2012-06-27,9,Wednesday,Morning Rush,29,253,282,10.28
2012-06-27,10,Wednesday,Mid-Day,34,138,172,19.77
2012-06-27,11,Wednesday,Mid-Day,64,145,209,30.62
2012-06-27,12,Wednesday,Mid-Day,77,245,322,23.91
2012-06-27,13,Wednesday,Mid-Day,77,244,321,23.99
2012-06-27,14,Wednesday,Mid-Day,78,192,270,28.89
2012-06-27,15,Wednesday,Mid-Day,61,188,249,24.5
2012-06-27,16,Wednesday,Evening Rush,55,337,392,14.03
2012-06-27,17,Wednesday,Evening Rush,113,730,843,13.4
2012-06-27,18,Wednesday,Evening Rush,85,719,804,10.57
2012-06-27,19,Wednesday,Evening Rush,101,542,643,15.71
2012-06-27,20,Wednesday,Night,76,369,445,17.08
2012-06-27,21,Wednesday,Night,54,313,367,14.71
2012-06-27,22,Wednesday,Night,52,245,297,17.51
2012-06-27,23,Wednesday,Night,11,148,159,6.92
2012-06-28,0,Thursday,Early Morning,2,52,54,3.7
2012-06-28,1,Thursday,Early Morning,11,14,25,44.0
2012-06-28,2,Thursday,Early Morning,1,12,13,7.69
2012-06-28,3,Thursday,Early Morning,1,6,7,14.29
2012-06-28,4,Thursday,Early Morning,0,11,11,0.0
2012-06-28,5,Thursday,Early Morning,8,39,47,17.02
2012-06-28,6,Thursday,Morning Rush,8,185,193,4.15
2012-06-28,7,Thursday,Morning Rush,24,484,508,4.72
2012-06-28,8,Thursday,Morning Rush,40,577,617,6.48
2012-06-28,9,Thursday,Morning Rush,33,318,351,9.4
2012-06-28,10,Thursday,Mid-Day,40,144,184,21.74
2012-06-28,11,Thursday,Mid-Day,41,170,211,19.43
2012-06-28,12,Thursday,Mid-Day,49,227,276,17.75
2012-06-28,13,Thursday,Mid-Day,31,205,236,13.14
2012-06-28,14,Thursday,Mid-Day,66,188,254,25.98
2012-06-28,15,Thursday,Mid-Day,24,195,219,10.96
2012-06-28,16,Thursday,Evening Rush,56,331,387,14.47
2012-06-28,17,Thursday,Evening Rush,71,634,705,10.07
2012-06-28,18,Thursday,Evening Rush,100,597,697,14.35
2012-06-28,19,Thursday,Evening Rush,79,492,571,13.84
2012-06-28,20,Thursday,Night,71,399,470,15.11
2012-06-28,21,Thursday,Night,89,309,398,22.36
2012-06-28,22,Thursday,Night,50,224,274,18.25
2012-06-28,23,Thursday,Night,26,145,171,15.2
2012-06-29,0,Friday,Early Morning,24,90,114,21.05
2012-06-29,1,Friday,Early Morning,9,33,42,21.43
2012-06-29,2,Friday,Early Morning,3,15,18,16.67
2012-06-29,3,Friday,Early Morning,3,5,8,37.5
2012-06-29,4,Friday,Early Morning,1,9,10,10.0
2012-06-29,5,Friday,Early Morning,6,39,45,13.33
2012-06-29,6,Friday,Morning Rush,15,148,163,9.2
2012-06-29,7,Friday,Morning Rush,19,361,380,5.0
2012-06-29,8,Friday,Morning Rush,48,576,624,7.69
2012-06-29,9,Friday,Morning Rush,39,261,300,13.0
2012-06-29,10,Friday,Mid-Day,32,139,171,18.71
2012-06-29,11,Friday,Mid-Day,51,137,188,27.13
2012-06-29,12,Friday,Mid-Day,53,173,226,23.45
2012-06-29,13,Friday,Mid-Day,45,194,239,18.83
2012-06-29,14,Friday,Mid-Day,49,184,233,21.03
2012-06-29,15,Friday,Mid-Day,47,183,230,20.43
2012-06-29,16,Friday,Evening Rush,59,292,351,16.81
2012-06-29,17,Friday,Evening Rush,82,457,539,15.21
2012-06-29,18,Friday,Evening Rush,50,414,464,10.78
2012-06-29,19,Friday,Evening Rush,60,303,363,16.53
2012-06-29,20,Friday,Night,53,255,308,17.21
2012-06-29,21,Friday,Night,41,195,236,17.37
2012-06-29,22,Friday,Night,34,129,163,20.86
2012-06-29,23,Friday,Night,6,42,48,12.5
2012-06-30,0,Saturday,Early Morning,4,65,69,5.8
2012-06-30,1,Saturday,Early Morning,3,55,58,5.17
2012-06-30,2,Saturday,Early Morning,7,54,61,11.48
2012-06-30,3,Saturday,Early Morning,3,20,23,13.04
2012-06-30,4,Saturday,Early Morning,3,15,18,16.67
2012-06-30,5,Saturday,Early Morning,3,7,10,30.0
2012-06-30,6,Saturday,Morning Rush,6,36,42,14.29
2012-06-30,7,Saturday,Morning Rush,10,82,92,10.87
2012-06-30,8,Saturday,Morning Rush,26,168,194,13.4
2012-06-30,9,Saturday,Morning Rush,41,234,275,14.91
2012-06-30,10,Saturday,Mid-Day,96,308,404,23.76
2012-06-30,11,Saturday,Mid-Day,102,350,452,22.57
2012-06-30,12,Saturday,Mid-Day,143,328,471,30.36
2012-06-30,13,Saturday,Mid-Day,105,323,428,24.53
2012-06-30,14,Saturday,Mid-Day,114,295,409,27.87
2012-06-30,15,Saturday,Mid-Day,117,287,404,28.96
2012-06-30,16,Saturday,Evening Rush,109,264,373,29.22
2012-06-30,17,Saturday,Evening Rush,131,231,362,36.19
2012-06-30,18,Saturday,Evening Rush,91,248,339,26.84
2012-06-30,19,Saturday,Evening Rush,134,240,374,35.83
2012-06-30,20,Saturday,Night,88,204,292,30.14
2012-06-30,21,Saturday,Night,48,165,213,22.54
2012-06-30,22,Saturday,Night,38,134,172,22.09
2012-06-30,23,Saturday,Night,33,119,152,21.71
2012-07-01,0,Sunday,Early Morning,27,122,149,18.12
2012-07-01,1,Sunday,Early Morning,12,81,93,12.9
2012-07-01,2,Sunday,Early Morning,21,69,90,23.33
2012-07-01,3,Sunday,Early Morning,6,27,33,18.18
2012-07-01,4,Sunday,Early Morning,0,4,4,0.0
2012-07-01,5,Sunday,Early Morning,3,7,10,30.0
2012-07-01,6,Sunday,Morning Rush,8,19,27,29.63
2012-07-01,7,Sunday,Morning Rush,13,37,50,26.0
2012-07-01,8,Sunday,Morning Rush,36,106,142,25.35
2012-07-01,9,Sunday,Morning Rush,51,168,219,23.29
2012-07-01,10,Sunday,Mid-Day,98,268,366,26.78
2012-07-01,11,Sunday,Mid-Day,121,256,377,32.1
2012-07-01,12,Sunday,Mid-Day,114,319,433,26.33
2012-07-01,13,Sunday,Mid-Day,111,309,420,26.43
2012-07-01,14,Sunday,Mid-Day,98,346,444,22.07
2012-07-01,15,Sunday,Mid-Day,101,244,345,29.28
2012-07-01,16,Sunday,Evening Rush,85,228,313,27.16
2012-07-01,17,Sunday,Evening Rush,90,323,413,21.79
2012-07-01,18,Sunday,Evening Rush,95,275,370,25.68
2012-07-01,19,Sunday,Evening Rush,103,279,382,26.96
2012-07-01,20,Sunday,Night,88,244,332,26.51
2012-07-01,21,Sunday,Night,77,181,258,29.84
2012-07-01,22,Sunday,Night,41,110,151,27.15
2012-07-01,23,Sunday,Night,22,88,110,20.0
2012-07-02,0,Monday,Early Morning,12,31,43,27.91
2012-07-02,1,Monday,Early Morning,3,14,17,17.65
2012-07-02,2,Monday,Early Morning,1,14,15,6.67
2012-07-02,3,Monday,Early Morning,0,5,5,0.0
2012-07-02,4,Monday,Early Morning,2,10,12,16.67
2012-07-02,5,Monday,Early Morning,3,37,40,7.5
2012-07-02,6,Monday,Morning Rush,4,132,136,2.94
2012-07-02,7,Monday,Morning Rush,8,390,398,2.01
2012-07-02,8,Monday,Morning Rush,20,548,568,3.52
2012-07-02,9,Monday,Morning Rush,56,239,295,18.98
2012-07-02,10,Monday,Mid-Day,70,104,174,40.23
2012-07-02,11,Monday,Mid-Day,67,134,201,33.33
2012-07-02,12,Monday,Mid-Day,74,183,257,28.79
2012-07-02,13,Monday,Mid-Day,74,162,236,31.36
2012-07-02,14,Monday,Mid-Day,79,151,230,34.35
2012-07-02,15,Monday,Mid-Day,59,175,234,25.21
2012-07-02,16,Monday,Evening Rush,61,304,365,16.71
2012-07-02,17,Monday,Evening Rush,82,665,747,10.98
2012-07-02,18,Monday,Evening Rush,72,658,730,9.86
2012-07-02,19,Monday,Evening Rush,71,510,581,12.22
2012-07-02,20,Monday,Night,38,357,395,9.62
2012-07-02,21,Monday,Night,17,241,258,6.59
2012-07-02,22,Monday,Night,19,169,188,10.11
2012-07-02,23,Monday,Night,12,90,102,11.76
2012-07-03,0,Tuesday,Early Morning,9,44,53,16.98
2012-07-03,1,Tuesday,Early Morning,5,9,14,35.71
2012-07-03,2,Tuesday,Early Morning,2,8,10,20.0
2012-07-03,3,Tuesday,Early Morning,0,2,2,0.0
2012-07-03,4,Tuesday,Early Morning,0,6,6,0.0
2012-07-03,5,Tuesday,Early Morning,2,33,35,5.71
2012-07-03,6,Tuesday,Morning Rush,5,149,154,3.25
2012-07-03,7,Tuesday,Morning Rush,21,462,483,4.35
2012-07-03,8,Tuesday,Morning Rush,42,604,646,6.5
2012-07-03,9,Tuesday,Morning Rush,46,226,272,16.91
2012-07-03,10,Tuesday,Mid-Day,56,153,209,26.79
2012-07-03,11,Tuesday,Mid-Day,66,151,217,30.41
2012-07-03,12,Tuesday,Mid-Day,74,198,272,27.21
2012-07-03,13,Tuesday,Mid-Day,80,203,283,28.27
2012-07-03,14,Tuesday,Mid-Day,69,241,310,22.26
2012-07-03,15,Tuesday,Mid-Day,71,330,401,17.71
2012-07-03,16,Tuesday,Evening Rush,90,437,527,17.08
2012-07-03,17,Tuesday,Evening Rush,102,620,722,14.13
2012-07-03,18,Tuesday,Evening Rush,85,542,627,13.56
2012-07-03,19,Tuesday,Evening Rush,66,431,497,13.28
2012-07-03,20,Tuesday,Night,80,296,376,21.28
2012-07-03,21,Tuesday,Night,36,160,196,18.37
2012-07-03,22,Tuesday,Night,26,151,177,14.69
2012-07-03,23,Tuesday,Night,19,152,171,11.11
2012-07-04,0,Wednesday,Early Morning,19,140,159,11.95
2012-07-04,1,Wednesday,Early Morning,27,96,123,21.95
2012-07-04,2,Wednesday,Early Morning,27,66,93,29.03
2012-07-04,3,Wednesday,Early Morning,9,23,32,28.13
2012-07-04,4,Wednesday,Early Morning,5,11,16,31.25
2012-07-04,5,Wednesday,Early Morning,5,14,19,26.32
2012-07-04,6,Wednesday,Morning Rush,9,23,32,28.13
2012-07-04,7,Wednesday,Morning Rush,10,62,72,13.89
2012-07-04,8,Wednesday,Morning Rush,43,110,153,28.1
2012-07-04,9,Wednesday,Morning Rush,90,203,293,30.72
2012-07-04,10,Wednesday,Mid-Day,143,304,447,31.99
2012-07-04,11,Wednesday,Mid-Day,164,321,485,33.81
2012-07-04,12,Wednesday,Mid-Day,164,330,494,33.2
2012-07-04,13,Wednesday,Mid-Day,177,322,499,35.47
2012-07-04,14,Wednesday,Mid-Day,190,357,547,34.73
2012-07-04,15,Wednesday,Mid-Day,155,299,454,34.14
2012-07-04,16,Wednesday,Evening Rush,163,226,389,41.9
2012-07-04,17,Wednesday,Evening Rush,161,253,414,38.89
2012-07-04,18,Wednesday,Evening Rush,159,271,430,36.98
2012-07-04,19,Wednesday,Evening Rush,177,255,432,40.97
2012-07-04,20,Wednesday,Night,237,314,551,43.01
2012-07-04,21,Wednesday,Night,222,362,584,38.01
2012-07-04,22,Wednesday,Night,175,327,502,34.86
2012-07-04,23,Wednesday,Night,31,152,183,16.94
2012-07-05,0,Thursday,Early Morning,17,71,88,19.32
2012-07-05,1,Thursday,Early Morning,6,24,30,20.0
2012-07-05,2,Thursday,Early Morning,4,14,18,22.22
2012-07-05,3,Thursday,Early Morning,2,5,7,28.57
2012-07-05,4,Thursday,Early Morning,0,7,7,0.0
2012-07-05,5,Thursday,Early Morning,1,28,29,3.45
2012-07-05,6,Thursday,Morning Rush,3,130,133,2.26
2012-07-05,7,Thursday,Morning Rush,27,316,343,7.87
2012-07-05,8,Thursday,Morning Rush,36,514,550,6.55
2012-07-05,9,Thursday,Morning Rush,47,246,293,16.04
2012-07-05,10,Thursday,Mid-Day,69,117,186,37.1
2012-07-05,11,Thursday,Mid-Day,107,137,244,43.85
2012-07-05,12,Thursday,Mid-Day,88,188,276,31.88
2012-07-05,13,Thursday,Mid-Day,129,181,310,41.61
2012-07-05,14,Thursday,Mid-Day,87,154,241,36.1
2012-07-05,15,Thursday,Mid-Day,71,183,254,27.95
2012-07-05,16,Thursday,Evening Rush,109,324,433,25.17
2012-07-05,17,Thursday,Evening Rush,114,575,689,16.55
2012-07-05,18,Thursday,Evening Rush,96,511,607,15.82
2012-07-05,19,Thursday,Evening Rush,128,375,503,25.45
2012-07-05,20,Thursday,Night,78,243,321,24.3
2012-07-05,21,Thursday,Night,91,232,323,28.17
2012-07-05,22,Thursday,Night,63,162,225,28.0
2012-07-05,23,Thursday,Night,32,99,131,24.43
2012-07-06,0,Friday,Early Morning,39,63,102,38.24
2012-07-06,1,Friday,Early Morning,7,22,29,24.14
2012-07-06,2,Friday,Early Morning,4,13,17,23.53
2012-07-06,3,Friday,Early Morning,1,6,7,14.29
2012-07-06,4,Friday,Early Morning,2,4,6,33.33
2012-07-06,5,Friday,Early Morning,4,31,35,11.43
2012-07-06,6,Friday,Morning Rush,4,127,131,3.05
2012-07-06,7,Friday,Morning Rush,20,333,353,5.67
2012-07-06,8,Friday,Morning Rush,28,557,585,4.79
2012-07-06,9,Friday,Morning Rush,55,249,304,18.09
2012-07-06,10,Friday,Mid-Day,80,130,210,38.1
2012-07-06,11,Friday,Mid-Day,92,141,233,39.48
2012-07-06,12,Friday,Mid-Day,111,220,331,33.53
2012-07-06,13,Friday,Mid-Day,99,194,293,33.79
2012-07-06,14,Friday,Mid-Day,91,184,275,33.09
2012-07-06,15,Friday,Mid-Day,79,206,285,27.72
2012-07-06,16,Friday,Evening Rush,69,300,369,18.7
2012-07-06,17,Friday,Evening Rush,90,486,576,15.63
2012-07-06,18,Friday,Evening Rush,106,454,560,18.93
2012-07-06,19,Friday,Evening Rush,112,306,418,26.79
2012-07-06,20,Friday,Night,91,245,336,27.08
2012-07-06,21,Friday,Night,77,223,300,25.67
2012-07-06,22,Friday,Night,78,210,288,27.08
2012-07-06,23,Friday,Night,27,137,164,16.46
2012-07-07,0,Saturday,Early Morning,35,115,150,23.33
2012-07-07,1,Saturday,Early Morning,16,55,71,22.54
2012-07-07,2,Saturday,Early Morning,11,47,58,18.97
2012-07-07,3,Saturday,Early Morning,12,19,31,38.71
2012-07-07,4,Saturday,Early Morning,3,13,16,18.75
2012-07-07,5,Saturday,Early Morning,2,12,14,14.29
2012-07-07,6,Saturday,Morning Rush,4,27,31,12.9
2012-07-07,7,Saturday,Morning Rush,8,63,71,11.27
2012-07-07,8,Saturday,Morning Rush,32,120,152,21.05
2012-07-07,9,Saturday,Morning Rush,69,187,256,26.95
2012-07-07,10,Saturday,Mid-Day,100,225,325,30.77
2012-07-07,11,Saturday,Mid-Day,122,245,367,33.24
2012-07-07,12,Saturday,Mid-Day,124,218,342,36.26
2012-07-07,13,Saturday,Mid-Day,116,244,360,32.22
2012-07-07,14,Saturday,Mid-Day,105,203,308,34.09
2012-07-07,15,Saturday,Mid-Day,113,193,306,36.93
2012-07-07,16,Saturday,Evening Rush,102,192,294,34.69
2012-07-07,17,Saturday,Evening Rush,103,176,279,36.92
2012-07-07,18,Saturday,Evening Rush,83,194,277,29.96
2012-07-07,19,Saturday,Evening Rush,68,219,287,23.69
2012-07-07,20,Saturday,Night,79,197,276,28.62
2012-07-07,21,Saturday,Night,51,150,201,25.37
2012-07-07,22,Saturday,Night,56,164,220,25.45
2012-07-07,23,Saturday,Night,34,114,148,22.97
2012-07-08,0,Sunday,Early Morning,22,125,147,14.97
2012-07-08,1,Sunday,Early Morning,25,99,124,20.16
2012-07-08,2,Sunday,Early Morning,11,59,70,15.71
2012-07-08,3,Sunday,Early Morning,1,34,35,2.86
2012-07-08,4,Sunday,Early Morning,2,11,13,15.38
2012-07-08,5,Sunday,Early Morning,1,5,6,16.67
2012-07-08,6,Sunday,Morning Rush,5,16,21,23.81
2012-07-08,7,Sunday,Morning Rush,19,33,52,36.54
2012-07-08,8,Sunday,Morning Rush,35,95,130,26.92
2012-07-08,9,Sunday,Morning Rush,70,172,242,28.93
2012-07-08,10,Sunday,Mid-Day,85,234,319,26.65
2012-07-08,11,Sunday,Mid-Day,120,269,389,30.85
2012-07-08,12,Sunday,Mid-Day,105,271,376,27.93
2012-07-08,13,Sunday,Mid-Day,118,219,337,35.01
2012-07-08,14,Sunday,Mid-Day,77,235,312,24.68
2012-07-08,15,Sunday,Mid-Day,80,218,298,26.85
2012-07-08,16,Sunday,Evening Rush,65,226,291,22.34
2012-07-08,17,Sunday,Evening Rush,68,202,270,25.19
2012-07-08,18,Sunday,Evening Rush,54,199,253,21.34
2012-07-08,19,Sunday,Evening Rush,66,184,250,26.4
2012-07-08,20,Sunday,Night,79,206,285,27.72
2012-07-08,21,Sunday,Night,58,149,207,28.02
2012-07-08,22,Sunday,Night,12,110,122,9.84
2012-07-08,23,Sunday,Night,25,98,123,20.33
2012-07-09,0,Monday,Early Morning,6,33,39,15.38
2012-07-09,1,Monday,Early Morning,5,13,18,27.78
2012-07-09,2,Monday,Early Morning,1,4,5,20.0
2012-07-09,3,Monday,Early Morning,0,5,5,0.0
2012-07-09,4,Monday,Early Morning,1,1,2,50.0
2012-07-09,5,Monday,Early Morning,1,27,28,3.57
2012-07-09,6,Monday,Morning Rush,6,86,92,6.52
2012-07-09,7,Monday,Morning Rush,7,223,230,3.04
2012-07-09,8,Monday,Morning Rush,26,429,455,5.71
2012-07-09,9,Monday,Morning Rush,38,325,363,10.47
2012-07-09,10,Monday,Mid-Day,58,117,175,33.14
2012-07-09,11,Monday,Mid-Day,72,144,216,33.33
2012-07-09,12,Monday,Mid-Day,61,205,266,22.93
2012-07-09,13,Monday,Mid-Day,67,188,255,26.27
2012-07-09,14,Monday,Mid-Day,58,184,242,23.97
2012-07-09,15,Monday,Mid-Day,66,214,280,23.57
2012-07-09,16,Monday,Evening Rush,88,325,413,21.31
2012-07-09,17,Monday,Evening Rush,108,741,849,12.72
2012-07-09,18,Monday,Evening Rush,82,790,872,9.4
2012-07-09,19,Monday,Evening Rush,88,543,631,13.95
2012-07-09,20,Monday,Night,69,378,447,15.44
2012-07-09,21,Monday,Night,33,298,331,9.97
2012-07-09,22,Monday,Night,35,189,224,15.63
2012-07-09,23,Monday,Night,22,109,131,16.79
2012-07-10,0,Tuesday,Early Morning,16,53,69,23.19
2012-07-10,1,Tuesday,Early Morning,0,15,15,0.0
2012-07-10,2,Tuesday,Early Morning,1,15,16,6.25
2012-07-10,3,Tuesday,Early Morning,0,3,3,0.0
2012-07-10,4,Tuesday,Early Morning,0,4,4,0.0
2012-07-10,5,Tuesday,Early Morning,3,39,42,7.14
2012-07-10,6,Tuesday,Morning Rush,4,183,187,2.14
2012-07-10,7,Tuesday,Morning Rush,31,489,520,5.96
2012-07-10,8,Tuesday,Morning Rush,34,615,649,5.24
2012-07-10,9,Tuesday,Morning Rush,47,284,331,14.2
2012-07-10,10,Tuesday,Mid-Day,56,134,190,29.47
2012-07-10,11,Tuesday,Mid-Day,92,157,249,36.95
2012-07-10,12,Tuesday,Mid-Day,69,203,272,25.37
2012-07-10,13,Tuesday,Mid-Day,77,203,280,27.5
2012-07-10,14,Tuesday,Mid-Day,71,171,242,29.34
2012-07-10,15,Tuesday,Mid-Day,77,188,265,29.06
2012-07-10,16,Tuesday,Evening Rush,89,346,435,20.46
2012-07-10,17,Tuesday,Evening Rush,103,769,872,11.81
2012-07-10,18,Tuesday,Evening Rush,70,749,819,8.55
2012-07-10,19,Tuesday,Evening Rush,55,359,414,13.29
2012-07-10,20,Tuesday,Night,9,75,84,10.71
2012-07-10,21,Tuesday,Night,7,83,90,7.78
2012-07-10,22,Tuesday,Night,14,125,139,10.07
2012-07-10,23,Tuesday,Night,29,74,103,28.16
2012-07-11,0,Wednesday,Early Morning,6,38,44,13.64
2012-07-11,1,Wednesday,Early Morning,3,11,14,21.43
2012-07-11,2,Wednesday,Early Morning,0,5,5,0.0
2012-07-11,3,Wednesday,Early Morning,0,5,5,0.0
2012-07-11,4,Wednesday,Early Morning,1,6,7,14.29
2012-07-11,5,Wednesday,Early Morning,5,36,41,12.2
2012-07-11,6,Wednesday,Morning Rush,17,168,185,9.19
2012-07-11,7,Wednesday,Morning Rush,26,471,497,5.23
2012-07-11,8,Wednesday,Morning Rush,30,644,674,4.45
2012-07-11,9,Wednesday,Morning Rush,30,298,328,9.15
2012-07-11,10,Wednesday,Mid-Day,47,148,195,24.1
2012-07-11,11,Wednesday,Mid-Day,56,173,229,24.45
2012-07-11,12,Wednesday,Mid-Day,69,223,292,23.63
2012-07-11,13,Wednesday,Mid-Day,65,208,273,23.81
2012-07-11,14,Wednesday,Mid-Day,66,175,241,27.39
2012-07-11,15,Wednesday,Mid-Day,56,220,276,20.29
2012-07-11,16,Wednesday,Evening Rush,53,358,411,12.9
2012-07-11,17,Wednesday,Evening Rush,90,740,830,10.84
2012-07-11,18,Wednesday,Evening Rush,79,735,814,9.71
2012-07-11,19,Wednesday,Evening Rush,73,560,633,11.53
2012-07-11,20,Wednesday,Night,73,410,483,15.11
2012-07-11,21,Wednesday,Night,69,322,391,17.65
2012-07-11,22,Wednesday,Night,41,203,244,16.8
2012-07-11,23,Wednesday,Night,20,132,152,13.16
2012-07-12,0,Thursday,Early Morning,1,55,56,1.79
2012-07-12,1,Thursday,Early Morning,0,21,21,0.0
2012-07-12,2,Thursday,Early Morning,0,9,9,0.0
2012-07-12,3,Thursday,Early Morning,0,10,10,0.0
2012-07-12,4,Thursday,Early Morning,0,5,5,0.0
2012-07-12,5,Thursday,Early Morning,4,40,44,9.09
2012-07-12,6,Thursday,Morning Rush,7,171,178,3.93
2012-07-12,7,Thursday,Morning Rush,32,480,512,6.25
2012-07-12,8,Thursday,Morning Rush,49,653,702,6.98
2012-07-12,9,Thursday,Morning Rush,42,285,327,12.84
2012-07-12,10,Thursday,Mid-Day,69,145,214,32.24
2012-07-12,11,Thursday,Mid-Day,49,166,215,22.79
2012-07-12,12,Thursday,Mid-Day,71,221,292,24.32
2012-07-12,13,Thursday,Mid-Day,52,225,277,18.77
2012-07-12,14,Thursday,Mid-Day,42,167,209,20.1
2012-07-12,15,Thursday,Mid-Day,63,208,271,23.25
2012-07-12,16,Thursday,Evening Rush,69,370,439,15.72
2012-07-12,17,Thursday,Evening Rush,91,704,795,11.45
2012-07-12,18,Thursday,Evening Rush,86,739,825,10.42
2012-07-12,19,Thursday,Evening Rush,97,532,629,15.42
2012-07-12,20,Thursday,Night,75,439,514,14.59
2012-07-12,21,Thursday,Night,44,329,373,11.8
2012-07-12,22,Thursday,Night,56,262,318,17.61
2012-07-12,23,Thursday,Night,33,178,211,15.64
2012-07-13,0,Friday,Early Morning,19,76,95,20.0
2012-07-13,1,Friday,Early Morning,17,42,59,28.81
2012-07-13,2,Friday,Early Morning,2,15,17,11.76
2012-07-13,3,Friday,Early Morning,2,7,9,22.22
2012-07-13,4,Friday,Early Morning,0,11,11,0.0
2012-07-13,5,Friday,Early Morning,4,30,34,11.76
2012-07-13,6,Friday,Morning Rush,7,120,127,5.51
2012-07-13,7,Friday,Morning Rush,27,353,380,7.11
2012-07-13,8,Friday,Morning Rush,53,660,713,7.43
2012-07-13,9,Friday,Morning Rush,70,344,414,16.91
2012-07-13,10,Friday,Mid-Day,78,190,268,29.1
2012-07-13,11,Friday,Mid-Day,68,220,288,23.61
2012-07-13,12,Friday,Mid-Day,125,254,379,32.98
2012-07-13,13,Friday,Mid-Day,100,274,374,26.74
2012-07-13,14,Friday,Mid-Day,120,249,369,32.52
2012-07-13,15,Friday,Mid-Day,92,261,353,26.06
2012-07-13,16,Friday,Evening Rush,111,381,492,22.56
2012-07-13,17,Friday,Evening Rush,138,697,835,16.53
2012-07-13,18,Friday,Evening Rush,108,523,631,17.12
2012-07-13,19,Friday,Evening Rush,103,385,488,21.11
2012-07-13,20,Friday,Night,95,294,389,24.42
2012-07-13,21,Friday,Night,76,223,299,25.42
2012-07-13,22,Friday,Night,59,204,263,22.43
2012-07-13,23,Friday,Night,37,175,212,17.45
2012-07-14,0,Saturday,Early Morning,35,156,191,18.32
2012-07-14,1,Saturday,Early Morning,13,105,118,11.02
2012-07-14,2,Saturday,Early Morning,10,91,101,9.9
2012-07-14,3,Saturday,Early Morning,9,31,40,22.5
2012-07-14,4,Saturday,Early Morning,3,6,9,33.33
2012-07-14,5,Saturday,Early Morning,0,5,5,0.0
2012-07-14,6,Saturday,Morning Rush,6,29,35,17.14
2012-07-14,7,Saturday,Morning Rush,7,41,48,14.58
2012-07-14,8,Saturday,Morning Rush,33,118,151,21.85
2012-07-14,9,Saturday,Morning Rush,82,200,282,29.08
2012-07-14,10,Saturday,Mid-Day,123,278,401,30.67
2012-07-14,11,Saturday,Mid-Day,143,296,439,32.57
2012-07-14,12,Saturday,Mid-Day,181,318,499,36.27
2012-07-14,13,Saturday,Mid-Day,219,372,591,37.06
2012-07-14,14,Saturday,Mid-Day,269,363,632,42.56
2012-07-14,15,Saturday,Mid-Day,243,317,560,43.39
2012-07-14,16,Saturday,Evening Rush,226,340,566,39.93
2012-07-14,17,Saturday,Evening Rush,199,259,458,43.45
2012-07-14,18,Saturday,Evening Rush,108,243,351,30.77
2012-07-14,19,Saturday,Evening Rush,156,275,431,36.19
2012-07-14,20,Saturday,Night,101,255,356,28.37
2012-07-14,21,Saturday,Night,69,200,269,25.65
2012-07-14,22,Saturday,Night,65,160,225,28.89
2012-07-14,23,Saturday,Night,55,156,211,26.07
2012-07-15,0,Sunday,Early Morning,40,147,187,21.39
2012-07-15,1,Sunday,Early Morning,49,119,168,29.17
2012-07-15,2,Sunday,Early Morning,29,86,115,25.22
2012-07-15,3,Sunday,Early Morning,15,42,57,26.32
2012-07-15,4,Sunday,Early Morning,8,11,19,42.11
2012-07-15,5,Sunday,Early Morning,2,7,9,22.22
2012-07-15,6,Sunday,Morning Rush,6,9,15,40.0
2012-07-15,7,Sunday,Morning Rush,17,30,47,36.17
2012-07-15,8,Sunday,Morning Rush,37,96,133,27.82
2012-07-15,9,Sunday,Morning Rush,58,163,221,26.24
2012-07-15,10,Sunday,Mid-Day,141,241,382,36.91
2012-07-15,11,Sunday,Mid-Day,170,281,451,37.69
2012-07-15,12,Sunday,Mid-Day,153,336,489,31.29
2012-07-15,13,Sunday,Mid-Day,171,309,480,35.63
2012-07-15,14,Sunday,Mid-Day,162,314,476,34.03
2012-07-15,15,Sunday,Mid-Day,182,307,489,37.22
2012-07-15,16,Sunday,Evening Rush,152,343,495,30.71
2012-07-15,17,Sunday,Evening Rush,122,314,436,27.98
2012-07-15,18,Sunday,Evening Rush,84,228,312,26.92
2012-07-15,19,Sunday,Evening Rush,109,203,312,34.94
2012-07-15,20,Sunday,Night,95,199,294,32.31
2012-07-15,21,Sunday,Night,59,164,223,26.46
2012-07-15,22,Sunday,Night,34,96,130,26.15
2012-07-15,23,Sunday,Night,25,66,91,27.47
2012-07-16,0,Monday,Early Morning,11,32,43,25.58
2012-07-16,1,Monday,Early Morning,1,10,11,9.09
2012-07-16,2,Monday,Early Morning,4,11,15,26.67
2012-07-16,3,Monday,Early Morning,2,4,6,33.33
2012-07-16,4,Monday,Early Morning,1,11,12,8.33
2012-07-16,5,Monday,Early Morning,10,40,50,20.0
2012-07-16,6,Monday,Morning Rush,8,132,140,5.71
2012-07-16,7,Monday,Morning Rush,24,459,483,4.97
2012-07-16,8,Monday,Morning Rush,48,619,667,7.2
2012-07-16,9,Monday,Morning Rush,51,297,348,14.66
2012-07-16,10,Monday,Mid-Day,69,117,186,37.1
2012-07-16,11,Monday,Mid-Day,57,125,182,31.32
2012-07-16,12,Monday,Mid-Day,79,158,237,33.33
2012-07-16,13,Monday,Mid-Day,63,176,239,26.36
2012-07-16,14,Monday,Mid-Day,53,159,212,25.0
2012-07-16,15,Monday,Mid-Day,61,176,237,25.74
2012-07-16,16,Monday,Evening Rush,77,309,386,19.95
2012-07-16,17,Monday,Evening Rush,86,669,755,11.39
2012-07-16,18,Monday,Evening Rush,97,697,794,12.22
2012-07-16,19,Monday,Evening Rush,92,503,595,15.46
2012-07-16,20,Monday,Night,66,388,454,14.54
2012-07-16,21,Monday,Night,45,283,328,13.72
2012-07-16,22,Monday,Night,56,228,284,19.72
2012-07-16,23,Monday,Night,27,139,166,16.27
2012-07-17,0,Tuesday,Early Morning,10,43,53,18.87
2012-07-17,1,Tuesday,Early Morning,4,21,25,16.0
2012-07-17,2,Tuesday,Early Morning,1,6,7,14.29
2012-07-17,3,Tuesday,Early Morning,0,3,3,0.0
2012-07-17,4,Tuesday,Early Morning,0,7,7,0.0
2012-07-17,5,Tuesday,Early Morning,7,31,38,18.42
2012-07-17,6,Tuesday,Morning Rush,16,197,213,7.51
2012-07-17,7,Tuesday,Morning Rush,26,500,526,4.94
2012-07-17,8,Tuesday,Morning Rush,43,618,661,6.51
2012-07-17,9,Tuesday,Morning Rush,32,288,320,10.0
2012-07-17,10,Tuesday,Mid-Day,37,122,159,23.27
2012-07-17,11,Tuesday,Mid-Day,60,146,206,29.13
2012-07-17,12,Tuesday,Mid-Day,80,174,254,31.5
2012-07-17,13,Tuesday,Mid-Day,53,168,221,23.98
2012-07-17,14,Tuesday,Mid-Day,54,160,214,25.23
2012-07-17,15,Tuesday,Mid-Day,57,187,244,23.36
2012-07-17,16,Tuesday,Evening Rush,64,317,381,16.8
2012-07-17,17,Tuesday,Evening Rush,95,675,770,12.34
2012-07-17,18,Tuesday,Evening Rush,60,712,772,7.77
2012-07-17,19,Tuesday,Evening Rush,69,478,547,12.61
2012-07-17,20,Tuesday,Night,52,375,427,12.18
2012-07-17,21,Tuesday,Night,50,283,333,15.02
2012-07-17,22,Tuesday,Night,29,215,244,11.89
2012-07-17,23,Tuesday,Night,22,139,161,13.66
2012-07-18,0,Wednesday,Early Morning,8,45,53,15.09
2012-07-18,1,Wednesday,Early Morning,2,14,16,12.5
2012-07-18,2,Wednesday,Early Morning,3,5,8,37.5
2012-07-18,3,Wednesday,Early Morning,2,2,4,50.0
2012-07-18,4,Wednesday,Early Morning,0,6,6,0.0
2012-07-18,5,Wednesday,Early Morning,5,41,46,10.87
2012-07-18,6,Wednesday,Morning Rush,10,152,162,6.17
2012-07-18,7,Wednesday,Morning Rush,23,472,495,4.65
2012-07-18,8,Wednesday,Morning Rush,55,624,679,8.1
2012-07-18,9,Wednesday,Morning Rush,44,253,297,14.81
2012-07-18,10,Wednesday,Mid-Day,39,99,138,28.26
2012-07-18,11,Wednesday,Mid-Day,47,136,183,25.68
2012-07-18,12,Wednesday,Mid-Day,36,166,202,17.82
2012-07-18,13,Wednesday,Mid-Day,49,154,203,24.14
2012-07-18,14,Wednesday,Mid-Day,54,116,170,31.76
2012-07-18,15,Wednesday,Mid-Day,42,152,194,21.65
2012-07-18,16,Wednesday,Evening Rush,34,190,224,15.18
2012-07-18,17,Wednesday,Evening Rush,35,335,370,9.46
2012-07-18,18,Wednesday,Evening Rush,63,580,643,9.8
2012-07-18,19,Wednesday,Evening Rush,78,438,516,15.12
2012-07-18,20,Wednesday,Night,56,310,366,15.3
2012-07-18,21,Wednesday,Night,53,266,319,16.61
2012-07-18,22,Wednesday,Night,42,246,288,14.58
2012-07-18,23,Wednesday,Night,19,112,131,14.5
2012-07-19,0,Thursday,Early Morning,16,50,66,24.24
2012-07-19,1,Thursday,Early Morning,6,19,25,24.0
2012-07-19,2,Thursday,Early Morning,0,7,7,0.0
2012-07-19,3,Thursday,Early Morning,1,4,5,20.0
2012-07-19,4,Thursday,Early Morning,0,8,8,0.0
2012-07-19,5,Thursday,Early Morning,5,35,40,12.5
2012-07-19,6,Thursday,Morning Rush,8,144,152,5.26
2012-07-19,7,Thursday,Morning Rush,23,450,473,4.86
2012-07-19,8,Thursday,Morning Rush,32,625,657,4.87
2012-07-19,9,Thursday,Morning Rush,36,282,318,11.32
2012-07-19,10,Thursday,Mid-Day,41,157,198,20.71
2012-07-19,11,Thursday,Mid-Day,54,162,216,25.0
2012-07-19,12,Thursday,Mid-Day,59,215,274,21.53
2012-07-19,13,Thursday,Mid-Day,74,180,254,29.13
2012-07-19,14,Thursday,Mid-Day,46,151,197,23.35
2012-07-19,15,Thursday,Mid-Day,66,226,292,22.6
2012-07-19,16,Thursday,Evening Rush,70,288,358,19.55
2012-07-19,17,Thursday,Evening Rush,93,678,771,12.06
2012-07-19,18,Thursday,Evening Rush,93,684,777,11.97
2012-07-19,19,Thursday,Evening Rush,53,480,533,9.94
2012-07-19,20,Thursday,Night,65,440,505,12.87
2012-07-19,21,Thursday,Night,38,294,332,11.45
2012-07-19,22,Thursday,Night,6,62,68,8.82
2012-07-19,23,Thursday,Night,3,62,65,4.62
2012-07-20,0,Friday,Early Morning,2,32,34,5.88
2012-07-20,1,Friday,Early Morning,2,9,11,18.18
2012-07-20,2,Friday,Early Morning,5,14,19,26.32
2012-07-20,3,Friday,Early Morning,7,29,36,19.44
2012-07-20,4,Friday,Early Morning,3,6,9,33.33
2012-07-20,5,Friday,Early Morning,2,40,42,4.76
2012-07-20,6,Friday,Morning Rush,3,123,126,2.38
2012-07-20,7,Friday,Morning Rush,14,346,360,3.89
2012-07-20,8,Friday,Morning Rush,39,652,691,5.64
2012-07-20,9,Friday,Morning Rush,45,328,373,12.06
2012-07-20,10,Friday,Mid-Day,51,182,233,21.89
2012-07-20,11,Friday,Mid-Day,51,161,212,24.06
2012-07-20,12,Friday,Mid-Day,41,233,274,14.96
2012-07-20,13,Friday,Mid-Day,20,136,156,12.82
2012-07-20,14,Friday,Mid-Day,53,176,229,23.14
2012-07-20,15,Friday,Mid-Day,47,169,216,21.76
2012-07-20,16,Friday,Evening Rush,70,366,436,16.06
2012-07-20,17,Friday,Evening Rush,95,620,715,13.29
2012-07-20,18,Friday,Evening Rush,73,549,622,11.74
2012-07-20,19,Friday,Evening Rush,44,358,402,10.95
2012-07-20,20,Friday,Night,35,216,251,13.94
2012-07-20,21,Friday,Night,14,108,122,11.48
2012-07-20,22,Friday,Night,13,122,135,9.63
2012-07-20,23,Friday,Night,18,148,166,10.84
2012-07-21,0,Saturday,Early Morning,11,92,103,10.68
2012-07-21,1,Saturday,Early Morning,10,62,72,13.89
2012-07-21,2,Saturday,Early Morning,5,55,60,8.33
2012-07-21,3,Saturday,Early Morning,7,18,25,28.0
2012-07-21,4,Saturday,Early Morning,11,5,16,68.75
2012-07-21,5,Saturday,Early Morning,7,10,17,41.18
2012-07-21,6,Saturday,Morning Rush,3,12,15,20.0
2012-07-21,7,Saturday,Morning Rush,8,29,37,21.62
2012-07-21,8,Saturday,Morning Rush,18,94,112,16.07
2012-07-21,9,Saturday,Morning Rush,32,175,207,15.46
2012-07-21,10,Saturday,Mid-Day,49,219,268,18.28
2012-07-21,11,Saturday,Mid-Day,80,225,305,26.23
2012-07-21,12,Saturday,Mid-Day,156,301,457,34.14
2012-07-21,13,Saturday,Mid-Day,106,248,354,29.94
2012-07-21,14,Saturday,Mid-Day,121,222,343,35.28
2012-07-21,15,Saturday,Mid-Day,148,232,380,38.95
2012-07-21,16,Saturday,Evening Rush,130,196,326,39.88
2012-07-21,17,Saturday,Evening Rush,92,149,241,38.17
2012-07-21,18,Saturday,Evening Rush,51,126,177,28.81
2012-07-21,19,Saturday,Evening Rush,67,171,238,28.15
2012-07-21,20,Saturday,Night,51,163,214,23.83
2012-07-21,21,Saturday,Night,29,134,163,17.79
2012-07-21,22,Saturday,Night,40,140,180,22.22
2012-07-21,23,Saturday,Night,32,117,149,21.48
2012-07-22,0,Sunday,Early Morning,17,96,113,15.04
2012-07-22,1,Sunday,Early Morning,31,99,130,23.85
2012-07-22,2,Sunday,Early Morning,32,90,122,26.23
2012-07-22,3,Sunday,Early Morning,13,30,43,30.23
2012-07-22,4,Sunday,Early Morning,6,10,16,37.5
2012-07-22,5,Sunday,Early Morning,0,6,6,0.0
2012-07-22,6,Sunday,Morning Rush,5,14,19,26.32
2012-07-22,7,Sunday,Morning Rush,13,25,38,34.21
2012-07-22,8,Sunday,Morning Rush,31,122,153,20.26
2012-07-22,9,Sunday,Morning Rush,79,179,258,30.62
2012-07-22,10,Sunday,Mid-Day,114,265,379,30.08
2012-07-22,11,Sunday,Mid-Day,191,314,505,37.82
2012-07-22,12,Sunday,Mid-Day,178,326,504,35.32
2012-07-22,13,Sunday,Mid-Day,238,388,626,38.02
2012-07-22,14,Sunday,Mid-Day,256,360,616,41.56
2012-07-22,15,Sunday,Mid-Day,254,370,624,40.71
2012-07-22,16,Sunday,Evening Rush,245,383,628,39.01
2012-07-22,17,Sunday,Evening Rush,188,368,556,33.81
2012-07-22,18,Sunday,Evening Rush,173,342,515,33.59
2012-07-22,19,Sunday,Evening Rush,180,342,522,34.48
2012-07-22,20,Sunday,Night,124,254,378,32.8
2012-07-22,21,Sunday,Night,88,257,345,25.51
2012-07-22,22,Sunday,Night,55,136,191,28.8
2012-07-22,23,Sunday,Night,33,90,123,26.83
2012-07-23,0,Monday,Early Morning,11,36,47,23.4
2012-07-23,1,Monday,Early Morning,7,20,27,25.93
2012-07-23,2,Monday,Early Morning,3,14,17,17.65
2012-07-23,3,Monday,Early Morning,0,2,2,0.0
2012-07-23,4,Monday,Early Morning,0,8,8,0.0
2012-07-23,5,Monday,Early Morning,3,48,51,5.88
2012-07-23,6,Monday,Morning Rush,9,148,157,5.73
2012-07-23,7,Monday,Morning Rush,17,404,421,4.04
2012-07-23,8,Monday,Morning Rush,47,691,738,6.37
2012-07-23,9,Monday,Morning Rush,57,288,345,16.52
2012-07-23,10,Monday,Mid-Day,63,137,200,31.5
2012-07-23,11,Monday,Mid-Day,69,129,198,34.85
2012-07-23,12,Monday,Mid-Day,109,205,314,34.71
2012-07-23,13,Monday,Mid-Day,64,176,240,26.67
2012-07-23,14,Monday,Mid-Day,82,189,271,30.26
2012-07-23,15,Monday,Mid-Day,76,205,281,27.05
2012-07-23,16,Monday,Evening Rush,111,346,457,24.29
2012-07-23,17,Monday,Evening Rush,87,760,847,10.27
2012-07-23,18,Monday,Evening Rush,69,672,741,9.31
2012-07-23,19,Monday,Evening Rush,94,488,582,16.15
2012-07-23,20,Monday,Night,56,347,403,13.9
2012-07-23,21,Monday,Night,45,251,296,15.2
2012-07-23,22,Monday,Night,40,169,209,19.14
2012-07-23,23,Monday,Night,16,98,114,14.04
2012-07-24,0,Tuesday,Early Morning,12,52,64,18.75
2012-07-24,1,Tuesday,Early Morning,7,10,17,41.18
2012-07-24,2,Tuesday,Early Morning,6,10,16,37.5
2012-07-24,3,Tuesday,Early Morning,1,5,6,16.67
2012-07-24,4,Tuesday,Early Morning,0,6,6,0.0
2012-07-24,5,Tuesday,Early Morning,5,45,50,10.0
2012-07-24,6,Tuesday,Morning Rush,17,173,190,8.95
2012-07-24,7,Tuesday,Morning Rush,24,492,516,4.65
2012-07-24,8,Tuesday,Morning Rush,49,694,743,6.59
2012-07-24,9,Tuesday,Morning Rush,40,299,339,11.8
2012-07-24,10,Tuesday,Mid-Day,62,156,218,28.44
2012-07-24,11,Tuesday,Mid-Day,45,156,201,22.39
2012-07-24,12,Tuesday,Mid-Day,60,169,229,26.2
2012-07-24,13,Tuesday,Mid-Day,73,200,273,26.74
2012-07-24,14,Tuesday,Mid-Day,48,196,244,19.67
2012-07-24,15,Tuesday,Mid-Day,73,212,285,25.61
2012-07-24,16,Tuesday,Evening Rush,86,369,455,18.9
2012-07-24,17,Tuesday,Evening Rush,94,775,869,10.82
2012-07-24,18,Tuesday,Evening Rush,110,767,877,12.54
2012-07-24,19,Tuesday,Evening Rush,109,523,632,17.25
2012-07-24,20,Tuesday,Night,85,438,523,16.25
2012-07-24,21,Tuesday,Night,53,325,378,14.02
2012-07-24,22,Tuesday,Night,43,226,269,15.99
2012-07-24,23,Tuesday,Night,38,154,192,19.79
2012-07-25,0,Wednesday,Early Morning,9,57,66,13.64
2012-07-25,1,Wednesday,Early Morning,2,26,28,7.14
2012-07-25,2,Wednesday,Early Morning,1,11,12,8.33
2012-07-25,3,Wednesday,Early Morning,1,11,12,8.33
2012-07-25,4,Wednesday,Early Morning,0,4,4,0.0
2012-07-25,5,Wednesday,Early Morning,5,54,59,8.47
2012-07-25,6,Wednesday,Morning Rush,11,179,190,5.79
2012-07-25,7,Wednesday,Morning Rush,34,473,507,6.71
2012-07-25,8,Wednesday,Morning Rush,43,745,788,5.46
2012-07-25,9,Wednesday,Morning Rush,65,277,342,19.01
2012-07-25,10,Wednesday,Mid-Day,68,163,231,29.44
2012-07-25,11,Wednesday,Mid-Day,79,202,281,28.11
2012-07-25,12,Wednesday,Mid-Day,77,233,310,24.84
2012-07-25,13,Wednesday,Mid-Day,81,231,312,25.96
2012-07-25,14,Wednesday,Mid-Day,88,159,247,35.63
2012-07-25,15,Wednesday,Mid-Day,94,223,317,29.65
2012-07-25,16,Wednesday,Evening Rush,91,393,484,18.8
2012-07-25,17,Wednesday,Evening Rush,130,783,913,14.24
2012-07-25,18,Wednesday,Evening Rush,104,787,891,11.67
2012-07-25,19,Wednesday,Evening Rush,116,582,698,16.62
2012-07-25,20,Wednesday,Night,106,461,567,18.69
2012-07-25,21,Wednesday,Night,71,326,397,17.88
2012-07-25,22,Wednesday,Night,55,223,278,19.78
2012-07-25,23,Wednesday,Night,52,187,239,21.76
2012-07-26,0,Thursday,Early Morning,27,65,92,29.35
2012-07-26,1,Thursday,Early Morning,6,23,29,20.69
2012-07-26,2,Thursday,Early Morning,5,16,21,23.81
2012-07-26,3,Thursday,Early Morning,0,8,8,0.0
2012-07-26,4,Thursday,Early Morning,0,4,4,0.0
2012-07-26,5,Thursday,Early Morning,2,40,42,4.76
2012-07-26,6,Thursday,Morning Rush,16,165,181,8.84
2012-07-26,7,Thursday,Morning Rush,17,478,495,3.43
2012-07-26,8,Thursday,Morning Rush,49,680,729,6.72
2012-07-26,9,Thursday,Morning Rush,55,289,344,15.99
2012-07-26,10,Thursday,Mid-Day,79,143,222,35.59
2012-07-26,11,Thursday,Mid-Day,69,143,212,32.55
2012-07-26,12,Thursday,Mid-Day,73,206,279,26.16
2012-07-26,13,Thursday,Mid-Day,53,189,242,21.9
2012-07-26,14,Thursday,Mid-Day,62,151,213,29.11
2012-07-26,15,Thursday,Mid-Day,65,173,238,27.31
2012-07-26,16,Thursday,Evening Rush,62,312,374,16.58
2012-07-26,17,Thursday,Evening Rush,110,628,738,14.91
2012-07-26,18,Thursday,Evening Rush,73,615,688,10.61
2012-07-26,19,Thursday,Evening Rush,80,534,614,13.03
2012-07-26,20,Thursday,Night,47,399,446,10.54
2012-07-26,21,Thursday,Night,35,236,271,12.92
2012-07-26,22,Thursday,Night,33,201,234,14.1
2012-07-26,23,Thursday,Night,18,127,145,12.41
2012-07-27,0,Friday,Early Morning,14,83,97,14.43
2012-07-27,1,Friday,Early Morning,12,42,54,22.22
2012-07-27,2,Friday,Early Morning,8,18,26,30.77
2012-07-27,3,Friday,Early Morning,3,9,12,25.0
2012-07-27,4,Friday,Early Morning,3,5,8,37.5
2012-07-27,5,Friday,Early Morning,3,34,37,8.11
2012-07-27,6,Friday,Morning Rush,10,129,139,7.19
2012-07-27,7,Friday,Morning Rush,13,397,410,3.17
2012-07-27,8,Friday,Morning Rush,34,642,676,5.03
2012-07-27,9,Friday,Morning Rush,34,329,363,9.37
2012-07-27,10,Friday,Mid-Day,85,146,231,36.8
2012-07-27,11,Friday,Mid-Day,67,184,251,26.69
2012-07-27,12,Friday,Mid-Day,92,207,299,30.77
2012-07-27,13,Friday,Mid-Day,83,231,314,26.43
2012-07-27,14,Friday,Mid-Day,105,221,326,32.21
2012-07-27,15,Friday,Mid-Day,81,242,323,25.08
2012-07-27,16,Friday,Evening Rush,80,419,499,16.03
2012-07-27,17,Friday,Evening Rush,101,598,699,14.45
2012-07-27,18,Friday,Evening Rush,100,522,622,16.08
2012-07-27,19,Friday,Evening Rush,93,423,516,18.02
2012-07-27,20,Friday,Night,85,269,354,24.01
2012-07-27,21,Friday,Night,71,189,260,27.31
2012-07-27,22,Friday,Night,48,151,199,24.12
2012-07-27,23,Friday,Night,34,155,189,17.99
2012-07-28,0,Saturday,Early Morning,21,170,191,10.99
2012-07-28,1,Saturday,Early Morning,11,69,80,13.75
2012-07-28,2,Saturday,Early Morning,14,76,90,15.56
2012-07-28,3,Saturday,Early Morning,10,33,43,23.26
2012-07-28,4,Saturday,Early Morning,1,10,11,9.09
2012-07-28,5,Saturday,Early Morning,4,10,14,28.57
2012-07-28,6,Saturday,Morning Rush,10,40,50,20.0
2012-07-28,7,Saturday,Morning Rush,18,58,76,23.68
2012-07-28,8,Saturday,Morning Rush,36,127,163,22.09
2012-07-28,9,Saturday,Morning Rush,110,227,337,32.64
2012-07-28,10,Saturday,Mid-Day,129,266,395,32.66
2012-07-28,11,Saturday,Mid-Day,162,295,457,35.45
2012-07-28,12,Saturday,Mid-Day,157,330,487,32.24
2012-07-28,13,Saturday,Mid-Day,173,325,498,34.74
2012-07-28,14,Saturday,Mid-Day,186,308,494,37.65
2012-07-28,15,Saturday,Mid-Day,206,291,497,41.45
2012-07-28,16,Saturday,Evening Rush,208,279,487,42.71
2012-07-28,17,Saturday,Evening Rush,199,280,479,41.54
2012-07-28,18,Saturday,Evening Rush,151,330,481,31.39
2012-07-28,19,Saturday,Evening Rush,115,223,338,34.02
2012-07-28,20,Saturday,Night,79,154,233,33.91
2012-07-28,21,Saturday,Night,94,206,300,31.33
2012-07-28,22,Saturday,Night,88,188,276,31.88
2012-07-28,23,Saturday,Night,52,156,208,25.0
2012-07-29,0,Sunday,Early Morning,59,129,188,31.38
2012-07-29,1,Sunday,Early Morning,49,109,158,31.01
2012-07-29,2,Sunday,Early Morning,33,79,112,29.46
2012-07-29,3,Sunday,Early Morning,18,37,55,32.73
2012-07-29,4,Sunday,Early Morning,2,11,13,15.38
2012-07-29,5,Sunday,Early Morning,3,14,17,17.65
2012-07-29,6,Sunday,Morning Rush,6,12,18,33.33
2012-07-29,7,Sunday,Morning Rush,4,36,40,10.0
2012-07-29,8,Sunday,Morning Rush,37,90,127,29.13
2012-07-29,9,Sunday,Morning Rush,64,162,226,28.32
2012-07-29,10,Sunday,Mid-Day,123,258,381,32.28
2012-07-29,11,Sunday,Mid-Day,183,326,509,35.95
2012-07-29,12,Sunday,Mid-Day,154,357,511,30.14
2012-07-29,13,Sunday,Mid-Day,181,302,483,37.47
2012-07-29,14,Sunday,Mid-Day,231,291,522,44.25
2012-07-29,15,Sunday,Mid-Day,195,306,501,38.92
2012-07-29,16,Sunday,Evening Rush,191,330,521,36.66
2012-07-29,17,Sunday,Evening Rush,164,367,531,30.89
2012-07-29,18,Sunday,Evening Rush,117,302,419,27.92
2012-07-29,19,Sunday,Evening Rush,143,300,443,32.28
2012-07-29,20,Sunday,Night,75,228,303,24.75
2012-07-29,21,Sunday,Night,72,199,271,26.57
2012-07-29,22,Sunday,Night,31,117,148,20.95
2012-07-29,23,Sunday,Night,18,82,100,18.0
2012-07-30,0,Monday,Early Morning,12,46,58,20.69
2012-07-30,1,Monday,Early Morning,4,15,19,21.05
2012-07-30,2,Monday,Early Morning,2,6,8,25.0
2012-07-30,3,Monday,Early Morning,0,3,3,0.0
2012-07-30,4,Monday,Early Morning,0,5,5,0.0
2012-07-30,5,Monday,Early Morning,4,43,47,8.51
2012-07-30,6,Monday,Morning Rush,6,155,161,3.73
2012-07-30,7,Monday,Morning Rush,14,455,469,2.99
2012-07-30,8,Monday,Morning Rush,31,720,751,4.13
2012-07-30,9,Monday,Morning Rush,34,259,293,11.6
2012-07-30,10,Monday,Mid-Day,54,135,189,28.57
2012-07-30,11,Monday,Mid-Day,69,146,215,32.09
2012-07-30,12,Monday,Mid-Day,77,201,278,27.7
2012-07-30,13,Monday,Mid-Day,57,169,226,25.22
2012-07-30,14,Monday,Mid-Day,87,167,254,34.25
2012-07-30,15,Monday,Mid-Day,51,185,236,21.61
2012-07-30,16,Monday,Evening Rush,88,337,425,20.71
2012-07-30,17,Monday,Evening Rush,62,765,827,7.5
2012-07-30,18,Monday,Evening Rush,77,735,812,9.48
2012-07-30,19,Monday,Evening Rush,81,584,665,12.18
2012-07-30,20,Monday,Night,78,384,462,16.88
2012-07-30,21,Monday,Night,71,251,322,22.05
2012-07-30,22,Monday,Night,47,183,230,20.43
2012-07-30,23,Monday,Night,34,116,150,22.67
2012-07-31,0,Tuesday,Early Morning,11,27,38,28.95
2012-07-31,1,Tuesday,Early Morning,3,18,21,14.29
2012-07-31,2,Tuesday,Early Morning,0,8,8,0.0
2012-07-31,3,Tuesday,Early Morning,1,5,6,16.67
2012-07-31,4,Tuesday,Early Morning,0,6,6,0.0
2012-07-31,5,Tuesday,Early Morning,5,40,45,11.11
2012-07-31,6,Tuesday,Morning Rush,2,192,194,1.03
2012-07-31,7,Tuesday,Morning Rush,21,492,513,4.09
2012-07-31,8,Tuesday,Morning Rush,30,730,760,3.95
2012-07-31,9,Tuesday,Morning Rush,31,302,333,9.31
2012-07-31,10,Tuesday,Mid-Day,73,154,227,32.16
2012-07-31,11,Tuesday,Mid-Day,54,170,224,24.11
2012-07-31,12,Tuesday,Mid-Day,50,198,248,20.16
2012-07-31,13,Tuesday,Mid-Day,69,219,288,23.96
2012-07-31,14,Tuesday,Mid-Day,72,188,260,27.69
2012-07-31,15,Tuesday,Mid-Day,29,115,144,20.14
2012-07-31,16,Tuesday,Evening Rush,66,336,402,16.42
2012-07-31,17,Tuesday,Evening Rush,94,726,820,11.46
2012-07-31,18,Tuesday,Evening Rush,99,758,857,11.55
2012-07-31,19,Tuesday,Evening Rush,90,524,614,14.66
2012-07-31,20,Tuesday,Night,55,397,452,12.17
2012-07-31,21,Tuesday,Night,60,292,352,17.05
2012-07-31,22,Tuesday,Night,33,224,257,12.84
2012-07-31,23,Tuesday,Night,20,127,147,13.61
2012-08-01,0,Wednesday,Early Morning,3,44,47,6.38
2012-08-01,1,Wednesday,Early Morning,5,28,33,15.15
2012-08-01,2,Wednesday,Early Morning,0,13,13,0.0
2012-08-01,3,Wednesday,Early Morning,0,7,7,0.0
2012-08-01,4,Wednesday,Early Morning,1,3,4,25.0
2012-08-01,5,Wednesday,Early Morning,3,46,49,6.12
2012-08-01,6,Wednesday,Morning Rush,6,179,185,3.24
2012-08-01,7,Wednesday,Morning Rush,19,468,487,3.9
2012-08-01,8,Wednesday,Morning Rush,32,649,681,4.7
2012-08-01,9,Wednesday,Morning Rush,34,316,350,9.71
2012-08-01,10,Wednesday,Mid-Day,61,175,236,25.85
2012-08-01,11,Wednesday,Mid-Day,54,180,234,23.08
2012-08-01,12,Wednesday,Mid-Day,75,209,284,26.41
2012-08-01,13,Wednesday,Mid-Day,59,221,280,21.07
2012-08-01,14,Wednesday,Mid-Day,88,175,263,33.46
2012-08-01,15,Wednesday,Mid-Day,89,206,295,30.17
2012-08-01,16,Wednesday,Evening Rush,93,386,479,19.42
2012-08-01,17,Wednesday,Evening Rush,103,734,837,12.31
2012-08-01,18,Wednesday,Evening Rush,105,786,891,11.78
2012-08-01,19,Wednesday,Evening Rush,88,564,652,13.5
2012-08-01,20,Wednesday,Night,65,448,513,12.67
2012-08-01,21,Wednesday,Night,36,284,320,11.25
2012-08-01,22,Wednesday,Night,37,251,288,12.85
2012-08-01,23,Wednesday,Night,18,134,152,11.84
2012-08-02,0,Thursday,Early Morning,8,55,63,12.7
2012-08-02,1,Thursday,Early Morning,6,36,42,14.29
2012-08-02,2,Thursday,Early Morning,3,8,11,27.27
2012-08-02,3,Thursday,Early Morning,0,6,6,0.0
2012-08-02,4,Thursday,Early Morning,0,9,9,0.0
2012-08-02,5,Thursday,Early Morning,4,37,41,9.76
2012-08-02,6,Thursday,Morning Rush,6,177,183,3.28
2012-08-02,7,Thursday,Morning Rush,21,452,473,4.44
2012-08-02,8,Thursday,Morning Rush,21,718,739,2.84
2012-08-02,9,Thursday,Morning Rush,31,312,343,9.04
2012-08-02,10,Thursday,Mid-Day,51,130,181,28.18
2012-08-02,11,Thursday,Mid-Day,59,167,226,26.11
2012-08-02,12,Thursday,Mid-Day,56,230,286,19.58
2012-08-02,13,Thursday,Mid-Day,98,212,310,31.61
2012-08-02,14,Thursday,Mid-Day,54,171,225,24.0
2012-08-02,15,Thursday,Mid-Day,68,202,270,25.19
2012-08-02,16,Thursday,Evening Rush,71,335,406,17.49
2012-08-02,17,Thursday,Evening Rush,90,775,865,10.4
2012-08-02,18,Thursday,Evening Rush,86,681,767,11.21
2012-08-02,19,Thursday,Evening Rush,98,509,607,16.14
2012-08-02,20,Thursday,Night,51,376,427,11.94
2012-08-02,21,Thursday,Night,41,301,342,11.99
2012-08-02,22,Thursday,Night,35,227,262,13.36
2012-08-02,23,Thursday,Night,25,152,177,14.12
2012-08-03,0,Friday,Early Morning,15,56,71,21.13
2012-08-03,1,Friday,Early Morning,11,32,43,25.58
2012-08-03,2,Friday,Early Morning,0,14,14,0.0
2012-08-03,3,Friday,Early Morning,1,5,6,16.67
2012-08-03,4,Friday,Early Morning,1,11,12,8.33
2012-08-03,5,Friday,Early Morning,2,35,37,5.41
2012-08-03,6,Friday,Morning Rush,5,158,163,3.07
2012-08-03,7,Friday,Morning Rush,25,396,421,5.94
2012-08-03,8,Friday,Morning Rush,32,636,668,4.79
2012-08-03,9,Friday,Morning Rush,69,327,396,17.42
2012-08-03,10,Friday,Mid-Day,82,167,249,32.93
2012-08-03,11,Friday,Mid-Day,77,186,263,29.28
2012-08-03,12,Friday,Mid-Day,95,243,338,28.11
2012-08-03,13,Friday,Mid-Day,98,247,345,28.41
2012-08-03,14,Friday,Mid-Day,102,229,331,30.82
2012-08-03,15,Friday,Mid-Day,112,268,380,29.47
2012-08-03,16,Friday,Evening Rush,112,380,492,22.76
2012-08-03,17,Friday,Evening Rush,95,646,741,12.82
2012-08-03,18,Friday,Evening Rush,98,573,671,14.61
2012-08-03,19,Friday,Evening Rush,81,388,469,17.27
2012-08-03,20,Friday,Night,89,300,389,22.88
2012-08-03,21,Friday,Night,54,224,278,19.42
2012-08-03,22,Friday,Night,46,156,202,22.77
2012-08-03,23,Friday,Night,26,170,196,13.27
2012-08-04,0,Saturday,Early Morning,24,137,161,14.91
2012-08-04,1,Saturday,Early Morning,23,99,122,18.85
2012-08-04,2,Saturday,Early Morning,20,64,84,23.81
2012-08-04,3,Saturday,Early Morning,11,19,30,36.67
2012-08-04,4,Saturday,Early Morning,2,11,13,15.38
2012-08-04,5,Saturday,Early Morning,1,16,17,5.88
2012-08-04,6,Saturday,Morning Rush,12,37,49,24.49
2012-08-04,7,Saturday,Morning Rush,18,49,67,26.87
2012-08-04,8,Saturday,Morning Rush,49,132,181,27.07
2012-08-04,9,Saturday,Morning Rush,61,217,278,21.94
2012-08-04,10,Saturday,Mid-Day,108,288,396,27.27
2012-08-04,11,Saturday,Mid-Day,155,315,470,32.98
2012-08-04,12,Saturday,Mid-Day,222,325,547,40.59
2012-08-04,13,Saturday,Mid-Day,195,332,527,37.0
2012-08-04,14,Saturday,Mid-Day,183,289,472,38.77
2012-08-04,15,Saturday,Mid-Day,205,284,489,41.92
2012-08-04,16,Saturday,Evening Rush,197,253,450,43.78
2012-08-04,17,Saturday,Evening Rush,179,313,492,36.38
2012-08-04,18,Saturday,Evening Rush,169,321,490,34.49
2012-08-04,19,Saturday,Evening Rush,133,264,397,33.5
2012-08-04,20,Saturday,Night,117,195,312,37.5
2012-08-04,21,Saturday,Night,96,193,289,33.22
2012-08-04,22,Saturday,Night,104,165,269,38.66
2012-08-04,23,Saturday,Night,61,161,222,27.48
2012-08-05,0,Sunday,Early Morning,32,121,153,20.92
2012-08-05,1,Sunday,Early Morning,8,79,87,9.2
2012-08-05,2,Sunday,Early Morning,5,68,73,6.85
2012-08-05,3,Sunday,Early Morning,9,32,41,21.95
2012-08-05,4,Sunday,Early Morning,3,11,14,21.43
2012-08-05,5,Sunday,Early Morning,1,18,19,5.26
2012-08-05,6,Sunday,Morning Rush,7,12,19,36.84
2012-08-05,7,Sunday,Morning Rush,18,50,68,26.47
2012-08-05,8,Sunday,Morning Rush,27,81,108,25.0
2012-08-05,9,Sunday,Morning Rush,61,168,229,26.64
2012-08-05,10,Sunday,Mid-Day,111,253,364,30.49
2012-08-05,11,Sunday,Mid-Day,155,282,437,35.47
2012-08-05,12,Sunday,Mid-Day,161,330,491,32.79
2012-08-05,13,Sunday,Mid-Day,208,315,523,39.77
2012-08-05,14,Sunday,Mid-Day,161,365,526,30.61
2012-08-05,15,Sunday,Mid-Day,164,286,450,36.44
2012-08-05,16,Sunday,Evening Rush,143,278,421,33.97
2012-08-05,17,Sunday,Evening Rush,122,260,382,31.94
2012-08-05,18,Sunday,Evening Rush,75,154,229,32.75
2012-08-05,19,Sunday,Evening Rush,46,139,185,24.86
2012-08-05,20,Sunday,Night,53,140,193,27.46
2012-08-05,21,Sunday,Night,51,157,208,24.52
2012-08-05,22,Sunday,Night,57,100,157,36.31
2012-08-05,23,Sunday,Night,29,58,87,33.33
2012-08-06,0,Monday,Early Morning,9,24,33,27.27
2012-08-06,1,Monday,Early Morning,1,10,11,9.09
2012-08-06,2,Monday,Early Morning,0,5,5,0.0
2012-08-06,3,Monday,Early Morning,0,5,5,0.0
2012-08-06,4,Monday,Early Morning,3,8,11,27.27
2012-08-06,5,Monday,Early Morning,2,23,25,8.0
2012-08-06,6,Monday,Morning Rush,4,137,141,2.84
2012-08-06,7,Monday,Morning Rush,14,393,407,3.44
2012-08-06,8,Monday,Morning Rush,27,578,605,4.46
2012-08-06,9,Monday,Morning Rush,28,248,276,10.14
2012-08-06,10,Monday,Mid-Day,54,159,213,25.35
2012-08-06,11,Monday,Mid-Day,108,152,260,41.54
2012-08-06,12,Monday,Mid-Day,72,213,285,25.26
2012-08-06,13,Monday,Mid-Day,85,204,289,29.41
2012-08-06,14,Monday,Mid-Day,99,188,287,34.49
2012-08-06,15,Monday,Mid-Day,91,183,274,33.21
2012-08-06,16,Monday,Evening Rush,88,363,451,19.51
2012-08-06,17,Monday,Evening Rush,112,746,858,13.05
2012-08-06,18,Monday,Evening Rush,100,743,843,11.86
2012-08-06,19,Monday,Evening Rush,109,531,640,17.03
2012-08-06,20,Monday,Night,89,368,457,19.47
2012-08-06,21,Monday,Night,72,245,317,22.71
2012-08-06,22,Monday,Night,50,157,207,24.15
2012-08-06,23,Monday,Night,16,97,113,14.16
2012-08-07,0,Tuesday,Early Morning,15,32,47,31.91
2012-08-07,1,Tuesday,Early Morning,2,16,18,11.11
2012-08-07,2,Tuesday,Early Morning,6,7,13,46.15
2012-08-07,3,Tuesday,Early Morning,0,6,6,0.0
2012-08-07,4,Tuesday,Early Morning,2,7,9,22.22
2012-08-07,5,Tuesday,Early Morning,3,33,36,8.33
2012-08-07,6,Tuesday,Morning Rush,3,176,179,1.68
2012-08-07,7,Tuesday,Morning Rush,21,481,502,4.18
2012-08-07,8,Tuesday,Morning Rush,41,664,705,5.82
2012-08-07,9,Tuesday,Morning Rush,44,283,327,13.46
2012-08-07,10,Tuesday,Mid-Day,89,161,250,35.6
2012-08-07,11,Tuesday,Mid-Day,84,130,214,39.25
2012-08-07,12,Tuesday,Mid-Day,86,197,283,30.39
2012-08-07,13,Tuesday,Mid-Day,68,185,253,26.88
2012-08-07,14,Tuesday,Mid-Day,76,185,261,29.12
2012-08-07,15,Tuesday,Mid-Day,100,206,306,32.68
2012-08-07,16,Tuesday,Evening Rush,101,344,445,22.7
2012-08-07,17,Tuesday,Evening Rush,125,743,868,14.4
2012-08-07,18,Tuesday,Evening Rush,103,711,814,12.65
2012-08-07,19,Tuesday,Evening Rush,104,506,610,17.05
2012-08-07,20,Tuesday,Night,74,374,448,16.52
2012-08-07,21,Tuesday,Night,70,247,317,22.08
2012-08-07,22,Tuesday,Night,43,181,224,19.2
2012-08-07,23,Tuesday,Night,18,120,138,13.04
2012-08-08,0,Wednesday,Early Morning,12,46,58,20.69
2012-08-08,1,Wednesday,Early Morning,3,20,23,13.04
2012-08-08,2,Wednesday,Early Morning,1,5,6,16.67
2012-08-08,3,Wednesday,Early Morning,1,6,7,14.29
2012-08-08,4,Wednesday,Early Morning,1,6,7,14.29
2012-08-08,5,Wednesday,Early Morning,3,40,43,6.98
2012-08-08,6,Wednesday,Morning Rush,4,169,173,2.31
2012-08-08,7,Wednesday,Morning Rush,24,458,482,4.98
2012-08-08,8,Wednesday,Morning Rush,48,689,737,6.51
2012-08-08,9,Wednesday,Morning Rush,33,308,341,9.68
2012-08-08,10,Wednesday,Mid-Day,63,151,214,29.44
2012-08-08,11,Wednesday,Mid-Day,80,159,239,33.47
2012-08-08,12,Wednesday,Mid-Day,63,217,280,22.5
2012-08-08,13,Wednesday,Mid-Day,101,212,313,32.27
2012-08-08,14,Wednesday,Mid-Day,63,173,236,26.69
2012-08-08,15,Wednesday,Mid-Day,110,168,278,39.57
2012-08-08,16,Wednesday,Evening Rush,113,328,441,25.62
2012-08-08,17,Wednesday,Evening Rush,107,751,858,12.47
2012-08-08,18,Wednesday,Evening Rush,117,745,862,13.57
2012-08-08,19,Wednesday,Evening Rush,119,567,686,17.35
2012-08-08,20,Wednesday,Night,76,424,500,15.2
2012-08-08,21,Wednesday,Night,70,311,381,18.37
2012-08-08,22,Wednesday,Night,35,198,233,15.02
2012-08-08,23,Wednesday,Night,16,120,136,11.76
2012-08-09,0,Thursday,Early Morning,16,51,67,23.88
2012-08-09,1,Thursday,Early Morning,5,23,28,17.86
2012-08-09,2,Thursday,Early Morning,2,12,14,14.29
2012-08-09,3,Thursday,Early Morning,1,5,6,16.67
2012-08-09,4,Thursday,Early Morning,0,10,10,0.0
2012-08-09,5,Thursday,Early Morning,4,37,41,9.76
2012-08-09,6,Thursday,Morning Rush,5,162,167,2.99
2012-08-09,7,Thursday,Morning Rush,24,451,475,5.05
2012-08-09,8,Thursday,Morning Rush,28,670,698,4.01
2012-08-09,9,Thursday,Morning Rush,54,299,353,15.3
2012-08-09,10,Thursday,Mid-Day,72,133,205,35.12
2012-08-09,11,Thursday,Mid-Day,94,166,260,36.15
2012-08-09,12,Thursday,Mid-Day,85,192,277,30.69
2012-08-09,13,Thursday,Mid-Day,80,201,281,28.47
2012-08-09,14,Thursday,Mid-Day,86,161,247,34.82
2012-08-09,15,Thursday,Mid-Day,63,204,267,23.6
2012-08-09,16,Thursday,Evening Rush,97,320,417,23.26
2012-08-09,17,Thursday,Evening Rush,111,699,810,13.7
2012-08-09,18,Thursday,Evening Rush,78,733,811,9.62
2012-08-09,19,Thursday,Evening Rush,90,533,623,14.45
2012-08-09,20,Thursday,Night,91,387,478,19.04
2012-08-09,21,Thursday,Night,50,286,336,14.88
2012-08-09,22,Thursday,Night,41,218,259,15.83
2012-08-09,23,Thursday,Night,19,137,156,12.18
2012-08-10,0,Friday,Early Morning,17,68,85,20.0
2012-08-10,1,Friday,Early Morning,6,35,41,14.63
2012-08-10,2,Friday,Early Morning,6,14,20,30.0
2012-08-10,3,Friday,Early Morning,3,6,9,33.33
2012-08-10,4,Friday,Early Morning,0,7,7,0.0
2012-08-10,5,Friday,Early Morning,4,29,33,12.12
2012-08-10,6,Friday,Morning Rush,3,41,44,6.82
2012-08-10,7,Friday,Morning Rush,5,128,133,3.76
2012-08-10,8,Friday,Morning Rush,7,112,119,5.88
2012-08-10,9,Friday,Morning Rush,21,199,220,9.55
2012-08-10,10,Friday,Mid-Day,27,166,193,13.99
2012-08-10,11,Friday,Mid-Day,73,178,251,29.08
2012-08-10,12,Friday,Mid-Day,75,240,315,23.81
2012-08-10,13,Friday,Mid-Day,66,224,290,22.76
2012-08-10,14,Friday,Mid-Day,71,236,307,23.13
2012-08-10,15,Friday,Mid-Day,100,224,324,30.86
2012-08-10,16,Friday,Evening Rush,96,371,467,20.56
2012-08-10,17,Friday,Evening Rush,111,619,730,15.21
2012-08-10,18,Friday,Evening Rush,88,552,640,13.75
2012-08-10,19,Friday,Evening Rush,98,394,492,19.92
2012-08-10,20,Friday,Night,55,315,370,14.86
2012-08-10,21,Friday,Night,50,236,286,17.48
2012-08-10,22,Friday,Night,50,168,218,22.94
2012-08-10,23,Friday,Night,33,159,192,17.19
2012-08-11,0,Saturday,Early Morning,38,142,180,21.11
2012-08-11,1,Saturday,Early Morning,32,84,116,27.59
2012-08-11,2,Saturday,Early Morning,19,66,85,22.35
2012-08-11,3,Saturday,Early Morning,2,19,21,9.52
2012-08-11,4,Saturday,Early Morning,3,7,10,30.0
2012-08-11,5,Saturday,Early Morning,2,9,11,18.18
2012-08-11,6,Saturday,Morning Rush,5,18,23,21.74
2012-08-11,7,Saturday,Morning Rush,8,54,62,12.9
2012-08-11,8,Saturday,Morning Rush,30,132,162,18.52
2012-08-11,9,Saturday,Morning Rush,54,217,271,19.93
2012-08-11,10,Saturday,Mid-Day,125,282,407,30.71
2012-08-11,11,Saturday,Mid-Day,203,296,499,40.68
2012-08-11,12,Saturday,Mid-Day,214,332,546,39.19
2012-08-11,13,Saturday,Mid-Day,228,341,569,40.07
2012-08-11,14,Saturday,Mid-Day,248,290,538,46.1
2012-08-11,15,Saturday,Mid-Day,246,316,562,43.77
2012-08-11,16,Saturday,Evening Rush,227,304,531,42.75
2012-08-11,17,Saturday,Evening Rush,220,292,512,42.97
2012-08-11,18,Saturday,Evening Rush,107,193,300,35.67
2012-08-11,19,Saturday,Evening Rush,97,178,275,35.27
2012-08-11,20,Saturday,Night,31,129,160,19.38
2012-08-11,21,Saturday,Night,26,102,128,20.31
2012-08-11,22,Saturday,Night,40,128,168,23.81
2012-08-11,23,Saturday,Night,42,121,163,25.77
2012-08-12,0,Sunday,Early Morning,24,96,120,20.0
2012-08-12,1,Sunday,Early Morning,21,92,113,18.58
2012-08-12,2,Sunday,Early Morning,19,67,86,22.09
2012-08-12,3,Sunday,Early Morning,11,37,48,22.92
2012-08-12,4,Sunday,Early Morning,2,8,10,20.0
2012-08-12,5,Sunday,Early Morning,1,9,10,10.0
2012-08-12,6,Sunday,Morning Rush,2,14,16,12.5
2012-08-12,7,Sunday,Morning Rush,9,30,39,23.08
2012-08-12,8,Sunday,Morning Rush,35,84,119,29.41
2012-08-12,9,Sunday,Morning Rush,64,153,217,29.49
2012-08-12,10,Sunday,Mid-Day,88,240,328,26.83
2012-08-12,11,Sunday,Mid-Day,167,282,449,37.19
2012-08-12,12,Sunday,Mid-Day,163,342,505,32.28
2012-08-12,13,Sunday,Mid-Day,178,365,543,32.78
2012-08-12,14,Sunday,Mid-Day,213,366,579,36.79
2012-08-12,15,Sunday,Mid-Day,235,342,577,40.73
2012-08-12,16,Sunday,Evening Rush,213,300,513,41.52
2012-08-12,17,Sunday,Evening Rush,186,319,505,36.83
2012-08-12,18,Sunday,Evening Rush,164,327,491,33.4
2012-08-12,19,Sunday,Evening Rush,148,317,465,31.83
2012-08-12,20,Sunday,Night,96,204,300,32.0
2012-08-12,21,Sunday,Night,78,142,220,35.45
2012-08-12,22,Sunday,Night,40,141,181,22.1
2012-08-12,23,Sunday,Night,25,85,110,22.73
2012-08-13,0,Monday,Early Morning,14,33,47,29.79
2012-08-13,1,Monday,Early Morning,3,11,14,21.43
2012-08-13,2,Monday,Early Morning,1,8,9,11.11
2012-08-13,3,Monday,Early Morning,1,5,6,16.67
2012-08-13,4,Monday,Early Morning,0,11,11,0.0
2012-08-13,5,Monday,Early Morning,3,33,36,8.33
2012-08-13,6,Monday,Morning Rush,4,155,159,2.52
2012-08-13,7,Monday,Morning Rush,11,425,436,2.52
2012-08-13,8,Monday,Morning Rush,25,648,673,3.71
2012-08-13,9,Monday,Morning Rush,40,265,305,13.11
2012-08-13,10,Monday,Mid-Day,88,111,199,44.22
2012-08-13,11,Monday,Mid-Day,94,151,245,38.37
2012-08-13,12,Monday,Mid-Day,96,180,276,34.78
2012-08-13,13,Monday,Mid-Day,79,175,254,31.1
2012-08-13,14,Monday,Mid-Day,85,163,248,34.27
2012-08-13,15,Monday,Mid-Day,80,194,274,29.2
2012-08-13,16,Monday,Evening Rush,116,348,464,25.0
2012-08-13,17,Monday,Evening Rush,102,716,818,12.47
2012-08-13,18,Monday,Evening Rush,103,709,812,12.68
2012-08-13,19,Monday,Evening Rush,88,467,555,15.86
2012-08-13,20,Monday,Night,58,374,432,13.43
2012-08-13,21,Monday,Night,44,246,290,15.17
2012-08-13,22,Monday,Night,44,148,192,22.92
2012-08-13,23,Monday,Night,28,100,128,21.88
2012-08-14,0,Tuesday,Early Morning,12,48,60,20.0
2012-08-14,1,Tuesday,Early Morning,8,19,27,29.63
2012-08-14,2,Tuesday,Early Morning,2,9,11,18.18
2012-08-14,3,Tuesday,Early Morning,0,3,3,0.0
2012-08-14,4,Tuesday,Early Morning,0,5,5,0.0
2012-08-14,5,Tuesday,Early Morning,1,35,36,2.78
2012-08-14,6,Tuesday,Morning Rush,1,63,64,1.56
2012-08-14,7,Tuesday,Morning Rush,1,178,179,0.56
2012-08-14,8,Tuesday,Morning Rush,27,591,618,4.37
2012-08-14,9,Tuesday,Morning Rush,48,354,402,11.94
2012-08-14,10,Tuesday,Mid-Day,53,155,208,25.48
2012-08-14,11,Tuesday,Mid-Day,69,127,196,35.2
2012-08-14,12,Tuesday,Mid-Day,93,207,300,31.0
2012-08-14,13,Tuesday,Mid-Day,83,203,286,29.02
2012-08-14,14,Tuesday,Mid-Day,80,175,255,31.37
2012-08-14,15,Tuesday,Mid-Day,84,199,283,29.68
2012-08-14,16,Tuesday,Evening Rush,95,363,458,20.74
2012-08-14,17,Tuesday,Evening Rush,78,734,812,9.61
2012-08-14,18,Tuesday,Evening Rush,97,757,854,11.36
2012-08-14,19,Tuesday,Evening Rush,94,533,627,14.99
2012-08-14,20,Tuesday,Night,65,371,436,14.91
2012-08-14,21,Tuesday,Night,56,252,308,18.18
2012-08-14,22,Tuesday,Night,28,161,189,14.81
2012-08-14,23,Tuesday,Night,53,114,167,31.74
2012-08-15,0,Wednesday,Early Morning,8,52,60,13.33
2012-08-15,1,Wednesday,Early Morning,6,31,37,16.22
2012-08-15,2,Wednesday,Early Morning,1,7,8,12.5
2012-08-15,3,Wednesday,Early Morning,1,10,11,9.09
2012-08-15,4,Wednesday,Early Morning,0,4,4,0.0
2012-08-15,5,Wednesday,Early Morning,4,35,39,10.26
2012-08-15,6,Wednesday,Morning Rush,12,160,172,6.98
2012-08-15,7,Wednesday,Morning Rush,25,467,492,5.08
2012-08-15,8,Wednesday,Morning Rush,40,642,682,5.87
2012-08-15,9,Wednesday,Morning Rush,57,310,367,15.53
2012-08-15,10,Wednesday,Mid-Day,70,163,233,30.04
2012-08-15,11,Wednesday,Mid-Day,80,155,235,34.04
2012-08-15,12,Wednesday,Mid-Day,77,230,307,25.08
2012-08-15,13,Wednesday,Mid-Day,88,206,294,29.93
2012-08-15,14,Wednesday,Mid-Day,94,161,255,36.86
2012-08-15,15,Wednesday,Mid-Day,70,196,266,26.32
2012-08-15,16,Wednesday,Evening Rush,91,340,431,21.11
2012-08-15,17,Wednesday,Evening Rush,102,749,851,11.99
2012-08-15,18,Wednesday,Evening Rush,80,768,848,9.43
2012-08-15,19,Wednesday,Evening Rush,124,525,649,19.11
2012-08-15,20,Wednesday,Night,72,355,427,16.86
2012-08-15,21,Wednesday,Night,49,266,315,15.56
2012-08-15,22,Wednesday,Night,29,197,226,12.83
2012-08-15,23,Wednesday,Night,18,120,138,13.04
2012-08-16,0,Thursday,Early Morning,13,63,76,17.11
2012-08-16,1,Thursday,Early Morning,3,18,21,14.29
2012-08-16,2,Thursday,Early Morning,0,15,15,0.0
2012-08-16,3,Thursday,Early Morning,0,4,4,0.0
2012-08-16,4,Thursday,Early Morning,2,3,5,40.0
2012-08-16,5,Thursday,Early Morning,7,30,37,18.92
2012-08-16,6,Thursday,Morning Rush,3,162,165,1.82
2012-08-16,7,Thursday,Morning Rush,16,448,464,3.45
2012-08-16,8,Thursday,Morning Rush,33,649,682,4.84
2012-08-16,9,Thursday,Morning Rush,41,296,337,12.17
2012-08-16,10,Thursday,Mid-Day,78,121,199,39.2
2012-08-16,11,Thursday,Mid-Day,83,191,274,30.29
2012-08-16,12,Thursday,Mid-Day,96,247,343,27.99
2012-08-16,13,Thursday,Mid-Day,81,219,300,27.0
2012-08-16,14,Thursday,Mid-Day,72,176,248,29.03
2012-08-16,15,Thursday,Mid-Day,63,197,260,24.23
2012-08-16,16,Thursday,Evening Rush,79,340,419,18.85
2012-08-16,17,Thursday,Evening Rush,130,767,897,14.49
2012-08-16,18,Thursday,Evening Rush,109,723,832,13.1
2012-08-16,19,Thursday,Evening Rush,119,558,677,17.58
2012-08-16,20,Thursday,Night,100,414,514,19.46
2012-08-16,21,Thursday,Night,83,273,356,23.31
2012-08-16,22,Thursday,Night,69,185,254,27.17
2012-08-16,23,Thursday,Night,58,168,226,25.66
2012-08-17,0,Friday,Early Morning,21,67,88,23.86
2012-08-17,1,Friday,Early Morning,16,38,54,29.63
2012-08-17,2,Friday,Early Morning,4,15,19,21.05
2012-08-17,3,Friday,Early Morning,0,6,6,0.0
2012-08-17,4,Friday,Early Morning,0,9,9,0.0
2012-08-17,5,Friday,Early Morning,2,34,36,5.56
2012-08-17,6,Friday,Morning Rush,6,151,157,3.82
2012-08-17,7,Friday,Morning Rush,11,368,379,2.9
2012-08-17,8,Friday,Morning Rush,43,625,668,6.44
2012-08-17,9,Friday,Morning Rush,58,320,378,15.34
2012-08-17,10,Friday,Mid-Day,82,149,231,35.5
2012-08-17,11,Friday,Mid-Day,98,205,303,32.34
2012-08-17,12,Friday,Mid-Day,110,255,365,30.14
2012-08-17,13,Friday,Mid-Day,103,254,357,28.85
2012-08-17,14,Friday,Mid-Day,128,200,328,39.02
2012-08-17,15,Friday,Mid-Day,127,256,383,33.16
2012-08-17,16,Friday,Evening Rush,116,372,488,23.77
2012-08-17,17,Friday,Evening Rush,144,647,791,18.2
2012-08-17,18,Friday,Evening Rush,108,561,669,16.14
2012-08-17,19,Friday,Evening Rush,88,403,491,17.92
2012-08-17,20,Friday,Night,97,262,359,27.02
2012-08-17,21,Friday,Night,57,198,255,22.35
2012-08-17,22,Friday,Night,43,170,213,20.19
2012-08-17,23,Friday,Night,21,100,121,17.36
2012-08-18,0,Saturday,Early Morning,6,99,105,5.71
2012-08-18,1,Saturday,Early Morning,14,78,92,15.22
2012-08-18,2,Saturday,Early Morning,4,39,43,9.3
2012-08-18,3,Saturday,Early Morning,7,23,30,23.33
2012-08-18,4,Saturday,Early Morning,5,8,13,38.46
2012-08-18,5,Saturday,Early Morning,2,7,9,22.22
2012-08-18,6,Saturday,Morning Rush,4,23,27,14.81
2012-08-18,7,Saturday,Morning Rush,12,52,64,18.75
2012-08-18,8,Saturday,Morning Rush,28,161,189,14.81
2012-08-18,9,Saturday,Morning Rush,81,211,292,27.74
2012-08-18,10,Saturday,Mid-Day,166,314,480,34.58
2012-08-18,11,Saturday,Mid-Day,180,356,536,33.58
2012-08-18,12,Saturday,Mid-Day,266,388,654,40.67
2012-08-18,13,Saturday,Mid-Day,289,355,644,44.88
2012-08-18,14,Saturday,Mid-Day,242,356,598,40.47
2012-08-18,15,Saturday,Mid-Day,250,346,596,41.95
2012-08-18,16,Saturday,Evening Rush,287,354,641,44.77
2012-08-18,17,Saturday,Evening Rush,256,379,635,40.31
2012-08-18,18,Saturday,Evening Rush,225,329,554,40.61
2012-08-18,19,Saturday,Evening Rush,164,324,488,33.61
2012-08-18,20,Saturday,Night,99,242,341,29.03
2012-08-18,21,Saturday,Night,90,248,338,26.63
2012-08-18,22,Saturday,Night,90,171,261,34.48
2012-08-18,23,Saturday,Night,60,175,235,25.53
2012-08-19,0,Sunday,Early Morning,44,143,187,23.53
2012-08-19,1,Sunday,Early Morning,29,102,131,22.14
2012-08-19,2,Sunday,Early Morning,16,103,119,13.45
2012-08-19,3,Sunday,Early Morning,21,34,55,38.18
2012-08-19,4,Sunday,Early Morning,4,22,26,15.38
2012-08-19,5,Sunday,Early Morning,3,8,11,27.27
2012-08-19,6,Sunday,Morning Rush,5,15,20,25.0
2012-08-19,7,Sunday,Morning Rush,12,29,41,29.27
2012-08-19,8,Sunday,Morning Rush,34,90,124,27.42
2012-08-19,9,Sunday,Morning Rush,86,184,270,31.85
2012-08-19,10,Sunday,Mid-Day,138,287,425,32.47
2012-08-19,11,Sunday,Mid-Day,83,189,272,30.51
2012-08-19,12,Sunday,Mid-Day,112,186,298,37.58
2012-08-19,13,Sunday,Mid-Day,50,112,162,30.86
2012-08-19,14,Sunday,Mid-Day,41,108,149,27.52
2012-08-19,15,Sunday,Mid-Day,89,187,276,32.25
2012-08-19,16,Sunday,Evening Rush,97,259,356,27.25
2012-08-19,17,Sunday,Evening Rush,76,267,343,22.16
2012-08-19,18,Sunday,Evening Rush,86,291,377,22.81
2012-08-19,19,Sunday,Evening Rush,72,269,341,21.11
2012-08-19,20,Sunday,Night,61,213,274,22.26
2012-08-19,21,Sunday,Night,36,154,190,18.95
2012-08-19,22,Sunday,Night,6,50,56,10.71
2012-08-19,23,Sunday,Night,7,39,46,15.22
2012-08-20,0,Monday,Early Morning,1,25,26,3.85
2012-08-20,1,Monday,Early Morning,0,10,10,0.0
2012-08-20,2,Monday,Early Morning,0,5,5,0.0
2012-08-20,3,Monday,Early Morning,0,3,3,0.0
2012-08-20,4,Monday,Early Morning,0,7,7,0.0
2012-08-20,5,Monday,Early Morning,2,35,37,5.41
2012-08-20,6,Monday,Morning Rush,6,155,161,3.73
2012-08-20,7,Monday,Morning Rush,15,427,442,3.39
2012-08-20,8,Monday,Morning Rush,37,618,655,5.65
2012-08-20,9,Monday,Morning Rush,55,302,357,15.41
2012-08-20,10,Monday,Mid-Day,69,124,193,35.75
2012-08-20,11,Monday,Mid-Day,90,151,241,37.34
2012-08-20,12,Monday,Mid-Day,66,216,282,23.4
2012-08-20,13,Monday,Mid-Day,97,194,291,33.33
2012-08-20,14,Monday,Mid-Day,87,188,275,31.64
2012-08-20,15,Monday,Mid-Day,102,207,309,33.01
2012-08-20,16,Monday,Evening Rush,103,357,460,22.39
2012-08-20,17,Monday,Evening Rush,83,810,893,9.29
2012-08-20,18,Monday,Evening Rush,89,726,815,10.92
2012-08-20,19,Monday,Evening Rush,33,266,299,11.04
2012-08-20,20,Monday,Night,30,231,261,11.49
2012-08-20,21,Monday,Night,26,219,245,10.61
2012-08-20,22,Monday,Night,25,136,161,15.53
2012-08-20,23,Monday,Night,10,92,102,9.8
2012-08-21,0,Tuesday,Early Morning,7,52,59,11.86
2012-08-21,1,Tuesday,Early Morning,11,22,33,33.33
2012-08-21,2,Tuesday,Early Morning,1,7,8,12.5
2012-08-21,3,Tuesday,Early Morning,0,3,3,0.0
2012-08-21,4,Tuesday,Early Morning,0,4,4,0.0
2012-08-21,5,Tuesday,Early Morning,4,30,34,11.76
2012-08-21,6,Tuesday,Morning Rush,5,164,169,2.96
2012-08-21,7,Tuesday,Morning Rush,19,500,519,3.66
2012-08-21,8,Tuesday,Morning Rush,27,696,723,3.73
2012-08-21,9,Tuesday,Morning Rush,47,281,328,14.33
2012-08-21,10,Tuesday,Mid-Day,58,120,178,32.58
2012-08-21,11,Tuesday,Mid-Day,61,195,256,23.83
2012-08-21,12,Tuesday,Mid-Day,79,226,305,25.9
2012-08-21,13,Tuesday,Mid-Day,76,255,331,22.96
2012-08-21,14,Tuesday,Mid-Day,110,192,302,36.42
2012-08-21,15,Tuesday,Mid-Day,76,226,302,25.17
2012-08-21,16,Tuesday,Evening Rush,109,358,467,23.34
2012-08-21,17,Tuesday,Evening Rush,92,786,878,10.48
2012-08-21,18,Tuesday,Evening Rush,93,532,625,14.88
2012-08-21,19,Tuesday,Evening Rush,56,420,476,11.76
2012-08-21,20,Tuesday,Night,62,296,358,17.32
2012-08-21,21,Tuesday,Night,41,239,280,14.64
2012-08-21,22,Tuesday,Night,24,208,232,10.34
2012-08-21,23,Tuesday,Night,23,113,136,16.91
2012-08-22,0,Wednesday,Early Morning,9,46,55,16.36
2012-08-22,1,Wednesday,Early Morning,1,20,21,4.76
2012-08-22,2,Wednesday,Early Morning,7,10,17,41.18
2012-08-22,3,Wednesday,Early Morning,0,7,7,0.0
2012-08-22,4,Wednesday,Early Morning,1,7,8,12.5
2012-08-22,5,Wednesday,Early Morning,2,38,40,5.0
2012-08-22,6,Wednesday,Morning Rush,12,175,187,6.42
2012-08-22,7,Wednesday,Morning Rush,16,537,553,2.89
2012-08-22,8,Wednesday,Morning Rush,37,703,740,5.0
2012-08-22,9,Wednesday,Morning Rush,41,335,376,10.9
2012-08-22,10,Wednesday,Mid-Day,66,159,225,29.33
2012-08-22,11,Wednesday,Mid-Day,71,196,267,26.59
2012-08-22,12,Wednesday,Mid-Day,59,253,312,18.91
2012-08-22,13,Wednesday,Mid-Day,74,242,316,23.42
2012-08-22,14,Wednesday,Mid-Day,82,184,266,30.83
2012-08-22,15,Wednesday,Mid-Day,94,222,316,29.75
2012-08-22,16,Wednesday,Evening Rush,102,358,460,22.17
2012-08-22,17,Wednesday,Evening Rush,72,711,783,9.2
2012-08-22,18,Wednesday,Evening Rush,91,592,683,13.32
2012-08-22,19,Wednesday,Evening Rush,56,524,580,9.66
2012-08-22,20,Wednesday,Night,59,332,391,15.09
2012-08-22,21,Wednesday,Night,60,291,351,17.09
2012-08-22,22,Wednesday,Night,55,226,281,19.57
2012-08-22,23,Wednesday,Night,27,113,140,19.29
2012-08-23,0,Thursday,Early Morning,9,51,60,15.0
2012-08-23,1,Thursday,Early Morning,10,15,25,40.0
2012-08-23,2,Thursday,Early Morning,9,11,20,45.0
2012-08-23,3,Thursday,Early Morning,3,6,9,33.33
2012-08-23,4,Thursday,Early Morning,0,6,6,0.0
2012-08-23,5,Thursday,Early Morning,1,36,37,2.7
2012-08-23,6,Thursday,Morning Rush,14,178,192,7.29
2012-08-23,7,Thursday,Morning Rush,18,463,481,3.74
2012-08-23,8,Thursday,Morning Rush,45,662,707,6.36
2012-08-23,9,Thursday,Morning Rush,58,354,412,14.08
2012-08-23,10,Thursday,Mid-Day,76,157,233,32.62
2012-08-23,11,Thursday,Mid-Day,86,192,278,30.94
2012-08-23,12,Thursday,Mid-Day,97,235,332,29.22
2012-08-23,13,Thursday,Mid-Day,93,253,346,26.88
2012-08-23,14,Thursday,Mid-Day,114,191,305,37.38
2012-08-23,15,Thursday,Mid-Day,104,201,305,34.1
2012-08-23,16,Thursday,Evening Rush,121,344,465,26.02
2012-08-23,17,Thursday,Evening Rush,111,709,820,13.54
2012-08-23,18,Thursday,Evening Rush,130,811,941,13.82
2012-08-23,19,Thursday,Evening Rush,96,537,633,15.17
2012-08-23,20,Thursday,Night,70,404,474,14.77
2012-08-23,21,Thursday,Night,53,276,329,16.11
2012-08-23,22,Thursday,Night,21,177,198,10.61
2012-08-23,23,Thursday,Night,24,133,157,15.29
2012-08-24,0,Friday,Early Morning,27,84,111,24.32
2012-08-24,1,Friday,Early Morning,5,37,42,11.9
2012-08-24,2,Friday,Early Morning,1,15,16,6.25
2012-08-24,3,Friday,Early Morning,2,6,8,25.0
2012-08-24,4,Friday,Early Morning,2,6,8,25.0
2012-08-24,5,Friday,Early Morning,1,37,38,2.63
2012-08-24,6,Friday,Morning Rush,9,142,151,5.96
2012-08-24,7,Friday,Morning Rush,13,412,425,3.06
2012-08-24,8,Friday,Morning Rush,41,703,744,5.51
2012-08-24,9,Friday,Morning Rush,58,331,389,14.91
2012-08-24,10,Friday,Mid-Day,78,184,262,29.77
2012-08-24,11,Friday,Mid-Day,69,212,281,24.56
2012-08-24,12,Friday,Mid-Day,95,276,371,25.61
2012-08-24,13,Friday,Mid-Day,79,272,351,22.51
2012-08-24,14,Friday,Mid-Day,109,229,338,32.25
2012-08-24,15,Friday,Mid-Day,99,251,350,28.29
2012-08-24,16,Friday,Evening Rush,101,414,515,19.61
2012-08-24,17,Friday,Evening Rush,117,695,812,14.41
2012-08-24,18,Friday,Evening Rush,109,627,736,14.81
2012-08-24,19,Friday,Evening Rush,106,430,536,19.78
2012-08-24,20,Friday,Night,66,297,363,18.18
2012-08-24,21,Friday,Night,58,248,306,18.95
2012-08-24,22,Friday,Night,42,209,251,16.73
2012-08-24,23,Friday,Night,38,140,178,21.35
2012-08-25,0,Saturday,Early Morning,21,114,135,15.56
2012-08-25,1,Saturday,Early Morning,15,100,115,13.04
2012-08-25,2,Saturday,Early Morning,18,61,79,22.78
2012-08-25,3,Saturday,Early Morning,7,31,38,18.42
2012-08-25,4,Saturday,Early Morning,3,9,12,25.0
2012-08-25,5,Saturday,Early Morning,4,10,14,28.57
2012-08-25,6,Saturday,Morning Rush,5,25,30,16.67
2012-08-25,7,Saturday,Morning Rush,14,88,102,13.73
2012-08-25,8,Saturday,Morning Rush,29,133,162,17.9
2012-08-25,9,Saturday,Morning Rush,60,228,288,20.83
2012-08-25,10,Saturday,Mid-Day,148,294,442,33.48
2012-08-25,11,Saturday,Mid-Day,143,314,457,31.29
2012-08-25,12,Saturday,Mid-Day,217,367,584,37.16
2012-08-25,13,Saturday,Mid-Day,186,331,517,35.98
2012-08-25,14,Saturday,Mid-Day,150,332,482,31.12
2012-08-25,15,Saturday,Mid-Day,79,154,233,33.91
2012-08-25,16,Saturday,Evening Rush,174,260,434,40.09
2012-08-25,17,Saturday,Evening Rush,132,271,403,32.75
2012-08-25,18,Saturday,Evening Rush,122,261,383,31.85
2012-08-25,19,Saturday,Evening Rush,97,257,354,27.4
2012-08-25,20,Saturday,Night,65,176,241,26.97
2012-08-25,21,Saturday,Night,60,148,208,28.85
2012-08-25,22,Saturday,Night,46,136,182,25.27
2012-08-25,23,Saturday,Night,34,124,158,21.52
2012-08-26,0,Sunday,Early Morning,23,111,134,17.16
2012-08-26,1,Sunday,Early Morning,18,116,134,13.43
2012-08-26,2,Sunday,Early Morning,12,104,116,10.34
2012-08-26,3,Sunday,Early Morning,11,42,53,20.75
2012-08-26,4,Sunday,Early Morning,5,11,16,31.25
2012-08-26,5,Sunday,Early Morning,3,13,16,18.75
2012-08-26,6,Sunday,Morning Rush,5,16,21,23.81
2012-08-26,7,Sunday,Morning Rush,11,23,34,32.35
2012-08-26,8,Sunday,Morning Rush,21,112,133,15.79
2012-08-26,9,Sunday,Morning Rush,67,196,263,25.48
2012-08-26,10,Sunday,Mid-Day,127,258,385,32.99
2012-08-26,11,Sunday,Mid-Day,150,332,482,31.12
2012-08-26,12,Sunday,Mid-Day,225,401,626,35.94
2012-08-26,13,Sunday,Mid-Day,166,375,541,30.68
2012-08-26,14,Sunday,Mid-Day,125,252,377,33.16
2012-08-26,15,Sunday,Mid-Day,132,259,391,33.76
2012-08-26,16,Sunday,Evening Rush,57,116,173,32.95
2012-08-26,17,Sunday,Evening Rush,61,172,233,26.18
2012-08-26,18,Sunday,Evening Rush,77,187,264,29.17
2012-08-26,19,Sunday,Evening Rush,80,212,292,27.4
2012-08-26,20,Sunday,Night,40,171,211,18.96
2012-08-26,21,Sunday,Night,26,140,166,15.66
2012-08-26,22,Sunday,Night,20,94,114,17.54
2012-08-26,23,Sunday,Night,21,59,80,26.25
2012-08-27,0,Monday,Early Morning,4,28,32,12.5
2012-08-27,1,Monday,Early Morning,3,4,7,42.86
2012-08-27,2,Monday,Early Morning,0,8,8,0.0
2012-08-27,3,Monday,Early Morning,1,3,4,25.0
2012-08-27,4,Monday,Early Morning,1,11,12,8.33
2012-08-27,5,Monday,Early Morning,4,32,36,11.11
2012-08-27,6,Monday,Morning Rush,4,141,145,2.76
2012-08-27,7,Monday,Morning Rush,15,418,433,3.46
2012-08-27,8,Monday,Morning Rush,29,670,699,4.15
2012-08-27,9,Monday,Morning Rush,40,302,342,11.7
2012-08-27,10,Monday,Mid-Day,63,143,206,30.58
2012-08-27,11,Monday,Mid-Day,47,182,229,20.52
2012-08-27,12,Monday,Mid-Day,69,214,283,24.38
2012-08-27,13,Monday,Mid-Day,77,211,288,26.74
2012-08-27,14,Monday,Mid-Day,66,180,246,26.83
2012-08-27,15,Monday,Mid-Day,77,205,282,27.3
2012-08-27,16,Monday,Evening Rush,77,367,444,17.34
2012-08-27,17,Monday,Evening Rush,101,744,845,11.95
2012-08-27,18,Monday,Evening Rush,83,751,834,9.95
2012-08-27,19,Monday,Evening Rush,74,499,573,12.91
2012-08-27,20,Monday,Night,50,366,416,12.02
2012-08-27,21,Monday,Night,39,239,278,14.03
2012-08-27,22,Monday,Night,30,131,161,18.63
2012-08-27,23,Monday,Night,35,79,114,30.7
2012-08-28,0,Tuesday,Early Morning,9,29,38,23.68
2012-08-28,1,Tuesday,Early Morning,4,17,21,19.05
2012-08-28,2,Tuesday,Early Morning,2,13,15,13.33
2012-08-28,3,Tuesday,Early Morning,0,4,4,0.0
2012-08-28,4,Tuesday,Early Morning,2,6,8,25.0
2012-08-28,5,Tuesday,Early Morning,3,39,42,7.14
2012-08-28,6,Tuesday,Morning Rush,3,144,147,2.04
2012-08-28,7,Tuesday,Morning Rush,14,255,269,5.2
2012-08-28,8,Tuesday,Morning Rush,25,668,693,3.61
2012-08-28,9,Tuesday,Morning Rush,44,351,395,11.14
2012-08-28,10,Tuesday,Mid-Day,39,165,204,19.12
2012-08-28,11,Tuesday,Mid-Day,47,171,218,21.56
2012-08-28,12,Tuesday,Mid-Day,56,241,297,18.86
2012-08-28,13,Tuesday,Mid-Day,56,232,288,19.44
2012-08-28,14,Tuesday,Mid-Day,72,179,251,28.69
2012-08-28,15,Tuesday,Mid-Day,59,258,317,18.61
2012-08-28,16,Tuesday,Evening Rush,84,396,480,17.5
2012-08-28,17,Tuesday,Evening Rush,90,774,864,10.42
2012-08-28,18,Tuesday,Evening Rush,82,736,818,10.02
2012-08-28,19,Tuesday,Evening Rush,82,515,597,13.74
2012-08-28,20,Tuesday,Night,87,348,435,20.0
2012-08-28,21,Tuesday,Night,38,276,314,12.1
2012-08-28,22,Tuesday,Night,20,196,216,9.26
2012-08-28,23,Tuesday,Night,17,92,109,15.6
2012-08-29,0,Wednesday,Early Morning,8,39,47,17.02
2012-08-29,1,Wednesday,Early Morning,2,12,14,14.29
2012-08-29,2,Wednesday,Early Morning,2,4,6,33.33
2012-08-29,3,Wednesday,Early Morning,0,9,9,0.0
2012-08-29,4,Wednesday,Early Morning,2,8,10,20.0
2012-08-29,5,Wednesday,Early Morning,3,37,40,7.5
2012-08-29,6,Wednesday,Morning Rush,6,175,181,3.31
2012-08-29,7,Wednesday,Morning Rush,23,531,554,4.15
2012-08-29,8,Wednesday,Morning Rush,28,780,808,3.47
2012-08-29,9,Wednesday,Morning Rush,40,308,348,11.49
2012-08-29,10,Wednesday,Mid-Day,34,144,178,19.1
2012-08-29,11,Wednesday,Mid-Day,67,186,253,26.48
2012-08-29,12,Wednesday,Mid-Day,79,281,360,21.94
2012-08-29,13,Wednesday,Mid-Day,68,232,300,22.67
2012-08-29,14,Wednesday,Mid-Day,87,214,301,28.9
2012-08-29,15,Wednesday,Mid-Day,96,242,338,28.4
2012-08-29,16,Wednesday,Evening Rush,104,389,493,21.1
2012-08-29,17,Wednesday,Evening Rush,108,762,870,12.41
2012-08-29,18,Wednesday,Evening Rush,119,693,812,14.66
2012-08-29,19,Wednesday,Evening Rush,120,523,643,18.66
2012-08-29,20,Wednesday,Night,49,378,427,11.48
2012-08-29,21,Wednesday,Night,48,265,313,15.34
2012-08-29,22,Wednesday,Night,50,185,235,21.28
2012-08-29,23,Wednesday,Night,34,123,157,21.66
2012-08-30,0,Thursday,Early Morning,14,51,65,21.54
2012-08-30,1,Thursday,Early Morning,6,17,23,26.09
2012-08-30,2,Thursday,Early Morning,3,14,17,17.65
2012-08-30,3,Thursday,Early Morning,0,5,5,0.0
2012-08-30,4,Thursday,Early Morning,4,4,8,50.0
2012-08-30,5,Thursday,Early Morning,2,33,35,5.71
2012-08-30,6,Thursday,Morning Rush,8,155,163,4.91
2012-08-30,7,Thursday,Morning Rush,31,501,532,5.83
2012-08-30,8,Thursday,Morning Rush,53,701,754,7.03
2012-08-30,9,Thursday,Morning Rush,57,339,396,14.39
2012-08-30,10,Thursday,Mid-Day,73,161,234,31.2
2012-08-30,11,Thursday,Mid-Day,85,191,276,30.8
2012-08-30,12,Thursday,Mid-Day,73,221,294,24.83
2012-08-30,13,Thursday,Mid-Day,76,214,290,26.21
2012-08-30,14,Thursday,Mid-Day,74,199,273,27.11
2012-08-30,15,Thursday,Mid-Day,99,239,338,29.29
2012-08-30,16,Thursday,Evening Rush,77,405,482,15.98
2012-08-30,17,Thursday,Evening Rush,93,751,844,11.02
2012-08-30,18,Thursday,Evening Rush,109,744,853,12.78
2012-08-30,19,Thursday,Evening Rush,78,532,610,12.79
2012-08-30,20,Thursday,Night,68,403,471,14.44
2012-08-30,21,Thursday,Night,32,275,307,10.42
2012-08-30,22,Thursday,Night,38,253,291,13.06
2012-08-30,23,Thursday,Night,19,133,152,12.5
2012-08-31,0,Friday,Early Morning,13,69,82,15.85
2012-08-31,1,Friday,Early Morning,8,24,32,25.0
2012-08-31,2,Friday,Early Morning,9,11,20,45.0
2012-08-31,3,Friday,Early Morning,3,2,5,60.0
2012-08-31,4,Friday,Early Morning,0,7,7,0.0
2012-08-31,5,Friday,Early Morning,2,27,29,6.9
2012-08-31,6,Friday,Morning Rush,7,101,108,6.48
2012-08-31,7,Friday,Morning Rush,21,400,421,4.99
2012-08-31,8,Friday,Morning Rush,36,654,690,5.22
2012-08-31,9,Friday,Morning Rush,61,337,398,15.33
2012-08-31,10,Friday,Mid-Day,59,197,256,23.05
2012-08-31,11,Friday,Mid-Day,88,221,309,28.48
2012-08-31,12,Friday,Mid-Day,120,290,410,29.27
2012-08-31,13,Friday,Mid-Day,97,271,368,26.36
2012-08-31,14,Friday,Mid-Day,112,324,436,25.69
2012-08-31,15,Friday,Mid-Day,109,417,526,20.72
2012-08-31,16,Friday,Evening Rush,111,417,528,21.02
2012-08-31,17,Friday,Evening Rush,129,488,617,20.91
2012-08-31,18,Friday,Evening Rush,87,459,546,15.93
2012-08-31,19,Friday,Evening Rush,91,361,452,20.13
2012-08-31,20,Friday,Night,102,254,356,28.65
2012-08-31,21,Friday,Night,71,232,303,23.43
2012-08-31,22,Friday,Night,65,212,277,23.47
2012-08-31,23,Friday,Night,32,142,174,18.39
2012-09-01,0,Saturday,Early Morning,22,146,168,13.1
2012-09-01,1,Saturday,Early Morning,11,68,79,13.92
2012-09-01,2,Saturday,Early Morning,8,61,69,11.59
2012-09-01,3,Saturday,Early Morning,6,29,35,17.14
2012-09-01,4,Saturday,Early Morning,3,9,12,25.0
2012-09-01,5,Saturday,Early Morning,2,20,22,9.09
2012-09-01,6,Saturday,Morning Rush,13,23,36,36.11
2012-09-01,7,Saturday,Morning Rush,8,58,66,12.12
2012-09-01,8,Saturday,Morning Rush,28,134,162,17.28
2012-09-01,9,Saturday,Morning Rush,62,175,237,26.16
2012-09-01,10,Saturday,Mid-Day,128,289,417,30.7
2012-09-01,11,Saturday,Mid-Day,219,273,492,44.51
2012-09-01,12,Saturday,Mid-Day,187,284,471,39.7
2012-09-01,13,Saturday,Mid-Day,237,267,504,47.02
2012-09-01,14,Saturday,Mid-Day,240,274,514,46.69
2012-09-01,15,Saturday,Mid-Day,257,306,563,45.65
2012-09-01,16,Saturday,Evening Rush,209,253,462,45.24
2012-09-01,17,Saturday,Evening Rush,205,258,463,44.28
2012-09-01,18,Saturday,Evening Rush,184,258,442,41.63
2012-09-01,19,Saturday,Evening Rush,157,235,392,40.05
2012-09-01,20,Saturday,Night,67,140,207,32.37
2012-09-01,21,Saturday,Night,21,83,104,20.19
2012-09-01,22,Saturday,Night,21,57,78,26.92
2012-09-01,23,Saturday,Night,57,88,145,39.31
2012-09-02,0,Sunday,Early Morning,27,72,99,27.27
2012-09-02,1,Sunday,Early Morning,15,58,73,20.55
2012-09-02,2,Sunday,Early Morning,28,56,84,33.33
2012-09-02,3,Sunday,Early Morning,9,33,42,21.43
2012-09-02,4,Sunday,Early Morning,7,15,22,31.82
2012-09-02,5,Sunday,Early Morning,2,10,12,16.67
2012-09-02,6,Sunday,Morning Rush,2,13,15,13.33
2012-09-02,7,Sunday,Morning Rush,13,29,42,30.95
2012-09-02,8,Sunday,Morning Rush,30,99,129,23.26
2012-09-02,9,Sunday,Morning Rush,88,144,232,37.93
2012-09-02,10,Sunday,Mid-Day,158,230,388,40.72
2012-09-02,11,Sunday,Mid-Day,226,263,489,46.22
2012-09-02,12,Sunday,Mid-Day,248,297,545,45.5
2012-09-02,13,Sunday,Mid-Day,263,230,493,53.35
2012-09-02,14,Sunday,Mid-Day,249,208,457,54.49
2012-09-02,15,Sunday,Mid-Day,179,176,355,50.42
2012-09-02,16,Sunday,Evening Rush,222,252,474,46.84
2012-09-02,17,Sunday,Evening Rush,219,284,503,43.54
2012-09-02,18,Sunday,Evening Rush,227,273,500,45.4
2012-09-02,19,Sunday,Evening Rush,140,152,292,47.95
2012-09-02,20,Sunday,Night,63,41,104,60.58
2012-09-02,21,Sunday,Night,79,92,171,46.2
2012-09-02,22,Sunday,Night,66,100,166,39.76
2012-09-02,23,Sunday,Night,53,70,123,43.09
2012-09-03,0,Monday,Early Morning,42,62,104,40.38
2012-09-03,1,Monday,Early Morning,18,37,55,32.73
2012-09-03,2,Monday,Early Morning,10,30,40,25.0
2012-09-03,3,Monday,Early Morning,6,22,28,21.43
2012-09-03,4,Monday,Early Morning,6,5,11,54.55
2012-09-03,5,Monday,Early Morning,1,3,4,25.0
2012-09-03,6,Monday,Morning Rush,3,12,15,20.0
2012-09-03,7,Monday,Morning Rush,6,37,43,13.95
2012-09-03,8,Monday,Morning Rush,36,91,127,28.35
2012-09-03,9,Monday,Morning Rush,71,158,229,31.0
2012-09-03,10,Monday,Mid-Day,135,224,359,37.6
2012-09-03,11,Monday,Mid-Day,187,272,459,40.74
2012-09-03,12,Monday,Mid-Day,191,352,543,35.17
2012-09-03,13,Monday,Mid-Day,209,357,566,36.93
2012-09-03,14,Monday,Mid-Day,163,349,512,31.84
2012-09-03,15,Monday,Mid-Day,168,281,449,37.42
2012-09-03,16,Monday,Evening Rush,165,335,500,33.0
2012-09-03,17,Monday,Evening Rush,181,317,498,36.35
2012-09-03,18,Monday,Evening Rush,145,337,482,30.08
2012-09-03,19,Monday,Evening Rush,73,301,374,19.52
2012-09-03,20,Monday,Night,78,183,261,29.89
2012-09-03,21,Monday,Night,42,142,184,22.83
2012-09-03,22,Monday,Night,17,104,121,14.05
2012-09-03,23,Monday,Night,12,58,70,17.14
2012-09-04,0,Tuesday,Early Morning,10,19,29,34.48
2012-09-04,1,Tuesday,Early Morning,15,9,24,62.5
2012-09-04,2,Tuesday,Early Morning,1,4,5,20.0
2012-09-04,3,Tuesday,Early Morning,1,9,10,10.0
2012-09-04,4,Tuesday,Early Morning,0,8,8,0.0
2012-09-04,5,Tuesday,Early Morning,1,37,38,2.63
2012-09-04,6,Tuesday,Morning Rush,7,165,172,4.07
2012-09-04,7,Tuesday,Morning Rush,13,480,493,2.64
2012-09-04,8,Tuesday,Morning Rush,15,617,632,2.37
2012-09-04,9,Tuesday,Morning Rush,30,293,323,9.29
2012-09-04,10,Tuesday,Mid-Day,42,130,172,24.42
2012-09-04,11,Tuesday,Mid-Day,39,159,198,19.7
2012-09-04,12,Tuesday,Mid-Day,54,233,287,18.82
2012-09-04,13,Tuesday,Mid-Day,72,203,275,26.18
2012-09-04,14,Tuesday,Mid-Day,72,202,274,26.28
2012-09-04,15,Tuesday,Mid-Day,68,224,292,23.29
2012-09-04,16,Tuesday,Evening Rush,61,397,458,13.32
2012-09-04,17,Tuesday,Evening Rush,110,746,856,12.85
2012-09-04,18,Tuesday,Evening Rush,94,745,839,11.2
2012-09-04,19,Tuesday,Evening Rush,50,502,552,9.06
2012-09-04,20,Tuesday,Night,47,338,385,12.21
2012-09-04,21,Tuesday,Night,28,240,268,10.45
2012-09-04,22,Tuesday,Night,25,154,179,13.97
2012-09-04,23,Tuesday,Night,12,83,95,12.63
2012-09-05,0,Wednesday,Early Morning,10,27,37,27.03
2012-09-05,1,Wednesday,Early Morning,2,11,13,15.38
2012-09-05,2,Wednesday,Early Morning,0,9,9,0.0
2012-09-05,3,Wednesday,Early Morning,0,4,4,0.0
2012-09-05,4,Wednesday,Early Morning,2,3,5,40.0
2012-09-05,5,Wednesday,Early Morning,1,39,40,2.5
2012-09-05,6,Wednesday,Morning Rush,7,203,210,3.33
2012-09-05,7,Wednesday,Morning Rush,11,489,500,2.2
2012-09-05,8,Wednesday,Morning Rush,33,692,725,4.55
2012-09-05,9,Wednesday,Morning Rush,27,263,290,9.31
2012-09-05,10,Wednesday,Mid-Day,54,181,235,22.98
2012-09-05,11,Wednesday,Mid-Day,61,156,217,28.11
2012-09-05,12,Wednesday,Mid-Day,49,217,266,18.42
2012-09-05,13,Wednesday,Mid-Day,50,184,234,21.37
2012-09-05,14,Wednesday,Mid-Day,34,177,211,16.11
2012-09-05,15,Wednesday,Mid-Day,41,204,245,16.73
2012-09-05,16,Wednesday,Evening Rush,86,344,430,20.0
2012-09-05,17,Wednesday,Evening Rush,83,780,863,9.62
2012-09-05,18,Wednesday,Evening Rush,82,757,839,9.77
2012-09-05,19,Wednesday,Evening Rush,64,598,662,9.67
2012-09-05,20,Wednesday,Night,55,357,412,13.35
2012-09-05,21,Wednesday,Night,18,278,296,6.08
2012-09-05,22,Wednesday,Night,38,181,219,17.35
2012-09-05,23,Wednesday,Night,24,126,150,16.0
2012-09-06,0,Thursday,Early Morning,30,35,65,46.15
2012-09-06,1,Thursday,Early Morning,2,16,18,11.11
2012-09-06,2,Thursday,Early Morning,1,7,8,12.5
2012-09-06,3,Thursday,Early Morning,0,9,9,0.0
2012-09-06,4,Thursday,Early Morning,0,8,8,0.0
2012-09-06,5,Thursday,Early Morning,3,35,38,7.89
2012-09-06,6,Thursday,Morning Rush,11,189,200,5.5
2012-09-06,7,Thursday,Morning Rush,21,461,482,4.36
2012-09-06,8,Thursday,Morning Rush,24,622,646,3.72
2012-09-06,9,Thursday,Morning Rush,8,115,123,6.5
2012-09-06,10,Thursday,Mid-Day,9,40,49,18.37
2012-09-06,11,Thursday,Mid-Day,10,52,62,16.13
2012-09-06,12,Thursday,Mid-Day,11,126,137,8.03
2012-09-06,13,Thursday,Mid-Day,39,152,191,20.42
2012-09-06,14,Thursday,Mid-Day,38,178,216,17.59
2012-09-06,15,Thursday,Mid-Day,42,228,270,15.56
2012-09-06,16,Thursday,Evening Rush,42,374,416,10.1
2012-09-06,17,Thursday,Evening Rush,67,741,808,8.29
2012-09-06,18,Thursday,Evening Rush,74,761,835,8.86
2012-09-06,19,Thursday,Evening Rush,54,504,558,9.68
2012-09-06,20,Thursday,Night,50,356,406,12.32
2012-09-06,21,Thursday,Night,32,240,272,11.76
2012-09-06,22,Thursday,Night,24,193,217,11.06
2012-09-06,23,Thursday,Night,19,150,169,11.24
2012-09-07,0,Friday,Early Morning,17,79,96,17.71
2012-09-07,1,Friday,Early Morning,10,19,29,34.48
2012-09-07,2,Friday,Early Morning,1,10,11,9.09
2012-09-07,3,Friday,Early Morning,0,9,9,0.0
2012-09-07,4,Friday,Early Morning,1,7,8,12.5
2012-09-07,5,Friday,Early Morning,1,39,40,2.5
2012-09-07,6,Friday,Morning Rush,5,135,140,3.57
2012-09-07,7,Friday,Morning Rush,21,465,486,4.32
2012-09-07,8,Friday,Morning Rush,29,690,719,4.03
2012-09-07,9,Friday,Morning Rush,33,311,344,9.59
2012-09-07,10,Friday,Mid-Day,53,171,224,23.66
2012-09-07,11,Friday,Mid-Day,81,215,296,27.36
2012-09-07,12,Friday,Mid-Day,76,247,323,23.53
2012-09-07,13,Friday,Mid-Day,71,283,354,20.06
2012-09-07,14,Friday,Mid-Day,66,187,253,26.09
2012-09-07,15,Friday,Mid-Day,66,265,331,19.94
2012-09-07,16,Friday,Evening Rush,75,395,470,15.96
2012-09-07,17,Friday,Evening Rush,88,684,772,11.4
2012-09-07,18,Friday,Evening Rush,95,697,792,11.99
2012-09-07,19,Friday,Evening Rush,70,498,568,12.32
2012-09-07,20,Friday,Night,51,340,391,13.04
2012-09-07,21,Friday,Night,55,246,301,18.27
2012-09-07,22,Friday,Night,52,247,299,17.39
2012-09-07,23,Friday,Night,28,220,248,11.29
2012-09-08,0,Saturday,Early Morning,20,130,150,13.33
2012-09-08,1,Saturday,Early Morning,10,107,117,8.55
2012-09-08,2,Saturday,Early Morning,9,68,77,11.69
2012-09-08,3,Saturday,Early Morning,3,40,43,6.98
2012-09-08,4,Saturday,Early Morning,3,8,11,27.27
2012-09-08,5,Saturday,Early Morning,2,13,15,13.33
2012-09-08,6,Saturday,Morning Rush,8,26,34,23.53
2012-09-08,7,Saturday,Morning Rush,11,71,82,13.41
2012-09-08,8,Saturday,Morning Rush,33,197,230,14.35
2012-09-08,9,Saturday,Morning Rush,87,261,348,25.0
2012-09-08,10,Saturday,Mid-Day,100,322,422,23.7
2012-09-08,11,Saturday,Mid-Day,173,405,578,29.93
2012-09-08,12,Saturday,Mid-Day,220,474,694,31.7
2012-09-08,13,Saturday,Mid-Day,233,435,668,34.88
2012-09-08,14,Saturday,Mid-Day,260,366,626,41.53
2012-09-08,15,Saturday,Mid-Day,175,337,512,34.18
2012-09-08,16,Saturday,Evening Rush,19,95,114,16.67
2012-09-08,17,Saturday,Evening Rush,52,119,171,30.41
2012-09-08,18,Saturday,Evening Rush,27,140,167,16.17
2012-09-08,19,Saturday,Evening Rush,28,187,215,13.02
2012-09-08,20,Saturday,Night,28,166,194,14.43
2012-09-08,21,Saturday,Night,26,155,181,14.36
2012-09-08,22,Saturday,Night,18,176,194,9.28
2012-09-08,23,Saturday,Night,12,121,133,9.02
2012-09-09,0,Sunday,Early Morning,18,106,124,14.52
2012-09-09,1,Sunday,Early Morning,20,104,124,16.13
2012-09-09,2,Sunday,Early Morning,15,81,96,15.63
2012-09-09,3,Sunday,Early Morning,14,32,46,30.43
2012-09-09,4,Sunday,Early Morning,12,16,28,42.86
2012-09-09,5,Sunday,Early Morning,16,39,55,29.09
2012-09-09,6,Sunday,Morning Rush,11,24,35,31.43
2012-09-09,7,Sunday,Morning Rush,20,50,70,28.57
2012-09-09,8,Sunday,Morning Rush,27,143,170,15.88
2012-09-09,9,Sunday,Morning Rush,85,214,299,28.43
2012-09-09,10,Sunday,Mid-Day,172,323,495,34.75
2012-09-09,11,Sunday,Mid-Day,194,391,585,33.16
2012-09-09,12,Sunday,Mid-Day,247,510,757,32.63
2012-09-09,13,Sunday,Mid-Day,238,491,729,32.65
2012-09-09,14,Sunday,Mid-Day,232,415,647,35.86
2012-09-09,15,Sunday,Mid-Day,284,412,696,40.8
2012-09-09,16,Sunday,Evening Rush,228,473,701,32.52
2012-09-09,17,Sunday,Evening Rush,213,458,671,31.74
2012-09-09,18,Sunday,Evening Rush,156,404,560,27.86
2012-09-09,19,Sunday,Evening Rush,134,362,496,27.02
2012-09-09,20,Sunday,Night,91,265,356,25.56
2012-09-09,21,Sunday,Night,57,149,206,27.67
2012-09-09,22,Sunday,Night,64,125,189,33.86
2012-09-09,23,Sunday,Night,22,70,92,23.91
2012-09-10,0,Monday,Early Morning,6,35,41,14.63
2012-09-10,1,Monday,Early Morning,7,11,18,38.89
2012-09-10,2,Monday,Early Morning,11,6,17,64.71
2012-09-10,3,Monday,Early Morning,5,7,12,41.67
2012-09-10,4,Monday,Early Morning,1,4,5,20.0
2012-09-10,5,Monday,Early Morning,4,36,40,10.0
2012-09-10,6,Monday,Morning Rush,8,172,180,4.44
2012-09-10,7,Monday,Morning Rush,20,427,447,4.47
2012-09-10,8,Monday,Morning Rush,33,697,730,4.52
2012-09-10,9,Monday,Morning Rush,40,321,361,11.08
2012-09-10,10,Monday,Mid-Day,42,168,210,20.0
2012-09-10,11,Monday,Mid-Day,69,167,236,29.24
2012-09-10,12,Monday,Mid-Day,76,256,332,22.89
2012-09-10,13,Monday,Mid-Day,72,251,323,22.29
2012-09-10,14,Monday,Mid-Day,107,233,340,31.47
2012-09-10,15,Monday,Mid-Day,115,231,346,33.24
2012-09-10,16,Monday,Evening Rush,108,380,488,22.13
2012-09-10,17,Monday,Evening Rush,127,744,871,14.58
2012-09-10,18,Monday,Evening Rush,111,857,968,11.47
2012-09-10,19,Monday,Evening Rush,71,562,633,11.22
2012-09-10,20,Monday,Night,34,356,390,8.72
2012-09-10,21,Monday,Night,29,256,285,10.18
2012-09-10,22,Monday,Night,15,144,159,9.43
2012-09-10,23,Monday,Night,7,86,93,7.53
2012-09-11,0,Tuesday,Early Morning,5,27,32,15.63
2012-09-11,1,Tuesday,Early Morning,0,10,10,0.0
2012-09-11,2,Tuesday,Early Morning,1,5,6,16.67
2012-09-11,3,Tuesday,Early Morning,1,7,8,12.5
2012-09-11,4,Tuesday,Early Morning,1,8,9,11.11
2012-09-11,5,Tuesday,Early Morning,3,41,44,6.82
2012-09-11,6,Tuesday,Morning Rush,11,200,211,5.21
2012-09-11,7,Tuesday,Morning Rush,24,572,596,4.03
2012-09-11,8,Tuesday,Morning Rush,48,702,750,6.4
2012-09-11,9,Tuesday,Morning Rush,35,323,358,9.78
2012-09-11,10,Tuesday,Mid-Day,54,142,196,27.55
2012-09-11,11,Tuesday,Mid-Day,60,187,247,24.29
2012-09-11,12,Tuesday,Mid-Day,62,254,316,19.62
2012-09-11,13,Tuesday,Mid-Day,72,256,328,21.95
2012-09-11,14,Tuesday,Mid-Day,74,181,255,29.02
2012-09-11,15,Tuesday,Mid-Day,73,253,326,22.39
2012-09-11,16,Tuesday,Evening Rush,99,437,536,18.47
2012-09-11,17,Tuesday,Evening Rush,168,802,970,17.32
2012-09-11,18,Tuesday,Evening Rush,110,767,877,12.54
2012-09-11,19,Tuesday,Evening Rush,56,540,596,9.4
2012-09-11,20,Tuesday,Night,40,421,461,8.68
2012-09-11,21,Tuesday,Night,28,282,310,9.03
2012-09-11,22,Tuesday,Night,27,189,216,12.5
2012-09-11,23,Tuesday,Night,18,91,109,16.51
2012-09-12,0,Wednesday,Early Morning,8,41,49,16.33
2012-09-12,1,Wednesday,Early Morning,2,19,21,9.52
2012-09-12,2,Wednesday,Early Morning,2,9,11,18.18
2012-09-12,3,Wednesday,Early Morning,0,7,7,0.0
2012-09-12,4,Wednesday,Early Morning,0,5,5,0.0
2012-09-12,5,Wednesday,Early Morning,4,44,48,8.33
2012-09-12,6,Wednesday,Morning Rush,6,199,205,2.93
2012-09-12,7,Wednesday,Morning Rush,24,533,557,4.31
2012-09-12,8,Wednesday,Morning Rush,43,727,770,5.58
2012-09-12,9,Wednesday,Morning Rush,50,278,328,15.24
2012-09-12,10,Wednesday,Mid-Day,57,148,205,27.8
2012-09-12,11,Wednesday,Mid-Day,51,181,232,21.98
2012-09-12,12,Wednesday,Mid-Day,88,264,352,25.0
2012-09-12,13,Wednesday,Mid-Day,85,238,323,26.32
2012-09-12,14,Wednesday,Mid-Day,78,200,278,28.06
2012-09-12,15,Wednesday,Mid-Day,75,243,318,23.58
2012-09-12,16,Wednesday,Evening Rush,90,419,509,17.68
2012-09-12,17,Wednesday,Evening Rush,114,811,925,12.32
2012-09-12,18,Wednesday,Evening Rush,91,886,977,9.31
2012-09-12,19,Wednesday,Evening Rush,78,557,635,12.28
2012-09-12,20,Wednesday,Night,38,432,470,8.09
2012-09-12,21,Wednesday,Night,27,279,306,8.82
2012-09-12,22,Wednesday,Night,23,189,212,10.85
2012-09-12,23,Wednesday,Night,16,111,127,12.6
2012-09-13,0,Thursday,Early Morning,11,46,57,19.3
2012-09-13,1,Thursday,Early Morning,6,22,28,21.43
2012-09-13,2,Thursday,Early Morning,0,9,9,0.0
2012-09-13,3,Thursday,Early Morning,2,9,11,18.18
2012-09-13,4,Thursday,Early Morning,0,6,6,0.0
2012-09-13,5,Thursday,Early Morning,3,54,57,5.26
2012-09-13,6,Thursday,Morning Rush,9,186,195,4.62
2012-09-13,7,Thursday,Morning Rush,22,549,571,3.85
2012-09-13,8,Thursday,Morning Rush,33,725,758,4.35
2012-09-13,9,Thursday,Morning Rush,46,292,338,13.61
2012-09-13,10,Thursday,Mid-Day,63,149,212,29.72
2012-09-13,11,Thursday,Mid-Day,71,183,254,27.95
2012-09-13,12,Thursday,Mid-Day,57,240,297,19.19
2012-09-13,13,Thursday,Mid-Day,60,223,283,21.2
2012-09-13,14,Thursday,Mid-Day,60,214,274,21.9
2012-09-13,15,Thursday,Mid-Day,99,253,352,28.13
2012-09-13,16,Thursday,Evening Rush,85,406,491,17.31
2012-09-13,17,Thursday,Evening Rush,97,787,884,10.97
2012-09-13,18,Thursday,Evening Rush,108,744,852,12.68
2012-09-13,19,Thursday,Evening Rush,80,594,674,11.87
2012-09-13,20,Thursday,Night,55,408,463,11.88
2012-09-13,21,Thursday,Night,26,291,317,8.2
2012-09-13,22,Thursday,Night,28,223,251,11.16
2012-09-13,23,Thursday,Night,33,137,170,19.41
2012-09-14,0,Friday,Early Morning,24,63,87,27.59
2012-09-14,1,Friday,Early Morning,6,35,41,14.63
2012-09-14,2,Friday,Early Morning,7,23,30,23.33
2012-09-14,3,Friday,Early Morning,5,9,14,35.71
2012-09-14,4,Friday,Early Morning,1,11,12,8.33
2012-09-14,5,Friday,Early Morning,1,40,41,2.44
2012-09-14,6,Friday,Morning Rush,8,144,152,5.26
2012-09-14,7,Friday,Morning Rush,17,437,454,3.74
2012-09-14,8,Friday,Morning Rush,51,715,766,6.66
2012-09-14,9,Friday,Morning Rush,46,301,347,13.26
2012-09-14,10,Friday,Mid-Day,75,171,246,30.49
2012-09-14,11,Friday,Mid-Day,84,196,280,30.0
2012-09-14,12,Friday,Mid-Day,119,290,409,29.1
2012-09-14,13,Friday,Mid-Day,107,301,408,26.23
2012-09-14,14,Friday,Mid-Day,113,258,371,30.46
2012-09-14,15,Friday,Mid-Day,94,273,367,25.61
2012-09-14,16,Friday,Evening Rush,109,454,563,19.36
2012-09-14,17,Friday,Evening Rush,137,757,894,15.32
2012-09-14,18,Friday,Evening Rush,116,692,808,14.36
2012-09-14,19,Friday,Evening Rush,83,496,579,14.34
2012-09-14,20,Friday,Night,67,337,404,16.58
2012-09-14,21,Friday,Night,42,270,312,13.46
2012-09-14,22,Friday,Night,40,189,229,17.47
2012-09-14,23,Friday,Night,27,168,195,13.85
2012-09-15,0,Saturday,Early Morning,38,169,207,18.36
2012-09-15,1,Saturday,Early Morning,8,101,109,7.34
2012-09-15,2,Saturday,Early Morning,18,75,93,19.35
2012-09-15,3,Saturday,Early Morning,6,31,37,16.22
2012-09-15,4,Saturday,Early Morning,3,3,6,50.0
2012-09-15,5,Saturday,Early Morning,1,15,16,6.25
2012-09-15,6,Saturday,Morning Rush,6,27,33,18.18
2012-09-15,7,Saturday,Morning Rush,10,63,73,13.7
2012-09-15,8,Saturday,Morning Rush,43,169,212,20.28
2012-09-15,9,Saturday,Morning Rush,79,263,342,23.1
2012-09-15,10,Saturday,Mid-Day,119,323,442,26.92
2012-09-15,11,Saturday,Mid-Day,228,399,627,36.36
2012-09-15,12,Saturday,Mid-Day,287,419,706,40.65
2012-09-15,13,Saturday,Mid-Day,327,377,704,46.45
2012-09-15,14,Saturday,Mid-Day,325,390,715,45.45
2012-09-15,15,Saturday,Mid-Day,312,342,654,47.71
2012-09-15,16,Saturday,Evening Rush,350,433,783,44.7
2012-09-15,17,Saturday,Evening Rush,295,434,729,40.47
2012-09-15,18,Saturday,Evening Rush,232,382,614,37.79
2012-09-15,19,Saturday,Evening Rush,169,309,478,35.36
2012-09-15,20,Saturday,Night,89,241,330,26.97
2012-09-15,21,Saturday,Night,86,210,296,29.05
2012-09-15,22,Saturday,Night,82,197,279,29.39
2012-09-15,23,Saturday,Night,47,182,229,20.52
2012-09-16,0,Sunday,Early Morning,28,123,151,18.54
2012-09-16,1,Sunday,Early Morning,35,82,117,29.91
2012-09-16,2,Sunday,Early Morning,27,62,89,30.34
2012-09-16,3,Sunday,Early Morning,10,38,48,20.83
2012-09-16,4,Sunday,Early Morning,2,6,8,25.0
2012-09-16,5,Sunday,Early Morning,3,10,13,23.08
2012-09-16,6,Sunday,Morning Rush,9,26,35,25.71
2012-09-16,7,Sunday,Morning Rush,28,43,71,39.44
2012-09-16,8,Sunday,Morning Rush,34,94,128,26.56
2012-09-16,9,Sunday,Morning Rush,70,226,296,23.65
2012-09-16,10,Sunday,Mid-Day,160,330,490,32.65
2012-09-16,11,Sunday,Mid-Day,183,376,559,32.74
2012-09-16,12,Sunday,Mid-Day,188,468,656,28.66
2012-09-16,13,Sunday,Mid-Day,240,454,694,34.58
2012-09-16,14,Sunday,Mid-Day,225,410,635,35.43
2012-09-16,15,Sunday,Mid-Day,215,342,557,38.6
2012-09-16,16,Sunday,Evening Rush,194,402,596,32.55
2012-09-16,17,Sunday,Evening Rush,177,393,570,31.05
2012-09-16,18,Sunday,Evening Rush,120,361,481,24.95
2012-09-16,19,Sunday,Evening Rush,91,312,403,22.58
2012-09-16,20,Sunday,Night,57,267,324,17.59
2012-09-16,21,Sunday,Night,43,148,191,22.51
2012-09-16,22,Sunday,Night,18,109,127,14.17
2012-09-16,23,Sunday,Night,9,85,94,9.57
2012-09-17,0,Monday,Early Morning,14,31,45,31.11
2012-09-17,1,Monday,Early Morning,9,12,21,42.86
2012-09-17,2,Monday,Early Morning,5,8,13,38.46
2012-09-17,3,Monday,Early Morning,0,7,7,0.0
2012-09-17,4,Monday,Early Morning,2,9,11,18.18
2012-09-17,5,Monday,Early Morning,1,44,45,2.22
2012-09-17,6,Monday,Morning Rush,7,157,164,4.27
2012-09-17,7,Monday,Morning Rush,18,474,492,3.66
2012-09-17,8,Monday,Morning Rush,36,647,683,5.27
2012-09-17,9,Monday,Morning Rush,34,265,299,11.37
2012-09-17,10,Monday,Mid-Day,73,129,202,36.14
2012-09-17,11,Monday,Mid-Day,61,191,252,24.21
2012-09-17,12,Monday,Mid-Day,62,233,295,21.02
2012-09-17,13,Monday,Mid-Day,112,231,343,32.65
2012-09-17,14,Monday,Mid-Day,129,203,332,38.86
2012-09-17,15,Monday,Mid-Day,82,256,338,24.26
2012-09-17,16,Monday,Evening Rush,74,379,453,16.34
2012-09-17,17,Monday,Evening Rush,102,740,842,12.11
2012-09-17,18,Monday,Evening Rush,66,708,774,8.53
2012-09-17,19,Monday,Evening Rush,51,435,486,10.49
2012-09-17,20,Monday,Night,32,308,340,9.41
2012-09-17,21,Monday,Night,28,205,233,12.02
2012-09-17,22,Monday,Night,20,109,129,15.5
2012-09-17,23,Monday,Night,4,66,70,5.71
2012-09-18,0,Tuesday,Early Morning,2,11,13,15.38
2012-09-18,1,Tuesday,Early Morning,0,5,5,0.0
2012-09-18,2,Tuesday,Early Morning,0,4,4,0.0
2012-09-18,3,Tuesday,Early Morning,0,6,6,0.0
2012-09-18,4,Tuesday,Early Morning,2,5,7,28.57
2012-09-18,5,Tuesday,Early Morning,3,45,48,6.25
2012-09-18,6,Tuesday,Morning Rush,4,163,167,2.4
2012-09-18,7,Tuesday,Morning Rush,13,343,356,3.65
2012-09-18,8,Tuesday,Morning Rush,32,640,672,4.76
2012-09-18,9,Tuesday,Morning Rush,27,266,293,9.22
2012-09-18,10,Tuesday,Mid-Day,30,130,160,18.75
2012-09-18,11,Tuesday,Mid-Day,36,115,151,23.84
2012-09-18,12,Tuesday,Mid-Day,16,72,88,18.18
2012-09-18,13,Tuesday,Mid-Day,17,97,114,14.91
2012-09-18,14,Tuesday,Mid-Day,27,116,143,18.88
2012-09-18,15,Tuesday,Mid-Day,1,35,36,2.78
2012-09-18,16,Tuesday,Evening Rush,19,122,141,13.48
2012-09-18,17,Tuesday,Evening Rush,36,302,338,10.65
2012-09-18,18,Tuesday,Evening Rush,19,262,281,6.76
2012-09-18,19,Tuesday,Evening Rush,22,302,324,6.79
2012-09-18,20,Tuesday,Night,19,271,290,6.55
2012-09-18,21,Tuesday,Night,21,186,207,10.14
2012-09-18,22,Tuesday,Night,14,137,151,9.27
2012-09-18,23,Tuesday,Night,11,67,78,14.1
2012-09-19,0,Wednesday,Early Morning,3,23,26,11.54
2012-09-19,1,Wednesday,Early Morning,0,12,12,0.0
2012-09-19,2,Wednesday,Early Morning,0,3,3,0.0
2012-09-19,3,Wednesday,Early Morning,1,4,5,20.0
2012-09-19,4,Wednesday,Early Morning,0,10,10,0.0
2012-09-19,5,Wednesday,Early Morning,2,54,56,3.57
2012-09-19,6,Wednesday,Morning Rush,6,166,172,3.49
2012-09-19,7,Wednesday,Morning Rush,16,529,545,2.94
2012-09-19,8,Wednesday,Morning Rush,39,758,797,4.89
2012-09-19,9,Wednesday,Morning Rush,26,336,362,7.18
2012-09-19,10,Wednesday,Mid-Day,23,169,192,11.98
2012-09-19,11,Wednesday,Mid-Day,44,203,247,17.81
2012-09-19,12,Wednesday,Mid-Day,53,260,313,16.93
2012-09-19,13,Wednesday,Mid-Day,55,234,289,19.03
2012-09-19,14,Wednesday,Mid-Day,59,227,286,20.63
2012-09-19,15,Wednesday,Mid-Day,57,254,311,18.33
2012-09-19,16,Wednesday,Evening Rush,69,397,466,14.81
2012-09-19,17,Wednesday,Evening Rush,74,812,886,8.35
2012-09-19,18,Wednesday,Evening Rush,85,807,892,9.53
2012-09-19,19,Wednesday,Evening Rush,72,539,611,11.78
2012-09-19,20,Wednesday,Night,31,378,409,7.58
2012-09-19,21,Wednesday,Night,25,324,349,7.16
2012-09-19,22,Wednesday,Night,31,198,229,13.54
2012-09-19,23,Wednesday,Night,17,106,123,13.82
2012-09-20,0,Thursday,Early Morning,12,46,58,20.69
2012-09-20,1,Thursday,Early Morning,4,14,18,22.22
2012-09-20,2,Thursday,Early Morning,2,9,11,18.18
2012-09-20,3,Thursday,Early Morning,0,6,6,0.0
2012-09-20,4,Thursday,Early Morning,0,6,6,0.0
2012-09-20,5,Thursday,Early Morning,4,52,56,7.14
2012-09-20,6,Thursday,Morning Rush,9,161,170,5.29
2012-09-20,7,Thursday,Morning Rush,20,514,534,3.75
2012-09-20,8,Thursday,Morning Rush,44,746,790,5.57
2012-09-20,9,Thursday,Morning Rush,25,330,355,7.04
2012-09-20,10,Thursday,Mid-Day,33,157,190,17.37
2012-09-20,11,Thursday,Mid-Day,37,206,243,15.23
2012-09-20,12,Thursday,Mid-Day,57,233,290,19.66
2012-09-20,13,Thursday,Mid-Day,68,268,336,20.24
2012-09-20,14,Thursday,Mid-Day,76,222,298,25.5
2012-09-20,15,Thursday,Mid-Day,60,231,291,20.62
2012-09-20,16,Thursday,Evening Rush,72,385,457,15.75
2012-09-20,17,Thursday,Evening Rush,91,885,976,9.32
2012-09-20,18,Thursday,Evening Rush,119,781,900,13.22
2012-09-20,19,Thursday,Evening Rush,69,534,603,11.44
2012-09-20,20,Thursday,Night,57,360,417,13.67
2012-09-20,21,Thursday,Night,28,246,274,10.22
2012-09-20,22,Thursday,Night,35,252,287,12.2
2012-09-20,23,Thursday,Night,17,137,154,11.04
2012-09-21,0,Friday,Early Morning,13,53,66,19.7
2012-09-21,1,Friday,Early Morning,11,38,49,22.45
2012-09-21,2,Friday,Early Morning,6,8,14,42.86
2012-09-21,3,Friday,Early Morning,1,11,12,8.33
2012-09-21,4,Friday,Early Morning,1,9,10,10.0
2012-09-21,5,Friday,Early Morning,2,47,49,4.08
2012-09-21,6,Friday,Morning Rush,19,146,165,11.52
2012-09-21,7,Friday,Morning Rush,35,468,503,6.96
2012-09-21,8,Friday,Morning Rush,31,726,757,4.1
2012-09-21,9,Friday,Morning Rush,35,348,383,9.14
2012-09-21,10,Friday,Mid-Day,44,181,225,19.56
2012-09-21,11,Friday,Mid-Day,79,242,321,24.61
2012-09-21,12,Friday,Mid-Day,84,305,389,21.59
2012-09-21,13,Friday,Mid-Day,105,316,421,24.94
2012-09-21,14,Friday,Mid-Day,113,299,412,27.43
2012-09-21,15,Friday,Mid-Day,90,333,423,21.28
2012-09-21,16,Friday,Evening Rush,103,464,567,18.17
2012-09-21,17,Friday,Evening Rush,107,739,846,12.65
2012-09-21,18,Friday,Evening Rush,106,699,805,13.17
2012-09-21,19,Friday,Evening Rush,95,493,588,16.16
2012-09-21,20,Friday,Night,54,315,369,14.63
2012-09-21,21,Friday,Night,46,266,312,14.74
2012-09-21,22,Friday,Night,47,248,295,15.93
2012-09-21,23,Friday,Night,23,163,186,12.37
2012-09-22,0,Saturday,Early Morning,32,140,172,18.6
2012-09-22,1,Saturday,Early Morning,18,106,124,14.52
2012-09-22,2,Saturday,Early Morning,10,73,83,12.05
2012-09-22,3,Saturday,Early Morning,6,39,45,13.33
2012-09-22,4,Saturday,Early Morning,5,10,15,33.33
2012-09-22,5,Saturday,Early Morning,2,15,17,11.76
2012-09-22,6,Saturday,Morning Rush,6,35,41,14.63
2012-09-22,7,Saturday,Morning Rush,7,70,77,9.09
2012-09-22,8,Saturday,Morning Rush,21,197,218,9.63
2012-09-22,9,Saturday,Morning Rush,88,289,377,23.34
2012-09-22,10,Saturday,Mid-Day,124,350,474,26.16
2012-09-22,11,Saturday,Mid-Day,189,437,626,30.19
2012-09-22,12,Saturday,Mid-Day,228,460,688,33.14
2012-09-22,13,Saturday,Mid-Day,273,434,707,38.61
2012-09-22,14,Saturday,Mid-Day,250,404,654,38.23
2012-09-22,15,Saturday,Mid-Day,307,443,750,40.93
2012-09-22,16,Saturday,Evening Rush,253,427,680,37.21
2012-09-22,17,Saturday,Evening Rush,195,451,646,30.19
2012-09-22,18,Saturday,Evening Rush,171,427,598,28.6
2012-09-22,19,Saturday,Evening Rush,99,308,407,24.32
2012-09-22,20,Saturday,Night,76,249,325,23.38
2012-09-22,21,Saturday,Night,59,202,261,22.61
2012-09-22,22,Saturday,Night,59,180,239,24.69
2012-09-22,23,Saturday,Night,34,137,171,19.88
2012-09-23,0,Sunday,Early Morning,34,146,180,18.89
2012-09-23,1,Sunday,Early Morning,23,119,142,16.2
2012-09-23,2,Sunday,Early Morning,18,77,95,18.95
2012-09-23,3,Sunday,Early Morning,13,41,54,24.07
2012-09-23,4,Sunday,Early Morning,1,9,10,10.0
2012-09-23,5,Sunday,Early Morning,1,5,6,16.67
2012-09-23,6,Sunday,Morning Rush,5,11,16,31.25
2012-09-23,7,Sunday,Morning Rush,9,48,57,15.79
2012-09-23,8,Sunday,Morning Rush,38,137,175,21.71
2012-09-23,9,Sunday,Morning Rush,71,205,276,25.72
2012-09-23,10,Sunday,Mid-Day,138,351,489,28.22
2012-09-23,11,Sunday,Mid-Day,186,384,570,32.63
2012-09-23,12,Sunday,Mid-Day,250,526,776,32.22
2012-09-23,13,Sunday,Mid-Day,257,445,702,36.61
2012-09-23,14,Sunday,Mid-Day,266,400,666,39.94
2012-09-23,15,Sunday,Mid-Day,265,375,640,41.41
2012-09-23,16,Sunday,Evening Rush,254,437,691,36.76
2012-09-23,17,Sunday,Evening Rush,227,496,723,31.4
2012-09-23,18,Sunday,Evening Rush,135,405,540,25.0
2012-09-23,19,Sunday,Evening Rush,82,331,413,19.85
2012-09-23,20,Sunday,Night,60,192,252,23.81
2012-09-23,21,Sunday,Night,51,145,196,26.02
2012-09-23,22,Sunday,Night,40,98,138,28.99
2012-09-23,23,Sunday,Night,30,70,100,30.0
2012-09-24,0,Monday,Early Morning,10,54,64,15.63
2012-09-24,1,Monday,Early Morning,6,12,18,33.33
2012-09-24,2,Monday,Early Morning,0,8,8,0.0
2012-09-24,3,Monday,Early Morning,0,5,5,0.0
2012-09-24,4,Monday,Early Morning,0,8,8,0.0
2012-09-24,5,Monday,Early Morning,2,35,37,5.41
2012-09-24,6,Monday,Morning Rush,6,162,168,3.57
2012-09-24,7,Monday,Morning Rush,17,513,530,3.21
2012-09-24,8,Monday,Morning Rush,31,719,750,4.13
2012-09-24,9,Monday,Morning Rush,42,286,328,12.8
2012-09-24,10,Monday,Mid-Day,52,146,198,26.26
2012-09-24,11,Monday,Mid-Day,71,167,238,29.83
2012-09-24,12,Monday,Mid-Day,77,265,342,22.51
2012-09-24,13,Monday,Mid-Day,80,248,328,24.39
2012-09-24,14,Monday,Mid-Day,77,226,303,25.41
2012-09-24,15,Monday,Mid-Day,84,216,300,28.0
2012-09-24,16,Monday,Evening Rush,99,417,516,19.19
2012-09-24,17,Monday,Evening Rush,89,809,898,9.91
2012-09-24,18,Monday,Evening Rush,95,758,853,11.14
2012-09-24,19,Monday,Evening Rush,56,534,590,9.49
2012-09-24,20,Monday,Night,52,380,432,12.04
2012-09-24,21,Monday,Night,26,230,256,10.16
2012-09-24,22,Monday,Night,18,154,172,10.47
2012-09-24,23,Monday,Night,11,83,94,11.7
2012-09-25,0,Tuesday,Early Morning,8,56,64,12.5
2012-09-25,1,Tuesday,Early Morning,2,11,13,15.38
2012-09-25,2,Tuesday,Early Morning,5,9,14,35.71
2012-09-25,3,Tuesday,Early Morning,2,3,5,40.0
2012-09-25,4,Tuesday,Early Morning,2,7,9,22.22
2012-09-25,5,Tuesday,Early Morning,1,46,47,2.13
2012-09-25,6,Tuesday,Morning Rush,5,189,194,2.58
2012-09-25,7,Tuesday,Morning Rush,17,539,556,3.06
2012-09-25,8,Tuesday,Morning Rush,41,764,805,5.09
2012-09-25,9,Tuesday,Morning Rush,28,381,409,6.85
2012-09-25,10,Tuesday,Mid-Day,45,125,170,26.47
2012-09-25,11,Tuesday,Mid-Day,63,155,218,28.9
2012-09-25,12,Tuesday,Mid-Day,69,233,302,22.85
2012-09-25,13,Tuesday,Mid-Day,48,257,305,15.74
2012-09-25,14,Tuesday,Mid-Day,80,213,293,27.3
2012-09-25,15,Tuesday,Mid-Day,56,247,303,18.48
2012-09-25,16,Tuesday,Evening Rush,59,436,495,11.92
2012-09-25,17,Tuesday,Evening Rush,107,860,967,11.07
2012-09-25,18,Tuesday,Evening Rush,64,758,822,7.79
2012-09-25,19,Tuesday,Evening Rush,49,490,539,9.09
2012-09-25,20,Tuesday,Night,37,388,425,8.71
2012-09-25,21,Tuesday,Night,34,263,297,11.45
2012-09-25,22,Tuesday,Night,14,174,188,7.45
2012-09-25,23,Tuesday,Night,9,89,98,9.18
2012-09-26,0,Wednesday,Early Morning,6,34,40,15.0
2012-09-26,1,Wednesday,Early Morning,10,19,29,34.48
2012-09-26,2,Wednesday,Early Morning,2,15,17,11.76
2012-09-26,3,Wednesday,Early Morning,4,6,10,40.0
2012-09-26,4,Wednesday,Early Morning,2,12,14,14.29
2012-09-26,5,Wednesday,Early Morning,1,35,36,2.78
2012-09-26,6,Wednesday,Morning Rush,3,179,182,1.65
2012-09-26,7,Wednesday,Morning Rush,9,523,532,1.69
2012-09-26,8,Wednesday,Morning Rush,30,808,838,3.58
2012-09-26,9,Wednesday,Morning Rush,27,307,334,8.08
2012-09-26,10,Wednesday,Mid-Day,29,156,185,15.68
2012-09-26,11,Wednesday,Mid-Day,46,181,227,20.26
2012-09-26,12,Wednesday,Mid-Day,56,260,316,17.72
2012-09-26,13,Wednesday,Mid-Day,67,273,340,19.71
2012-09-26,14,Wednesday,Mid-Day,60,217,277,21.66
2012-09-26,15,Wednesday,Mid-Day,69,231,300,23.0
2012-09-26,16,Wednesday,Evening Rush,71,397,468,15.17
2012-09-26,17,Wednesday,Evening Rush,77,876,953,8.08
2012-09-26,18,Wednesday,Evening Rush,69,815,884,7.81
2012-09-26,19,Wednesday,Evening Rush,38,589,627,6.06
2012-09-26,20,Wednesday,Night,45,389,434,10.37
2012-09-26,21,Wednesday,Night,32,328,360,8.89
2012-09-26,22,Wednesday,Night,21,194,215,9.77
2012-09-26,23,Wednesday,Night,13,102,115,11.3
2012-09-27,0,Thursday,Early Morning,5,60,65,7.69
2012-09-27,1,Thursday,Early Morning,5,16,21,23.81
2012-09-27,2,Thursday,Early Morning,3,13,16,18.75
2012-09-27,3,Thursday,Early Morning,0,7,7,0.0
2012-09-27,4,Thursday,Early Morning,2,6,8,25.0
2012-09-27,5,Thursday,Early Morning,2,64,66,3.03
2012-09-27,6,Thursday,Morning Rush,5,164,169,2.96
2012-09-27,7,Thursday,Morning Rush,12,546,558,2.15
2012-09-27,8,Thursday,Morning Rush,20,774,794,2.52
2012-09-27,9,Thursday,Morning Rush,30,305,335,8.96
2012-09-27,10,Thursday,Mid-Day,40,168,208,19.23
2012-09-27,11,Thursday,Mid-Day,67,227,294,22.79
2012-09-27,12,Thursday,Mid-Day,63,272,335,18.81
2012-09-27,13,Thursday,Mid-Day,61,265,326,18.71
2012-09-27,14,Thursday,Mid-Day,44,214,258,17.05
2012-09-27,15,Thursday,Mid-Day,41,255,296,13.85
2012-09-27,16,Thursday,Evening Rush,73,399,472,15.47
2012-09-27,17,Thursday,Evening Rush,87,818,905,9.61
2012-09-27,18,Thursday,Evening Rush,77,822,899,8.57
2012-09-27,19,Thursday,Evening Rush,48,511,559,8.59
2012-09-27,20,Thursday,Night,45,412,457,9.85
2012-09-27,21,Thursday,Night,18,235,253,7.11
2012-09-27,22,Thursday,Night,2,45,47,4.26
2012-09-27,23,Thursday,Night,1,44,45,2.22
2012-09-28,0,Friday,Early Morning,2,15,17,11.76
2012-09-28,1,Friday,Early Morning,0,13,13,0.0
2012-09-28,2,Friday,Early Morning,1,9,10,10.0
2012-09-28,3,Friday,Early Morning,0,7,7,0.0
2012-09-28,4,Friday,Early Morning,2,10,12,16.67
2012-09-28,5,Friday,Early Morning,1,37,38,2.63
2012-09-28,6,Friday,Morning Rush,2,136,138,1.45
2012-09-28,7,Friday,Morning Rush,10,384,394,2.54
2012-09-28,8,Friday,Morning Rush,31,674,705,4.4
2012-09-28,9,Friday,Morning Rush,27,399,426,6.34
2012-09-28,10,Friday,Mid-Day,51,194,245,20.82
2012-09-28,11,Friday,Mid-Day,109,252,361,30.19
2012-09-28,12,Friday,Mid-Day,94,286,380,24.74
2012-09-28,13,Friday,Mid-Day,106,304,410,25.85
2012-09-28,14,Friday,Mid-Day,105,294,399,26.32
2012-09-28,15,Friday,Mid-Day,104,288,392,26.53
2012-09-28,16,Friday,Evening Rush,83,419,502,16.53
2012-09-28,17,Friday,Evening Rush,101,707,808,12.5
2012-09-28,18,Friday,Evening Rush,58,609,667,8.7
2012-09-28,19,Friday,Evening Rush,38,470,508,7.48
2012-09-28,20,Friday,Night,32,304,336,9.52
2012-09-28,21,Friday,Night,32,205,237,13.5
2012-09-28,22,Friday,Night,30,190,220,13.64
2012-09-28,23,Friday,Night,26,164,190,13.68
2012-09-29,0,Saturday,Early Morning,15,134,149,10.07
2012-09-29,1,Saturday,Early Morning,12,89,101,11.88
2012-09-29,2,Saturday,Early Morning,12,80,92,13.04
2012-09-29,3,Saturday,Early Morning,4,25,29,13.79
2012-09-29,4,Saturday,Early Morning,6,8,14,42.86
2012-09-29,5,Saturday,Early Morning,2,13,15,13.33
2012-09-29,6,Saturday,Morning Rush,4,33,37,10.81
2012-09-29,7,Saturday,Morning Rush,12,61,73,16.44
2012-09-29,8,Saturday,Morning Rush,37,174,211,17.54
2012-09-29,9,Saturday,Morning Rush,69,263,332,20.78
2012-09-29,10,Saturday,Mid-Day,134,338,472,28.39
2012-09-29,11,Saturday,Mid-Day,217,446,663,32.73
2012-09-29,12,Saturday,Mid-Day,191,491,682,28.01
2012-09-29,13,Saturday,Mid-Day,233,453,686,33.97
2012-09-29,14,Saturday,Mid-Day,302,448,750,40.27
2012-09-29,15,Saturday,Mid-Day,271,456,727,37.28
2012-09-29,16,Saturday,Evening Rush,275,447,722,38.09
2012-09-29,17,Saturday,Evening Rush,256,456,712,35.96
2012-09-29,18,Saturday,Evening Rush,174,420,594,29.29
2012-09-29,19,Saturday,Evening Rush,119,351,470,25.32
2012-09-29,20,Saturday,Night,88,227,315,27.94
2012-09-29,21,Saturday,Night,73,219,292,25.0
2012-09-29,22,Saturday,Night,48,173,221,21.72
2012-09-29,23,Saturday,Night,35,161,196,17.86
2012-09-30,0,Sunday,Early Morning,35,112,147,23.81
2012-09-30,1,Sunday,Early Morning,31,85,116,26.72
2012-09-30,2,Sunday,Early Morning,21,71,92,22.83
2012-09-30,3,Sunday,Early Morning,17,41,58,29.31
2012-09-30,4,Sunday,Early Morning,1,6,7,14.29
2012-09-30,5,Sunday,Early Morning,1,9,10,10.0
2012-09-30,6,Sunday,Morning Rush,2,20,22,9.09
2012-09-30,7,Sunday,Morning Rush,14,43,57,24.56
2012-09-30,8,Sunday,Morning Rush,18,126,144,12.5
2012-09-30,9,Sunday,Morning Rush,74,211,285,25.96
2012-09-30,10,Sunday,Mid-Day,160,319,479,33.4
2012-09-30,11,Sunday,Mid-Day,222,369,591,37.56
2012-09-30,12,Sunday,Mid-Day,206,474,680,30.29
2012-09-30,13,Sunday,Mid-Day,180,414,594,30.3
2012-09-30,14,Sunday,Mid-Day,208,404,612,33.99
2012-09-30,15,Sunday,Mid-Day,230,419,649,35.44
2012-09-30,16,Sunday,Evening Rush,202,446,648,31.17
2012-09-30,17,Sunday,Evening Rush,195,380,575,33.91
2012-09-30,18,Sunday,Evening Rush,91,310,401,22.69
2012-09-30,19,Sunday,Evening Rush,34,223,257,13.23
2012-09-30,20,Sunday,Night,31,163,194,15.98
2012-09-30,21,Sunday,Night,19,104,123,15.45
2012-09-30,22,Sunday,Night,15,76,91,16.48
2012-09-30,23,Sunday,Night,8,49,57,14.04
2012-10-01,0,Monday,Early Morning,6,39,45,13.33
2012-10-01,1,Monday,Early Morning,5,13,18,27.78
2012-10-01,2,Monday,Early Morning,6,6,12,50.0
2012-10-01,3,Monday,Early Morning,1,6,7,14.29
2012-10-01,4,Monday,Early Morning,0,10,10,0.0
2012-10-01,5,Monday,Early Morning,2,34,36,5.56
2012-10-01,6,Monday,Morning Rush,8,147,155,5.16
2012-10-01,7,Monday,Morning Rush,13,470,483,2.69
2012-10-01,8,Monday,Morning Rush,40,744,784,5.1
2012-10-01,9,Monday,Morning Rush,26,314,340,7.65
2012-10-01,10,Monday,Mid-Day,44,135,179,24.58
2012-10-01,11,Monday,Mid-Day,76,196,272,27.94
2012-10-01,12,Monday,Mid-Day,61,262,323,18.89
2012-10-01,13,Monday,Mid-Day,80,225,305,26.23
2012-10-01,14,Monday,Mid-Day,51,193,244,20.9
2012-10-01,15,Monday,Mid-Day,95,234,329,28.88
2012-10-01,16,Monday,Evening Rush,51,408,459,11.11
2012-10-01,17,Monday,Evening Rush,65,791,856,7.59
2012-10-01,18,Monday,Evening Rush,42,571,613,6.85
2012-10-01,19,Monday,Evening Rush,33,483,516,6.4
2012-10-01,20,Monday,Night,11,251,262,4.2
2012-10-01,21,Monday,Night,13,205,218,5.96
2012-10-01,22,Monday,Night,17,190,207,8.21
2012-10-01,23,Monday,Night,17,88,105,16.19
2012-10-02,0,Tuesday,Early Morning,1,30,31,3.23
2012-10-02,1,Tuesday,Early Morning,0,11,11,0.0
2012-10-02,2,Tuesday,Early Morning,0,2,2,0.0
2012-10-02,3,Tuesday,Early Morning,1,4,5,20.0
2012-10-02,4,Tuesday,Early Morning,2,8,10,20.0
2012-10-02,5,Tuesday,Early Morning,1,42,43,2.33
2012-10-02,6,Tuesday,Morning Rush,3,176,179,1.68
2012-10-02,7,Tuesday,Morning Rush,4,256,260,1.54
2012-10-02,8,Tuesday,Morning Rush,6,128,134,4.48
2012-10-02,9,Tuesday,Morning Rush,3,83,86,3.49
2012-10-02,10,Tuesday,Mid-Day,3,42,45,6.67
2012-10-02,11,Tuesday,Mid-Day,7,92,99,7.07
2012-10-02,12,Tuesday,Mid-Day,6,98,104,5.77
2012-10-02,13,Tuesday,Mid-Day,6,148,154,3.9
2012-10-02,14,Tuesday,Mid-Day,16,147,163,9.82
2012-10-02,15,Tuesday,Mid-Day,14,195,209,6.7
2012-10-02,16,Tuesday,Evening Rush,46,328,374,12.3
2012-10-02,17,Tuesday,Evening Rush,38,677,715,5.31
2012-10-02,18,Tuesday,Evening Rush,48,639,687,6.99
2012-10-02,19,Tuesday,Evening Rush,27,368,395,6.84
2012-10-02,20,Tuesday,Night,20,286,306,6.54
2012-10-02,21,Tuesday,Night,24,265,289,8.3
2012-10-02,22,Tuesday,Night,28,212,240,11.67
2012-10-02,23,Tuesday,Night,11,87,98,11.22
2012-10-03,0,Wednesday,Early Morning,5,47,52,9.62
2012-10-03,1,Wednesday,Early Morning,3,16,19,15.79
2012-10-03,2,Wednesday,Early Morning,2,7,9,22.22
2012-10-03,3,Wednesday,Early Morning,0,7,7,0.0
2012-10-03,4,Wednesday,Early Morning,2,9,11,18.18
2012-10-03,5,Wednesday,Early Morning,2,32,34,5.88
2012-10-03,6,Wednesday,Morning Rush,4,173,177,2.26
2012-10-03,7,Wednesday,Morning Rush,11,504,515,2.14
2012-10-03,8,Wednesday,Morning Rush,28,781,809,3.46
2012-10-03,9,Wednesday,Morning Rush,30,332,362,8.29
2012-10-03,10,Wednesday,Mid-Day,29,146,175,16.57
2012-10-03,11,Wednesday,Mid-Day,52,178,230,22.61
2012-10-03,12,Wednesday,Mid-Day,69,289,358,19.27
2012-10-03,13,Wednesday,Mid-Day,55,224,279,19.71
2012-10-03,14,Wednesday,Mid-Day,56,195,251,22.31
2012-10-03,15,Wednesday,Mid-Day,59,260,319,18.5
2012-10-03,16,Wednesday,Evening Rush,42,436,478,8.79
2012-10-03,17,Wednesday,Evening Rush,84,833,917,9.16
2012-10-03,18,Wednesday,Evening Rush,54,756,810,6.67
2012-10-03,19,Wednesday,Evening Rush,49,544,593,8.26
2012-10-03,20,Wednesday,Night,48,449,497,9.66
2012-10-03,21,Wednesday,Night,14,195,209,6.7
2012-10-03,22,Wednesday,Night,9,232,241,3.73
2012-10-03,23,Wednesday,Night,21,199,220,9.55
2012-10-04,0,Thursday,Early Morning,11,65,76,14.47
2012-10-04,1,Thursday,Early Morning,2,23,25,8.0
2012-10-04,2,Thursday,Early Morning,3,10,13,23.08
2012-10-04,3,Thursday,Early Morning,5,6,11,45.45
2012-10-04,4,Thursday,Early Morning,0,10,10,0.0
2012-10-04,5,Thursday,Early Morning,2,37,39,5.13
2012-10-04,6,Thursday,Morning Rush,1,132,133,0.75
2012-10-04,7,Thursday,Morning Rush,12,379,391,3.07
2012-10-04,8,Thursday,Morning Rush,27,711,738,3.66
2012-10-04,9,Thursday,Morning Rush,40,319,359,11.14
2012-10-04,10,Thursday,Mid-Day,27,150,177,15.25
2012-10-04,11,Thursday,Mid-Day,38,176,214,17.76
2012-10-04,12,Thursday,Mid-Day,57,231,288,19.79
2012-10-04,13,Thursday,Mid-Day,63,231,294,21.43
2012-10-04,14,Thursday,Mid-Day,56,211,267,20.97
2012-10-04,15,Thursday,Mid-Day,77,248,325,23.69
2012-10-04,16,Thursday,Evening Rush,86,411,497,17.3
2012-10-04,17,Thursday,Evening Rush,112,789,901,12.43
2012-10-04,18,Thursday,Evening Rush,75,812,887,8.46
2012-10-04,19,Thursday,Evening Rush,67,467,534,12.55
2012-10-04,20,Thursday,Night,50,391,441,11.34
2012-10-04,21,Thursday,Night,33,288,321,10.28
2012-10-04,22,Thursday,Night,29,203,232,12.5
2012-10-04,23,Thursday,Night,18,137,155,11.61
2012-10-05,0,Friday,Early Morning,16,86,102,15.69
2012-10-05,1,Friday,Early Morning,3,43,46,6.52
2012-10-05,2,Friday,Early Morning,1,10,11,9.09
2012-10-05,3,Friday,Early Morning,5,11,16,31.25
2012-10-05,4,Friday,Early Morning,0,11,11,0.0
2012-10-05,5,Friday,Early Morning,0,41,41,0.0
2012-10-05,6,Friday,Morning Rush,4,133,137,2.92
2012-10-05,7,Friday,Morning Rush,11,417,428,2.57
2012-10-05,8,Friday,Morning Rush,36,749,785,4.59
2012-10-05,9,Friday,Morning Rush,58,326,384,15.1
2012-10-05,10,Friday,Mid-Day,68,192,260,26.15
2012-10-05,11,Friday,Mid-Day,90,214,304,29.61
2012-10-05,12,Friday,Mid-Day,161,307,468,34.4
2012-10-05,13,Friday,Mid-Day,117,307,424,27.59
2012-10-05,14,Friday,Mid-Day,113,287,400,28.25
2012-10-05,15,Friday,Mid-Day,150,320,470,31.91
2012-10-05,16,Friday,Evening Rush,153,481,634,24.13
2012-10-05,17,Friday,Evening Rush,158,742,900,17.56
2012-10-05,18,Friday,Evening Rush,106,655,761,13.93
2012-10-05,19,Friday,Evening Rush,67,433,500,13.4
2012-10-05,20,Friday,Night,66,306,372,17.74
2012-10-05,21,Friday,Night,47,220,267,17.6
2012-10-05,22,Friday,Night,63,201,264,23.86
2012-10-05,23,Friday,Night,23,148,171,13.45
2012-10-06,0,Saturday,Early Morning,37,154,191,19.37
2012-10-06,1,Saturday,Early Morning,25,116,141,17.73
2012-10-06,2,Saturday,Early Morning,13,62,75,17.33
2012-10-06,3,Saturday,Early Morning,2,54,56,3.57
2012-10-06,4,Saturday,Early Morning,4,7,11,36.36
2012-10-06,5,Saturday,Early Morning,2,8,10,20.0
2012-10-06,6,Saturday,Morning Rush,2,28,30,6.67
2012-10-06,7,Saturday,Morning Rush,13,71,84,15.48
2012-10-06,8,Saturday,Morning Rush,22,184,206,10.68
2012-10-06,9,Saturday,Morning Rush,130,265,395,32.91
2012-10-06,10,Saturday,Mid-Day,198,341,539,36.73
2012-10-06,11,Saturday,Mid-Day,258,389,647,39.88
2012-10-06,12,Saturday,Mid-Day,362,381,743,48.72
2012-10-06,13,Saturday,Mid-Day,310,400,710,43.66
2012-10-06,14,Saturday,Mid-Day,269,307,576,46.7
2012-10-06,15,Saturday,Mid-Day,279,341,620,45.0
2012-10-06,16,Saturday,Evening Rush,317,342,659,48.1
2012-10-06,17,Saturday,Evening Rush,268,342,610,43.93
2012-10-06,18,Saturday,Evening Rush,183,312,495,36.97
2012-10-06,19,Saturday,Evening Rush,102,239,341,29.91
2012-10-06,20,Saturday,Night,75,172,247,30.36
2012-10-06,21,Saturday,Night,78,137,215,36.28
2012-10-06,22,Saturday,Night,45,140,185,24.32
2012-10-06,23,Saturday,Night,37,142,179,20.67
2012-10-07,0,Sunday,Early Morning,28,99,127,22.05
2012-10-07,1,Sunday,Early Morning,29,80,109,26.61
2012-10-07,2,Sunday,Early Morning,10,64,74,13.51
2012-10-07,3,Sunday,Early Morning,5,17,22,22.73
2012-10-07,4,Sunday,Early Morning,5,6,11,45.45
2012-10-07,5,Sunday,Early Morning,2,8,10,20.0
2012-10-07,6,Sunday,Morning Rush,4,19,23,17.39
2012-10-07,7,Sunday,Morning Rush,6,29,35,17.14
2012-10-07,8,Sunday,Morning Rush,11,51,62,17.74
2012-10-07,9,Sunday,Morning Rush,16,70,86,18.6
2012-10-07,10,Sunday,Mid-Day,41,144,185,22.16
2012-10-07,11,Sunday,Mid-Day,76,260,336,22.62
2012-10-07,12,Sunday,Mid-Day,100,292,392,25.51
2012-10-07,13,Sunday,Mid-Day,80,240,320,25.0
2012-10-07,14,Sunday,Mid-Day,71,243,314,22.61
2012-10-07,15,Sunday,Mid-Day,74,232,306,24.18
2012-10-07,16,Sunday,Evening Rush,87,246,333,26.13
2012-10-07,17,Sunday,Evening Rush,35,122,157,22.29
2012-10-07,18,Sunday,Evening Rush,24,82,106,22.64
2012-10-07,19,Sunday,Evening Rush,17,97,114,14.91
2012-10-07,20,Sunday,Night,19,97,116,16.38
2012-10-07,21,Sunday,Night,22,91,113,19.47
2012-10-07,22,Sunday,Night,7,72,79,8.86
2012-10-07,23,Sunday,Night,12,68,80,15.0
2012-10-08,0,Monday,Early Morning,7,44,51,13.73
2012-10-08,1,Monday,Early Morning,2,35,37,5.41
2012-10-08,2,Monday,Early Morning,3,12,15,20.0
2012-10-08,3,Monday,Early Morning,2,8,10,20.0
2012-10-08,4,Monday,Early Morning,1,6,7,14.29
2012-10-08,5,Monday,Early Morning,2,17,19,10.53
2012-10-08,6,Monday,Morning Rush,5,54,59,8.47
2012-10-08,7,Monday,Morning Rush,3,151,154,1.95
2012-10-08,8,Monday,Morning Rush,23,374,397,5.79
2012-10-08,9,Monday,Morning Rush,59,273,332,17.77
2012-10-08,10,Monday,Mid-Day,69,229,298,23.15
2012-10-08,11,Monday,Mid-Day,72,236,308,23.38
2012-10-08,12,Monday,Mid-Day,74,267,341,21.7
2012-10-08,13,Monday,Mid-Day,82,323,405,20.25
2012-10-08,14,Monday,Mid-Day,121,299,420,28.81
2012-10-08,15,Monday,Mid-Day,76,294,370,20.54
2012-10-08,16,Monday,Evening Rush,61,316,377,16.18
2012-10-08,17,Monday,Evening Rush,81,416,497,16.3
2012-10-08,18,Monday,Evening Rush,41,415,456,8.99
2012-10-08,19,Monday,Evening Rush,38,333,371,10.24
2012-10-08,20,Monday,Night,20,207,227,8.81
2012-10-08,21,Monday,Night,17,134,151,11.26
2012-10-08,22,Monday,Night,6,101,107,5.61
2012-10-08,23,Monday,Night,9,60,69,13.04
2012-10-09,0,Tuesday,Early Morning,9,22,31,29.03
2012-10-09,1,Tuesday,Early Morning,0,13,13,0.0
2012-10-09,2,Tuesday,Early Morning,2,5,7,28.57
2012-10-09,3,Tuesday,Early Morning,0,3,3,0.0
2012-10-09,4,Tuesday,Early Morning,1,6,7,14.29
2012-10-09,5,Tuesday,Early Morning,0,19,19,0.0
2012-10-09,6,Tuesday,Morning Rush,2,141,143,1.4
2012-10-09,7,Tuesday,Morning Rush,5,357,362,1.38
2012-10-09,8,Tuesday,Morning Rush,15,698,713,2.1
2012-10-09,9,Tuesday,Morning Rush,37,345,382,9.69
2012-10-09,10,Tuesday,Mid-Day,33,131,164,20.12
2012-10-09,11,Tuesday,Mid-Day,37,156,193,19.17
2012-10-09,12,Tuesday,Mid-Day,43,217,260,16.54
2012-10-09,13,Tuesday,Mid-Day,54,184,238,22.69
2012-10-09,14,Tuesday,Mid-Day,43,201,244,17.62
2012-10-09,15,Tuesday,Mid-Day,59,195,254,23.23
2012-10-09,16,Tuesday,Evening Rush,70,354,424,16.51
2012-10-09,17,Tuesday,Evening Rush,73,733,806,9.06
2012-10-09,18,Tuesday,Evening Rush,26,758,784,3.32
2012-10-09,19,Tuesday,Evening Rush,31,483,514,6.03
2012-10-09,20,Tuesday,Night,30,330,360,8.33
2012-10-09,21,Tuesday,Night,16,209,225,7.11
2012-10-09,22,Tuesday,Night,7,155,162,4.32
2012-10-09,23,Tuesday,Night,8,76,84,9.52
2012-10-10,0,Wednesday,Early Morning,0,33,33,0.0
2012-10-10,1,Wednesday,Early Morning,2,6,8,25.0
2012-10-10,2,Wednesday,Early Morning,2,6,8,25.0
2012-10-10,3,Wednesday,Early Morning,0,6,6,0.0
2012-10-10,4,Wednesday,Early Morning,0,6,6,0.0
2012-10-10,5,Wednesday,Early Morning,2,38,40,5.0
2012-10-10,6,Wednesday,Morning Rush,3,172,175,1.71
2012-10-10,7,Wednesday,Morning Rush,9,498,507,1.78
2012-10-10,8,Wednesday,Morning Rush,33,806,839,3.93
2012-10-10,9,Wednesday,Morning Rush,35,331,366,9.56
2012-10-10,10,Wednesday,Mid-Day,27,190,217,12.44
2012-10-10,11,Wednesday,Mid-Day,53,238,291,18.21
2012-10-10,12,Wednesday,Mid-Day,78,312,390,20.0
2012-10-10,13,Wednesday,Mid-Day,60,237,297,20.2
2012-10-10,14,Wednesday,Mid-Day,63,208,271,23.25
2012-10-10,15,Wednesday,Mid-Day,58,261,319,18.18
2012-10-10,16,Wednesday,Evening Rush,92,474,566,16.25
2012-10-10,17,Wednesday,Evening Rush,91,857,948,9.6
2012-10-10,18,Wednesday,Evening Rush,57,787,844,6.75
2012-10-10,19,Wednesday,Evening Rush,32,534,566,5.65
2012-10-10,20,Wednesday,Night,21,371,392,5.36
2012-10-10,21,Wednesday,Night,18,251,269,6.69
2012-10-10,22,Wednesday,Night,27,170,197,13.71
2012-10-10,23,Wednesday,Night,17,119,136,12.5
2012-10-11,0,Thursday,Early Morning,1,41,42,2.38
2012-10-11,1,Thursday,Early Morning,1,10,11,9.09
2012-10-11,2,Thursday,Early Morning,4,7,11,36.36
2012-10-11,3,Thursday,Early Morning,0,3,3,0.0
2012-10-11,4,Thursday,Early Morning,0,10,10,0.0
2012-10-11,5,Thursday,Early Morning,0,42,42,0.0
2012-10-11,6,Thursday,Morning Rush,1,158,159,0.63
2012-10-11,7,Thursday,Morning Rush,11,467,478,2.3
2012-10-11,8,Thursday,Morning Rush,25,773,798,3.13
2012-10-11,9,Thursday,Morning Rush,27,328,355,7.61
2012-10-11,10,Thursday,Mid-Day,39,165,204,19.12
2012-10-11,11,Thursday,Mid-Day,76,175,251,30.28
2012-10-11,12,Thursday,Mid-Day,47,279,326,14.42
2012-10-11,13,Thursday,Mid-Day,48,243,291,16.49
2012-10-11,14,Thursday,Mid-Day,78,270,348,22.41
2012-10-11,15,Thursday,Mid-Day,102,358,460,22.17
2012-10-11,16,Thursday,Evening Rush,68,413,481,14.14
2012-10-11,17,Thursday,Evening Rush,90,737,827,10.88
2012-10-11,18,Thursday,Evening Rush,64,628,692,9.25
2012-10-11,19,Thursday,Evening Rush,81,662,743,10.9
2012-10-11,20,Thursday,Night,27,388,415,6.51
2012-10-11,21,Thursday,Night,24,236,260,9.23
2012-10-11,22,Thursday,Night,10,167,177,5.65
2012-10-11,23,Thursday,Night,10,176,186,5.38
2012-10-12,0,Friday,Early Morning,8,60,68,11.76
2012-10-12,1,Friday,Early Morning,8,29,37,21.62
2012-10-12,2,Friday,Early Morning,0,16,16,0.0
2012-10-12,3,Friday,Early Morning,0,6,6,0.0
2012-10-12,4,Friday,Early Morning,0,8,8,0.0
2012-10-12,5,Friday,Early Morning,2,33,35,5.71
2012-10-12,6,Friday,Morning Rush,3,140,143,2.1
2012-10-12,7,Friday,Morning Rush,8,384,392,2.04
2012-10-12,8,Friday,Morning Rush,34,711,745,4.56
2012-10-12,9,Friday,Morning Rush,26,374,400,6.5
2012-10-12,10,Friday,Mid-Day,75,200,275,27.27
2012-10-12,11,Friday,Mid-Day,61,252,313,19.49
2012-10-12,12,Friday,Mid-Day,75,312,387,19.38
2012-10-12,13,Friday,Mid-Day,81,300,381,21.26
2012-10-12,14,Friday,Mid-Day,109,262,371,29.38
2012-10-12,15,Friday,Mid-Day,138,317,455,30.33
2012-10-12,16,Friday,Evening Rush,108,412,520,20.77
2012-10-12,17,Friday,Evening Rush,131,706,837,15.65
2012-10-12,18,Friday,Evening Rush,76,566,642,11.84
2012-10-12,19,Friday,Evening Rush,40,453,493,8.11
2012-10-12,20,Friday,Night,28,280,308,9.09
2012-10-12,21,Friday,Night,21,169,190,11.05
2012-10-12,22,Friday,Night,17,143,160,10.63
2012-10-12,23,Friday,Night,11,89,100,11.0
2012-10-13,0,Saturday,Early Morning,31,218,249,12.45
2012-10-13,1,Saturday,Early Morning,23,123,146,15.75
2012-10-13,2,Saturday,Early Morning,7,60,67,10.45
2012-10-13,3,Saturday,Early Morning,2,13,15,13.33
2012-10-13,4,Saturday,Early Morning,2,9,11,18.18
2012-10-13,5,Saturday,Early Morning,0,11,11,0.0
2012-10-13,6,Saturday,Morning Rush,5,23,28,17.86
2012-10-13,7,Saturday,Morning Rush,10,60,70,14.29
2012-10-13,8,Saturday,Morning Rush,23,151,174,13.22
2012-10-13,9,Saturday,Morning Rush,46,220,266,17.29
2012-10-13,10,Saturday,Mid-Day,82,265,347,23.63
2012-10-13,11,Saturday,Mid-Day,192,335,527,36.43
2012-10-13,12,Saturday,Mid-Day,202,371,573,35.25
2012-10-13,13,Saturday,Mid-Day,235,435,670,35.07
2012-10-13,14,Saturday,Mid-Day,243,354,597,40.7
2012-10-13,15,Saturday,Mid-Day,251,364,615,40.81
2012-10-13,16,Saturday,Evening Rush,294,343,637,46.15
2012-10-13,17,Saturday,Evening Rush,193,335,528,36.55
2012-10-13,18,Saturday,Evening Rush,174,299,473,36.79
2012-10-13,19,Saturday,Evening Rush,73,259,332,21.99
2012-10-13,20,Saturday,Night,57,198,255,22.35
2012-10-13,21,Saturday,Night,47,157,204,23.04
2012-10-13,22,Saturday,Night,33,156,189,17.46
2012-10-13,23,Saturday,Night,27,98,125,21.6
2012-10-14,0,Sunday,Early Morning,8,103,111,7.21
2012-10-14,1,Sunday,Early Morning,16,96,112,14.29
2012-10-14,2,Sunday,Early Morning,8,58,66,12.12
2012-10-14,3,Sunday,Early Morning,3,25,28,10.71
2012-10-14,4,Sunday,Early Morning,2,10,12,16.67
2012-10-14,5,Sunday,Early Morning,5,6,11,45.45
2012-10-14,6,Sunday,Morning Rush,4,20,24,16.67
2012-10-14,7,Sunday,Morning Rush,7,44,51,13.73
2012-10-14,8,Sunday,Morning Rush,28,104,132,21.21
2012-10-14,9,Sunday,Morning Rush,62,161,223,27.8
2012-10-14,10,Sunday,Mid-Day,150,278,428,35.05
2012-10-14,11,Sunday,Mid-Day,156,338,494,31.58
2012-10-14,12,Sunday,Mid-Day,200,362,562,35.59
2012-10-14,13,Sunday,Mid-Day,218,401,619,35.22
2012-10-14,14,Sunday,Mid-Day,249,368,617,40.36
2012-10-14,15,Sunday,Mid-Day,213,355,568,37.5
2012-10-14,16,Sunday,Evening Rush,203,378,581,34.94
2012-10-14,17,Sunday,Evening Rush,193,346,539,35.81
2012-10-14,18,Sunday,Evening Rush,134,319,453,29.58
2012-10-14,19,Sunday,Evening Rush,68,268,336,20.24
2012-10-14,20,Sunday,Night,48,198,246,19.51
2012-10-14,21,Sunday,Night,40,156,196,20.41
2012-10-14,22,Sunday,Night,38,87,125,30.4
2012-10-14,23,Sunday,Night,27,78,105,25.71
2012-10-15,0,Monday,Early Morning,17,31,48,35.42
2012-10-15,1,Monday,Early Morning,5,24,29,17.24
2012-10-15,2,Monday,Early Morning,1,5,6,16.67
2012-10-15,3,Monday,Early Morning,2,2,4,50.0
2012-10-15,4,Monday,Early Morning,1,9,10,10.0
2012-10-15,5,Monday,Early Morning,2,38,40,5.0
2012-10-15,6,Monday,Morning Rush,6,141,147,4.08
2012-10-15,7,Monday,Morning Rush,15,461,476,3.15
2012-10-15,8,Monday,Morning Rush,24,713,737,3.26
2012-10-15,9,Monday,Morning Rush,31,328,359,8.64
2012-10-15,10,Monday,Mid-Day,43,125,168,25.6
2012-10-15,11,Monday,Mid-Day,88,175,263,33.46
2012-10-15,12,Monday,Mid-Day,73,211,284,25.7
2012-10-15,13,Monday,Mid-Day,37,109,146,25.34
2012-10-15,14,Monday,Mid-Day,57,128,185,30.81
2012-10-15,15,Monday,Mid-Day,70,190,260,26.92
2012-10-15,16,Monday,Evening Rush,76,371,447,17.0
2012-10-15,17,Monday,Evening Rush,96,670,766,12.53
2012-10-15,18,Monday,Evening Rush,52,540,592,8.78
2012-10-15,19,Monday,Evening Rush,12,227,239,5.02
2012-10-15,20,Monday,Night,19,237,256,7.42
2012-10-15,21,Monday,Night,16,190,206,7.77
2012-10-15,22,Monday,Night,8,118,126,6.35
2012-10-15,23,Monday,Night,9,72,81,11.11
2012-10-16,0,Tuesday,Early Morning,3,45,48,6.25
2012-10-16,1,Tuesday,Early Morning,4,9,13,30.77
2012-10-16,2,Tuesday,Early Morning,2,1,3,66.67
2012-10-16,3,Tuesday,Early Morning,0,2,2,0.0
2012-10-16,4,Tuesday,Early Morning,0,7,7,0.0
2012-10-16,5,Tuesday,Early Morning,5,47,52,9.62
2012-10-16,6,Tuesday,Morning Rush,4,168,172,2.33
2012-10-16,7,Tuesday,Morning Rush,20,505,525,3.81
2012-10-16,8,Tuesday,Morning Rush,35,800,835,4.19
2012-10-16,9,Tuesday,Morning Rush,32,323,355,9.01
2012-10-16,10,Tuesday,Mid-Day,65,157,222,29.28
2012-10-16,11,Tuesday,Mid-Day,56,172,228,24.56
2012-10-16,12,Tuesday,Mid-Day,69,256,325,21.23
2012-10-16,13,Tuesday,Mid-Day,68,260,328,20.73
2012-10-16,14,Tuesday,Mid-Day,94,214,308,30.52
2012-10-16,15,Tuesday,Mid-Day,76,270,346,21.97
2012-10-16,16,Tuesday,Evening Rush,79,367,446,17.71
2012-10-16,17,Tuesday,Evening Rush,104,839,943,11.03
2012-10-16,18,Tuesday,Evening Rush,71,767,838,8.47
2012-10-16,19,Tuesday,Evening Rush,40,491,531,7.53
2012-10-16,20,Tuesday,Night,35,397,432,8.1
2012-10-16,21,Tuesday,Night,19,176,195,9.74
2012-10-16,22,Tuesday,Night,18,163,181,9.94
2012-10-16,23,Tuesday,Night,23,176,199,11.56
2012-10-17,0,Wednesday,Early Morning,1,48,49,2.04
2012-10-17,1,Wednesday,Early Morning,3,14,17,17.65
2012-10-17,2,Wednesday,Early Morning,4,12,16,25.0
2012-10-17,3,Wednesday,Early Morning,0,7,7,0.0
2012-10-17,4,Wednesday,Early Morning,0,4,4,0.0
2012-10-17,5,Wednesday,Early Morning,2,39,41,4.88
2012-10-17,6,Wednesday,Morning Rush,7,171,178,3.93
2012-10-17,7,Wednesday,Morning Rush,15,449,464,3.23
2012-10-17,8,Wednesday,Morning Rush,38,779,817,4.65
2012-10-17,9,Wednesday,Morning Rush,38,344,382,9.95
2012-10-17,10,Wednesday,Mid-Day,60,168,228,26.32
2012-10-17,11,Wednesday,Mid-Day,78,156,234,33.33
2012-10-17,12,Wednesday,Mid-Day,71,261,332,21.39
2012-10-17,13,Wednesday,Mid-Day,73,237,310,23.55
2012-10-17,14,Wednesday,Mid-Day,82,188,270,30.37
2012-10-17,15,Wednesday,Mid-Day,62,239,301,20.6
2012-10-17,16,Wednesday,Evening Rush,70,396,466,15.02
2012-10-17,17,Wednesday,Evening Rush,122,766,888,13.74
2012-10-17,18,Wednesday,Evening Rush,90,794,884,10.18
2012-10-17,19,Wednesday,Evening Rush,49,467,516,9.5
2012-10-17,20,Wednesday,Night,54,360,414,13.04
2012-10-17,21,Wednesday,Night,28,301,329,8.51
2012-10-17,22,Wednesday,Night,17,198,215,7.91
2012-10-17,23,Wednesday,Night,15,84,99,15.15
2012-10-18,0,Thursday,Early Morning,4,53,57,7.02
2012-10-18,1,Thursday,Early Morning,0,14,14,0.0
2012-10-18,2,Thursday,Early Morning,1,13,14,7.14
2012-10-18,3,Thursday,Early Morning,0,5,5,0.0
2012-10-18,4,Thursday,Early Morning,0,5,5,0.0
2012-10-18,5,Thursday,Early Morning,1,41,42,2.38
2012-10-18,6,Thursday,Morning Rush,3,150,153,1.96
2012-10-18,7,Thursday,Morning Rush,20,488,508,3.94
2012-10-18,8,Thursday,Morning Rush,31,803,834,3.72
2012-10-18,9,Thursday,Morning Rush,41,346,387,10.59
2012-10-18,10,Thursday,Mid-Day,60,158,218,27.52
2012-10-18,11,Thursday,Mid-Day,79,189,268,29.48
2012-10-18,12,Thursday,Mid-Day,93,284,377,24.67
2012-10-18,13,Thursday,Mid-Day,96,236,332,28.92
2012-10-18,14,Thursday,Mid-Day,94,191,285,32.98
2012-10-18,15,Thursday,Mid-Day,69,284,353,19.55
2012-10-18,16,Thursday,Evening Rush,94,356,450,20.89
2012-10-18,17,Thursday,Evening Rush,102,788,890,11.46
2012-10-18,18,Thursday,Evening Rush,68,720,788,8.63
2012-10-18,19,Thursday,Evening Rush,42,471,513,8.19
2012-10-18,20,Thursday,Night,39,348,387,10.08
2012-10-18,21,Thursday,Night,38,245,283,13.43
2012-10-18,22,Thursday,Night,27,202,229,11.79
2012-10-18,23,Thursday,Night,6,111,117,5.13
2012-10-19,0,Friday,Early Morning,5,51,56,8.93
2012-10-19,1,Friday,Early Morning,4,12,16,25.0
2012-10-19,2,Friday,Early Morning,1,9,10,10.0
2012-10-19,3,Friday,Early Morning,0,5,5,0.0
2012-10-19,4,Friday,Early Morning,1,5,6,16.67
2012-10-19,5,Friday,Early Morning,1,35,36,2.78
2012-10-19,6,Friday,Morning Rush,5,126,131,3.82
2012-10-19,7,Friday,Morning Rush,5,149,154,3.25
2012-10-19,8,Friday,Morning Rush,20,447,467,4.28
2012-10-19,9,Friday,Morning Rush,26,363,389,6.68
2012-10-19,10,Friday,Mid-Day,26,198,224,11.61
2012-10-19,11,Friday,Mid-Day,41,211,252,16.27
2012-10-19,12,Friday,Mid-Day,74,258,332,22.29
2012-10-19,13,Friday,Mid-Day,87,288,375,23.2
2012-10-19,14,Friday,Mid-Day,88,277,365,24.11
2012-10-19,15,Friday,Mid-Day,93,302,395,23.54
2012-10-19,16,Friday,Evening Rush,131,434,565,23.19
2012-10-19,17,Friday,Evening Rush,48,377,425,11.29
2012-10-19,18,Friday,Evening Rush,21,212,233,9.01
2012-10-19,19,Friday,Evening Rush,19,213,232,8.19
2012-10-19,20,Friday,Night,13,216,229,5.68
2012-10-19,21,Friday,Night,17,189,206,8.25
2012-10-19,22,Friday,Night,14,176,190,7.37
2012-10-19,23,Friday,Night,13,118,131,9.92
2012-10-20,0,Saturday,Early Morning,13,110,123,10.57
2012-10-20,1,Saturday,Early Morning,2,93,95,2.11
2012-10-20,2,Saturday,Early Morning,9,69,78,11.54
2012-10-20,3,Saturday,Early Morning,2,27,29,6.9
2012-10-20,4,Saturday,Early Morning,9,9,18,50.0
2012-10-20,5,Saturday,Early Morning,6,7,13,46.15
2012-10-20,6,Saturday,Morning Rush,5,26,31,16.13
2012-10-20,7,Saturday,Morning Rush,6,59,65,9.23
2012-10-20,8,Saturday,Morning Rush,29,164,193,15.03
2012-10-20,9,Saturday,Morning Rush,106,257,363,29.2
2012-10-20,10,Saturday,Mid-Day,111,312,423,26.24
2012-10-20,11,Saturday,Mid-Day,204,408,612,33.33
2012-10-20,12,Saturday,Mid-Day,267,436,703,37.98
2012-10-20,13,Saturday,Mid-Day,273,441,714,38.24
2012-10-20,14,Saturday,Mid-Day,335,376,711,47.12
2012-10-20,15,Saturday,Mid-Day,308,403,711,43.32
2012-10-20,16,Saturday,Evening Rush,325,366,691,47.03
2012-10-20,17,Saturday,Evening Rush,347,384,731,47.47
2012-10-20,18,Saturday,Evening Rush,165,356,521,31.67
2012-10-20,19,Saturday,Evening Rush,77,268,345,22.32
2012-10-20,20,Saturday,Night,61,198,259,23.55
2012-10-20,21,Saturday,Night,72,224,296,24.32
2012-10-20,22,Saturday,Night,47,155,202,23.27
2012-10-20,23,Saturday,Night,27,136,163,16.56
2012-10-21,0,Sunday,Early Morning,35,119,154,22.73
2012-10-21,1,Sunday,Early Morning,20,97,117,17.09
2012-10-21,2,Sunday,Early Morning,44,88,132,33.33
2012-10-21,3,Sunday,Early Morning,12,29,41,29.27
2012-10-21,4,Sunday,Early Morning,8,13,21,38.1
2012-10-21,5,Sunday,Early Morning,6,4,10,60.0
2012-10-21,6,Sunday,Morning Rush,8,18,26,30.77
2012-10-21,7,Sunday,Morning Rush,13,43,56,23.21
2012-10-21,8,Sunday,Morning Rush,39,104,143,27.27
2012-10-21,9,Sunday,Morning Rush,77,192,269,28.62
2012-10-21,10,Sunday,Mid-Day,167,276,443,37.7
2012-10-21,11,Sunday,Mid-Day,191,356,547,34.92
2012-10-21,12,Sunday,Mid-Day,236,439,675,34.96
2012-10-21,13,Sunday,Mid-Day,243,383,626,38.82
2012-10-21,14,Sunday,Mid-Day,235,405,640,36.72
2012-10-21,15,Sunday,Mid-Day,240,383,623,38.52
2012-10-21,16,Sunday,Evening Rush,182,409,591,30.8
2012-10-21,17,Sunday,Evening Rush,153,338,491,31.16
2012-10-21,18,Sunday,Evening Rush,71,342,413,17.19
2012-10-21,19,Sunday,Evening Rush,50,216,266,18.8
2012-10-21,20,Sunday,Night,35,160,195,17.95
2012-10-21,21,Sunday,Night,42,124,166,25.3
2012-10-21,22,Sunday,Night,18,95,113,15.93
2012-10-21,23,Sunday,Night,7,59,66,10.61
2012-10-22,0,Monday,Early Morning,3,28,31,9.68
2012-10-22,1,Monday,Early Morning,0,11,11,0.0
2012-10-22,2,Monday,Early Morning,1,4,5,20.0
2012-10-22,3,Monday,Early Morning,1,5,6,16.67
2012-10-22,4,Monday,Early Morning,1,6,7,14.29
2012-10-22,5,Monday,Early Morning,2,44,46,4.35
2012-10-22,6,Monday,Morning Rush,4,140,144,2.78
2012-10-22,7,Monday,Morning Rush,15,437,452,3.32
2012-10-22,8,Monday,Morning Rush,32,696,728,4.4
2012-10-22,9,Monday,Morning Rush,25,335,360,6.94
2012-10-22,10,Monday,Mid-Day,51,161,212,24.06
2012-10-22,11,Monday,Mid-Day,63,148,211,29.86
2012-10-22,12,Monday,Mid-Day,52,231,283,18.37
2012-10-22,13,Monday,Mid-Day,88,227,315,27.94
2012-10-22,14,Monday,Mid-Day,73,209,282,25.89
2012-10-22,15,Monday,Mid-Day,74,222,296,25.0
2012-10-22,16,Monday,Evening Rush,80,444,524,15.27
2012-10-22,17,Monday,Evening Rush,84,838,922,9.11
2012-10-22,18,Monday,Evening Rush,60,726,786,7.63
2012-10-22,19,Monday,Evening Rush,36,478,514,7.0
2012-10-22,20,Monday,Night,21,382,403,5.21
2012-10-22,21,Monday,Night,19,155,174,10.92
2012-10-22,22,Monday,Night,25,158,183,13.66
2012-10-22,23,Monday,Night,20,143,163,12.27
2012-10-23,0,Tuesday,Early Morning,5,32,37,13.51
2012-10-23,1,Tuesday,Early Morning,1,16,17,5.88
2012-10-23,2,Tuesday,Early Morning,1,6,7,14.29
2012-10-23,3,Tuesday,Early Morning,0,1,1,0.0
2012-10-23,4,Tuesday,Early Morning,1,6,7,14.29
2012-10-23,5,Tuesday,Early Morning,1,49,50,2.0
2012-10-23,6,Tuesday,Morning Rush,6,152,158,3.8
2012-10-23,7,Tuesday,Morning Rush,12,519,531,2.26
2012-10-23,8,Tuesday,Morning Rush,28,733,761,3.68
2012-10-23,9,Tuesday,Morning Rush,29,305,334,8.68
2012-10-23,10,Tuesday,Mid-Day,50,171,221,22.62
2012-10-23,11,Tuesday,Mid-Day,52,201,253,20.55
2012-10-23,12,Tuesday,Mid-Day,80,298,378,21.16
2012-10-23,13,Tuesday,Mid-Day,59,244,303,19.47
2012-10-23,14,Tuesday,Mid-Day,67,229,296,22.64
2012-10-23,15,Tuesday,Mid-Day,76,270,346,21.97
2012-10-23,16,Tuesday,Evening Rush,108,433,541,19.96
2012-10-23,17,Tuesday,Evening Rush,67,871,938,7.14
2012-10-23,18,Tuesday,Evening Rush,64,762,826,7.75
2012-10-23,19,Tuesday,Evening Rush,25,457,482,5.19
2012-10-23,20,Tuesday,Night,45,334,379,11.87
2012-10-23,21,Tuesday,Night,35,260,295,11.86
2012-10-23,22,Tuesday,Night,20,174,194,10.31
2012-10-23,23,Tuesday,Night,9,102,111,8.11
2012-10-24,0,Wednesday,Early Morning,7,39,46,15.22
2012-10-24,1,Wednesday,Early Morning,4,23,27,14.81
2012-10-24,2,Wednesday,Early Morning,0,6,6,0.0
2012-10-24,3,Wednesday,Early Morning,0,4,4,0.0
2012-10-24,4,Wednesday,Early Morning,1,5,6,16.67
2012-10-24,5,Wednesday,Early Morning,1,52,53,1.89
2012-10-24,6,Wednesday,Morning Rush,11,162,173,6.36
2012-10-24,7,Wednesday,Morning Rush,20,506,526,3.8
2012-10-24,8,Wednesday,Morning Rush,24,777,801,3.0
2012-10-24,9,Wednesday,Morning Rush,24,349,373,6.43
2012-10-24,10,Wednesday,Mid-Day,29,142,171,16.96
2012-10-24,11,Wednesday,Mid-Day,47,189,236,19.92
2012-10-24,12,Wednesday,Mid-Day,48,268,316,15.19
2012-10-24,13,Wednesday,Mid-Day,65,241,306,21.24
2012-10-24,14,Wednesday,Mid-Day,64,237,301,21.26
2012-10-24,15,Wednesday,Mid-Day,63,245,308,20.45
2012-10-24,16,Wednesday,Evening Rush,67,465,532,12.59
2012-10-24,17,Wednesday,Evening Rush,87,876,963,9.03
2012-10-24,18,Wednesday,Evening Rush,63,795,858,7.34
2012-10-24,19,Wednesday,Evening Rush,50,522,572,8.74
2012-10-24,20,Wednesday,Night,45,396,441,10.2
2012-10-24,21,Wednesday,Night,33,280,313,10.54
2012-10-24,22,Wednesday,Night,30,208,238,12.61
2012-10-24,23,Wednesday,Night,12,111,123,9.76
2012-10-25,0,Thursday,Early Morning,19,57,76,25.0
2012-10-25,1,Thursday,Early Morning,6,22,28,21.43
2012-10-25,2,Thursday,Early Morning,3,15,18,16.67
2012-10-25,3,Thursday,Early Morning,0,8,8,0.0
2012-10-25,4,Thursday,Early Morning,1,4,5,20.0
2012-10-25,5,Thursday,Early Morning,2,53,55,3.64
2012-10-25,6,Thursday,Morning Rush,3,168,171,1.75
2012-10-25,7,Thursday,Morning Rush,18,477,495,3.64
2012-10-25,8,Thursday,Morning Rush,33,746,779,4.24
2012-10-25,9,Thursday,Morning Rush,23,320,343,6.71
2012-10-25,10,Thursday,Mid-Day,53,172,225,23.56
2012-10-25,11,Thursday,Mid-Day,57,181,238,23.95
2012-10-25,12,Thursday,Mid-Day,61,258,319,19.12
2012-10-25,13,Thursday,Mid-Day,49,264,313,15.65
2012-10-25,14,Thursday,Mid-Day,71,214,285,24.91
2012-10-25,15,Thursday,Mid-Day,63,242,305,20.66
2012-10-25,16,Thursday,Evening Rush,92,407,499,18.44
2012-10-25,17,Thursday,Evening Rush,112,774,886,12.64
2012-10-25,18,Thursday,Evening Rush,77,732,809,9.52
2012-10-25,19,Thursday,Evening Rush,45,497,542,8.3
2012-10-25,20,Thursday,Night,28,319,347,8.07
2012-10-25,21,Thursday,Night,24,247,271,8.86
2012-10-25,22,Thursday,Night,22,185,207,10.63
2012-10-25,23,Thursday,Night,13,122,135,9.63
2012-10-26,0,Friday,Early Morning,6,65,71,8.45
2012-10-26,1,Friday,Early Morning,4,32,36,11.11
2012-10-26,2,Friday,Early Morning,4,15,19,21.05
2012-10-26,3,Friday,Early Morning,5,8,13,38.46
2012-10-26,4,Friday,Early Morning,1,4,5,20.0
2012-10-26,5,Friday,Early Morning,3,47,50,6.0
2012-10-26,6,Friday,Morning Rush,2,142,144,1.39
2012-10-26,7,Friday,Morning Rush,13,408,421,3.09
2012-10-26,8,Friday,Morning Rush,20,714,734,2.72
2012-10-26,9,Friday,Morning Rush,56,347,403,13.9
2012-10-26,10,Friday,Mid-Day,41,156,197,20.81
2012-10-26,11,Friday,Mid-Day,68,222,290,23.45
2012-10-26,12,Friday,Mid-Day,90,302,392,22.96
2012-10-26,13,Friday,Mid-Day,77,260,337,22.85
2012-10-26,14,Friday,Mid-Day,99,252,351,28.21
2012-10-26,15,Friday,Mid-Day,142,306,448,31.7
2012-10-26,16,Friday,Evening Rush,137,445,582,23.54
2012-10-26,17,Friday,Evening Rush,125,692,817,15.3
2012-10-26,18,Friday,Evening Rush,81,584,665,12.18
2012-10-26,19,Friday,Evening Rush,72,399,471,15.29
2012-10-26,20,Friday,Night,40,271,311,12.86
2012-10-26,21,Friday,Night,40,252,292,13.7
2012-10-26,22,Friday,Night,37,180,217,17.05
2012-10-26,23,Friday,Night,19,159,178,10.67
2012-10-27,0,Saturday,Early Morning,10,132,142,7.04
2012-10-27,1,Saturday,Early Morning,23,123,146,15.75
2012-10-27,2,Saturday,Early Morning,19,71,90,21.11
2012-10-27,3,Saturday,Early Morning,5,21,26,19.23
2012-10-27,4,Saturday,Early Morning,1,12,13,7.69
2012-10-27,5,Saturday,Early Morning,2,7,9,22.22
2012-10-27,6,Saturday,Morning Rush,2,29,31,6.45
2012-10-27,7,Saturday,Morning Rush,7,79,86,8.14
2012-10-27,8,Saturday,Morning Rush,26,187,213,12.21
2012-10-27,9,Saturday,Morning Rush,88,240,328,26.83
2012-10-27,10,Saturday,Mid-Day,165,314,479,34.45
2012-10-27,11,Saturday,Mid-Day,197,388,585,33.68
2012-10-27,12,Saturday,Mid-Day,264,404,668,39.52
2012-10-27,13,Saturday,Mid-Day,310,450,760,40.79
2012-10-27,14,Saturday,Mid-Day,325,425,750,43.33
2012-10-27,15,Saturday,Mid-Day,310,401,711,43.6
2012-10-27,16,Saturday,Evening Rush,257,355,612,41.99
2012-10-27,17,Saturday,Evening Rush,248,370,618,40.13
2012-10-27,18,Saturday,Evening Rush,138,318,456,30.26
2012-10-27,19,Saturday,Evening Rush,67,233,300,22.33
2012-10-27,20,Saturday,Night,58,238,296,19.59
2012-10-27,21,Saturday,Night,49,160,209,23.44
2012-10-27,22,Saturday,Night,41,116,157,26.11
2012-10-27,23,Saturday,Night,31,136,167,18.56
2012-10-28,0,Sunday,Early Morning,20,97,117,17.09
2012-10-28,1,Sunday,Early Morning,22,111,133,16.54
2012-10-28,2,Sunday,Early Morning,17,99,116,14.66
2012-10-28,3,Sunday,Early Morning,18,61,79,22.78
2012-10-28,4,Sunday,Early Morning,1,19,20,5.0
2012-10-28,5,Sunday,Early Morning,6,22,28,21.43
2012-10-28,6,Sunday,Morning Rush,7,32,39,17.95
2012-10-28,7,Sunday,Morning Rush,17,48,65,26.15
2012-10-28,8,Sunday,Morning Rush,55,118,173,31.79
2012-10-28,9,Sunday,Morning Rush,124,206,330,37.58
2012-10-28,10,Sunday,Mid-Day,120,314,434,27.65
2012-10-28,11,Sunday,Mid-Day,110,352,462,23.81
2012-10-28,12,Sunday,Mid-Day,118,373,491,24.03
2012-10-28,13,Sunday,Mid-Day,75,316,391,19.18
2012-10-28,14,Sunday,Mid-Day,98,304,402,24.38
2012-10-28,15,Sunday,Mid-Day,76,225,301,25.25
2012-10-28,16,Sunday,Evening Rush,42,251,293,14.33
2012-10-28,17,Sunday,Evening Rush,37,188,225,16.44
2012-10-28,18,Sunday,Evening Rush,18,136,154,11.69
2012-10-28,19,Sunday,Evening Rush,7,47,54,12.96
2012-10-28,20,Sunday,Night,4,51,55,7.27
2012-10-28,21,Sunday,Night,2,44,46,4.35
2012-10-28,22,Sunday,Night,2,35,37,5.41
2012-10-28,23,Sunday,Night,2,12,14,14.29
2012-10-29,0,Monday,Early Morning,2,20,22,9.09
2012-10-30,13,Tuesday,Mid-Day,11,105,116,9.48
2012-10-30,14,Tuesday,Mid-Day,8,118,126,6.35
2012-10-30,15,Tuesday,Mid-Day,10,114,124,8.06
2012-10-30,16,Tuesday,Evening Rush,15,83,98,15.31
2012-10-30,17,Tuesday,Evening Rush,19,105,124,15.32
2012-10-30,18,Tuesday,Evening Rush,4,139,143,2.8
2012-10-30,19,Tuesday,Evening Rush,6,109,115,5.22
2012-10-30,20,Tuesday,Night,5,76,81,6.17
2012-10-30,21,Tuesday,Night,4,60,64,6.25
2012-10-30,22,Tuesday,Night,2,64,66,3.03
2012-10-30,23,Tuesday,Night,3,36,39,7.69
2012-10-31,0,Wednesday,Early Morning,0,16,16,0.0
2012-10-31,1,Wednesday,Early Morning,0,8,8,0.0
2012-10-31,2,Wednesday,Early Morning,0,7,7,0.0
2012-10-31,3,Wednesday,Early Morning,0,3,3,0.0
2012-10-31,4,Wednesday,Early Morning,0,5,5,0.0
2012-10-31,5,Wednesday,Early Morning,0,24,24,0.0
2012-10-31,6,Wednesday,Morning Rush,0,116,116,0.0
2012-10-31,7,Wednesday,Morning Rush,3,334,337,0.89
2012-10-31,8,Wednesday,Morning Rush,6,615,621,0.97
2012-10-31,9,Wednesday,Morning Rush,17,280,297,5.72
2012-10-31,10,Wednesday,Mid-Day,21,147,168,12.5
2012-10-31,11,Wednesday,Mid-Day,37,152,189,19.58
2012-10-31,12,Wednesday,Mid-Day,44,197,241,18.26
2012-10-31,13,Wednesday,Mid-Day,22,191,213,10.33
2012-10-31,14,Wednesday,Mid-Day,45,179,224,20.09
2012-10-31,15,Wednesday,Mid-Day,33,197,230,14.35
2012-10-31,16,Wednesday,Evening Rush,51,373,424,12.03
2012-10-31,17,Wednesday,Evening Rush,39,684,723,5.39
2012-10-31,18,Wednesday,Evening Rush,28,556,584,4.79
2012-10-31,19,Wednesday,Evening Rush,27,383,410,6.59
2012-10-31,20,Wednesday,Night,9,259,268,3.36
2012-10-31,21,Wednesday,Night,12,180,192,6.25
2012-10-31,22,Wednesday,Night,18,147,165,10.91
2012-10-31,23,Wednesday,Night,7,94,101,6.93
2012-11-01,0,Thursday,Early Morning,8,52,60,13.33
2012-11-01,1,Thursday,Early Morning,8,22,30,26.67
2012-11-01,2,Thursday,Early Morning,10,10,20,50.0
2012-11-01,3,Thursday,Early Morning,5,10,15,33.33
2012-11-01,4,Thursday,Early Morning,2,8,10,20.0
2012-11-01,5,Thursday,Early Morning,1,39,40,2.5
2012-11-01,6,Thursday,Morning Rush,2,146,148,1.35
2012-11-01,7,Thursday,Morning Rush,6,414,420,1.43
2012-11-01,8,Thursday,Morning Rush,12,668,680,1.76
2012-11-01,9,Thursday,Morning Rush,21,310,331,6.34
2012-11-01,10,Thursday,Mid-Day,13,133,146,8.9
2012-11-01,11,Thursday,Mid-Day,14,156,170,8.24
2012-11-01,12,Thursday,Mid-Day,23,198,221,10.41
2012-11-01,13,Thursday,Mid-Day,49,199,248,19.76
2012-11-01,14,Thursday,Mid-Day,31,154,185,16.76
2012-11-01,15,Thursday,Mid-Day,35,179,214,16.36
2012-11-01,16,Thursday,Evening Rush,31,313,344,9.01
2012-11-01,17,Thursday,Evening Rush,37,652,689,5.37
2012-11-01,18,Thursday,Evening Rush,50,628,678,7.37
2012-11-01,19,Thursday,Evening Rush,28,424,452,6.19
2012-11-01,20,Thursday,Night,16,280,296,5.41
2012-11-01,21,Thursday,Night,29,238,267,10.86
2012-11-01,22,Thursday,Night,27,175,202,13.37
2012-11-01,23,Thursday,Night,8,112,120,6.67
2012-11-02,0,Friday,Early Morning,10,40,50,20.0
2012-11-02,1,Friday,Early Morning,5,19,24,20.83
2012-11-02,2,Friday,Early Morning,3,7,10,30.0
2012-11-02,3,Friday,Early Morning,0,3,3,0.0
2012-11-02,4,Friday,Early Morning,1,6,7,14.29
2012-11-02,5,Friday,Early Morning,1,25,26,3.85
2012-11-02,6,Friday,Morning Rush,2,120,122,1.64
2012-11-02,7,Friday,Morning Rush,8,349,357,2.24
2012-11-02,8,Friday,Morning Rush,31,656,687,4.51
2012-11-02,9,Friday,Morning Rush,27,355,382,7.07
2012-11-02,10,Friday,Mid-Day,21,183,204,10.29
2012-11-02,11,Friday,Mid-Day,42,179,221,19.0
2012-11-02,12,Friday,Mid-Day,52,240,292,17.81
2012-11-02,13,Friday,Mid-Day,64,230,294,21.77
2012-11-02,14,Friday,Mid-Day,63,199,262,24.05
2012-11-02,15,Friday,Mid-Day,51,255,306,16.67
2012-11-02,16,Friday,Evening Rush,48,373,421,11.4
2012-11-02,17,Friday,Evening Rush,57,581,638,8.93
2012-11-02,18,Friday,Evening Rush,32,490,522,6.13
2012-11-02,19,Friday,Evening Rush,38,336,374,10.16
2012-11-02,20,Friday,Night,14,207,221,6.33
2012-11-02,21,Friday,Night,23,133,156,14.74
2012-11-02,22,Friday,Night,14,135,149,9.4
2012-11-02,23,Friday,Night,11,108,119,9.24
2012-11-03,0,Saturday,Early Morning,9,99,108,8.33
2012-11-03,1,Saturday,Early Morning,6,83,89,6.74
2012-11-03,2,Saturday,Early Morning,10,36,46,21.74
2012-11-03,3,Saturday,Early Morning,6,22,28,21.43
2012-11-03,4,Saturday,Early Morning,8,8,16,50.0
2012-11-03,5,Saturday,Early Morning,1,8,9,11.11
2012-11-03,6,Saturday,Morning Rush,4,17,21,19.05
2012-11-03,7,Saturday,Morning Rush,1,58,59,1.69
2012-11-03,8,Saturday,Morning Rush,10,132,142,7.04
2012-11-03,9,Saturday,Morning Rush,31,188,219,14.16
2012-11-03,10,Saturday,Mid-Day,68,260,328,20.73
2012-11-03,11,Saturday,Mid-Day,56,284,340,16.47
2012-11-03,12,Saturday,Mid-Day,74,320,394,18.78
2012-11-03,13,Saturday,Mid-Day,110,339,449,24.5
2012-11-03,14,Saturday,Mid-Day,136,319,455,29.89
2012-11-03,15,Saturday,Mid-Day,117,331,448,26.12
2012-11-03,16,Saturday,Evening Rush,108,292,400,27.0
2012-11-03,17,Saturday,Evening Rush,112,298,410,27.32
2012-11-03,18,Saturday,Evening Rush,58,239,297,19.53
2012-11-03,19,Saturday,Evening Rush,22,217,239,9.21
2012-11-03,20,Saturday,Night,23,158,181,12.71
2012-11-03,21,Saturday,Night,31,135,166,18.67
2012-11-03,22,Saturday,Night,13,133,146,8.9
2012-11-03,23,Saturday,Night,15,133,148,10.14
2012-11-04,0,Sunday,Early Morning,5,97,102,4.9
2012-11-04,1,Sunday,Early Morning,26,139,165,15.76
2012-11-04,2,Sunday,Early Morning,6,31,37,16.22
2012-11-04,3,Sunday,Early Morning,1,10,11,9.09
2012-11-04,4,Sunday,Early Morning,2,7,9,22.22
2012-11-04,5,Sunday,Early Morning,0,5,5,0.0
2012-11-04,6,Sunday,Morning Rush,2,14,16,12.5
2012-11-04,7,Sunday,Morning Rush,11,39,50,22.0
2012-11-04,8,Sunday,Morning Rush,34,115,149,22.82
2012-11-04,9,Sunday,Morning Rush,56,161,217,25.81
2012-11-04,10,Sunday,Mid-Day,73,287,360,20.28
2012-11-04,11,Sunday,Mid-Day,134,311,445,30.11
2012-11-04,12,Sunday,Mid-Day,150,354,504,29.76
2012-11-04,13,Sunday,Mid-Day,122,371,493,24.75
2012-11-04,14,Sunday,Mid-Day,149,360,509,29.27
2012-11-04,15,Sunday,Mid-Day,149,300,449,33.18
2012-11-04,16,Sunday,Evening Rush,119,316,435,27.36
2012-11-04,17,Sunday,Evening Rush,57,270,327,17.43
2012-11-04,18,Sunday,Evening Rush,31,206,237,13.08
2012-11-04,19,Sunday,Evening Rush,24,203,227,10.57
2012-11-04,20,Sunday,Night,7,134,141,4.96
2012-11-04,21,Sunday,Night,16,71,87,18.39
2012-11-04,22,Sunday,Night,15,64,79,18.99
2012-11-04,23,Sunday,Night,12,41,53,22.64
2012-11-05,0,Monday,Early Morning,3,20,23,13.04
2012-11-05,1,Monday,Early Morning,0,8,8,0.0
2012-11-05,2,Monday,Early Morning,2,4,6,33.33
2012-11-05,3,Monday,Early Morning,1,3,4,25.0
2012-11-05,4,Monday,Early Morning,5,11,16,31.25
2012-11-05,5,Monday,Early Morning,1,38,39,2.56
2012-11-05,6,Monday,Morning Rush,4,135,139,2.88
2012-11-05,7,Monday,Morning Rush,8,453,461,1.74
2012-11-05,8,Monday,Morning Rush,19,629,648,2.93
2012-11-05,9,Monday,Morning Rush,18,239,257,7.0
2012-11-05,10,Monday,Mid-Day,30,112,142,21.13
2012-11-05,11,Monday,Mid-Day,31,119,150,20.67
2012-11-05,12,Monday,Mid-Day,38,206,244,15.57
2012-11-05,13,Monday,Mid-Day,39,183,222,17.57
2012-11-05,14,Monday,Mid-Day,31,165,196,15.82
2012-11-05,15,Monday,Mid-Day,24,207,231,10.39
2012-11-05,16,Monday,Evening Rush,35,325,360,9.72
2012-11-05,17,Monday,Evening Rush,34,604,638,5.33
2012-11-05,18,Monday,Evening Rush,19,523,542,3.51
2012-11-05,19,Monday,Evening Rush,11,361,372,2.96
2012-11-05,20,Monday,Night,13,228,241,5.39
2012-11-05,21,Monday,Night,8,144,152,5.26
2012-11-05,22,Monday,Night,4,111,115,3.48
2012-11-05,23,Monday,Night,0,53,53,0.0
2012-11-06,0,Tuesday,Early Morning,1,18,19,5.26
2012-11-06,1,Tuesday,Early Morning,0,8,8,0.0
2012-11-06,2,Tuesday,Early Morning,0,2,2,0.0
2012-11-06,3,Tuesday,Early Morning,0,4,4,0.0
2012-11-06,4,Tuesday,Early Morning,0,7,7,0.0
2012-11-06,5,Tuesday,Early Morning,1,40,41,2.44
2012-11-06,6,Tuesday,Morning Rush,6,143,149,4.03
2012-11-06,7,Tuesday,Morning Rush,9,378,387,2.33
2012-11-06,8,Tuesday,Morning Rush,20,568,588,3.4
2012-11-06,9,Tuesday,Morning Rush,25,338,363,6.89
2012-11-06,10,Tuesday,Mid-Day,41,189,230,17.83
2012-11-06,11,Tuesday,Mid-Day,39,177,216,18.06
2012-11-06,12,Tuesday,Mid-Day,31,217,248,12.5
2012-11-06,13,Tuesday,Mid-Day,46,232,278,16.55
2012-11-06,14,Tuesday,Mid-Day,44,196,240,18.33
2012-11-06,15,Tuesday,Mid-Day,45,227,272,16.54
2012-11-06,16,Tuesday,Evening Rush,33,369,402,8.21
2012-11-06,17,Tuesday,Evening Rush,30,597,627,4.78
2012-11-06,18,Tuesday,Evening Rush,20,477,497,4.02
2012-11-06,19,Tuesday,Evening Rush,15,356,371,4.04
2012-11-06,20,Tuesday,Night,10,218,228,4.39
2012-11-06,21,Tuesday,Night,14,137,151,9.27
2012-11-06,22,Tuesday,Night,17,136,153,11.11
2012-11-06,23,Tuesday,Night,19,186,205,9.27
2012-11-07,0,Wednesday,Early Morning,49,234,283,17.31
2012-11-07,1,Wednesday,Early Morning,6,86,92,6.52
2012-11-07,2,Wednesday,Early Morning,6,68,74,8.11
2012-11-07,3,Wednesday,Early Morning,2,9,11,18.18
2012-11-07,4,Wednesday,Early Morning,0,9,9,0.0
2012-11-07,5,Wednesday,Early Morning,0,27,27,0.0
2012-11-07,6,Wednesday,Morning Rush,3,115,118,2.54
2012-11-07,7,Wednesday,Morning Rush,5,314,319,1.57
2012-11-07,8,Wednesday,Morning Rush,18,583,601,3.0
2012-11-07,9,Wednesday,Morning Rush,17,351,368,4.62
2012-11-07,10,Wednesday,Mid-Day,27,151,178,15.17
2012-11-07,11,Wednesday,Mid-Day,15,132,147,10.2
2012-11-07,12,Wednesday,Mid-Day,24,188,212,11.32
2012-11-07,13,Wednesday,Mid-Day,23,158,181,12.71
2012-11-07,14,Wednesday,Mid-Day,19,142,161,11.8
2012-11-07,15,Wednesday,Mid-Day,20,178,198,10.1
2012-11-07,16,Wednesday,Evening Rush,23,250,273,8.42
2012-11-07,17,Wednesday,Evening Rush,16,501,517,3.09
2012-11-07,18,Wednesday,Evening Rush,17,448,465,3.66
2012-11-07,19,Wednesday,Evening Rush,17,302,319,5.33
2012-11-07,20,Wednesday,Night,7,249,256,2.73
2012-11-07,21,Wednesday,Night,5,121,126,3.97
2012-11-07,22,Wednesday,Night,4,56,60,6.67
2012-11-07,23,Wednesday,Night,3,37,40,7.5
2012-11-08,0,Thursday,Early Morning,1,14,15,6.67
2012-11-08,1,Thursday,Early Morning,1,11,12,8.33
2012-11-08,2,Thursday,Early Morning,1,5,6,16.67
2012-11-08,4,Thursday,Early Morning,1,9,10,10.0
2012-11-08,5,Thursday,Early Morning,0,35,35,0.0
2012-11-08,6,Thursday,Morning Rush,2,122,124,1.61
2012-11-08,7,Thursday,Morning Rush,12,411,423,2.84
2012-11-08,8,Thursday,Morning Rush,16,652,668,2.4
2012-11-08,9,Thursday,Morning Rush,22,253,275,8.0
2012-11-08,10,Thursday,Mid-Day,13,148,161,8.07
2012-11-08,11,Thursday,Mid-Day,16,155,171,9.36
2012-11-08,12,Thursday,Mid-Day,33,202,235,14.04
2012-11-08,13,Thursday,Mid-Day,33,195,228,14.47
2012-11-08,14,Thursday,Mid-Day,33,149,182,18.13
2012-11-08,15,Thursday,Mid-Day,32,201,233,13.73
2012-11-08,16,Thursday,Evening Rush,18,321,339,5.31
2012-11-08,17,Thursday,Evening Rush,36,556,592,6.08
2012-11-08,18,Thursday,Evening Rush,16,491,507,3.16
2012-11-08,19,Thursday,Evening Rush,14,359,373,3.75
2012-11-08,20,Thursday,Night,10,235,245,4.08
2012-11-08,21,Thursday,Night,11,222,233,4.72
2012-11-08,22,Thursday,Night,14,147,161,8.7
2012-11-08,23,Thursday,Night,5,82,87,5.75
2012-11-09,0,Friday,Early Morning,9,46,55,16.36
2012-11-09,1,Friday,Early Morning,3,17,20,15.0
2012-11-09,2,Friday,Early Morning,1,11,12,8.33
2012-11-09,3,Friday,Early Morning,3,6,9,33.33
2012-11-09,4,Friday,Early Morning,0,14,14,0.0
2012-11-09,5,Friday,Early Morning,2,25,27,7.41
2012-11-09,6,Friday,Morning Rush,5,126,131,3.82
2012-11-09,7,Friday,Morning Rush,9,332,341,2.64
2012-11-09,8,Friday,Morning Rush,25,668,693,3.61
2012-11-09,9,Friday,Morning Rush,23,304,327,7.03
2012-11-09,10,Friday,Mid-Day,34,163,197,17.26
2012-11-09,11,Friday,Mid-Day,66,185,251,26.29
2012-11-09,12,Friday,Mid-Day,48,214,262,18.32
2012-11-09,13,Friday,Mid-Day,62,237,299,20.74
2012-11-09,14,Friday,Mid-Day,67,207,274,24.45
2012-11-09,15,Friday,Mid-Day,78,278,356,21.91
2012-11-09,16,Friday,Evening Rush,57,377,434,13.13
2012-11-09,17,Friday,Evening Rush,61,593,654,9.33
2012-11-09,18,Friday,Evening Rush,46,450,496,9.27
2012-11-09,19,Friday,Evening Rush,30,331,361,8.31
2012-11-09,20,Friday,Night,20,235,255,7.84
2012-11-09,21,Friday,Night,23,176,199,11.56
2012-11-09,22,Friday,Night,17,146,163,10.43
2012-11-09,23,Friday,Night,20,142,162,12.35
2012-11-10,0,Saturday,Early Morning,16,106,122,13.11
2012-11-10,1,Saturday,Early Morning,8,68,76,10.53
2012-11-10,2,Saturday,Early Morning,2,42,44,4.55
2012-11-10,3,Saturday,Early Morning,9,11,20,45.0
2012-11-10,4,Saturday,Early Morning,2,4,6,33.33
2012-11-10,5,Saturday,Early Morning,1,9,10,10.0
2012-11-10,6,Saturday,Morning Rush,5,11,16,31.25
2012-11-10,7,Saturday,Morning Rush,14,57,71,19.72
2012-11-10,8,Saturday,Morning Rush,16,130,146,10.96
2012-11-10,9,Saturday,Morning Rush,43,216,259,16.6
2012-11-10,10,Saturday,Mid-Day,86,264,350,24.57
2012-11-10,11,Saturday,Mid-Day,143,323,466,30.69
2012-11-10,12,Saturday,Mid-Day,258,348,606,42.57
2012-11-10,13,Saturday,Mid-Day,268,383,651,41.17
2012-11-10,14,Saturday,Mid-Day,280,347,627,44.66
2012-11-10,15,Saturday,Mid-Day,216,351,567,38.1
2012-11-10,16,Saturday,Evening Rush,227,378,605,37.52
2012-11-10,17,Saturday,Evening Rush,183,318,501,36.53
2012-11-10,18,Saturday,Evening Rush,103,256,359,28.69
2012-11-10,19,Saturday,Evening Rush,55,228,283,19.43
2012-11-10,20,Saturday,Night,39,153,192,20.31
2012-11-10,21,Saturday,Night,51,169,220,23.18
2012-11-10,22,Saturday,Night,39,154,193,20.21
2012-11-10,23,Saturday,Night,26,120,146,17.81
2012-11-11,0,Sunday,Early Morning,14,110,124,11.29
2012-11-11,1,Sunday,Early Morning,26,82,108,24.07
2012-11-11,2,Sunday,Early Morning,12,58,70,17.14
2012-11-11,3,Sunday,Early Morning,9,39,48,18.75
2012-11-11,4,Sunday,Early Morning,5,6,11,45.45
2012-11-11,5,Sunday,Early Morning,0,12,12,0.0
2012-11-11,6,Sunday,Morning Rush,3,16,19,15.79
2012-11-11,7,Sunday,Morning Rush,12,56,68,17.65
2012-11-11,8,Sunday,Morning Rush,32,87,119,26.89
2012-11-11,9,Sunday,Morning Rush,94,179,273,34.43
2012-11-11,10,Sunday,Mid-Day,133,272,405,32.84
2012-11-11,11,Sunday,Mid-Day,180,324,504,35.71
2012-11-11,12,Sunday,Mid-Day,195,390,585,33.33
2012-11-11,13,Sunday,Mid-Day,262,424,686,38.19
2012-11-11,14,Sunday,Mid-Day,292,362,654,44.65
2012-11-11,15,Sunday,Mid-Day,304,420,724,41.99
2012-11-11,16,Sunday,Evening Rush,260,393,653,39.82
2012-11-11,17,Sunday,Evening Rush,151,342,493,30.63
2012-11-11,18,Sunday,Evening Rush,102,303,405,25.19
2012-11-11,19,Sunday,Evening Rush,69,208,277,24.91
2012-11-11,20,Sunday,Night,54,146,200,27.0
2012-11-11,21,Sunday,Night,44,127,171,25.73
2012-11-11,22,Sunday,Night,21,113,134,15.67
2012-11-11,23,Sunday,Night,16,93,109,14.68
2012-11-12,0,Monday,Early Morning,6,43,49,12.24
2012-11-12,1,Monday,Early Morning,4,26,30,13.33
2012-11-12,2,Monday,Early Morning,6,14,20,30.0
2012-11-12,3,Monday,Early Morning,1,3,4,25.0
2012-11-12,4,Monday,Early Morning,1,3,4,25.0
2012-11-12,5,Monday,Early Morning,1,23,24,4.17
2012-11-12,6,Monday,Morning Rush,7,64,71,9.86
2012-11-12,7,Monday,Morning Rush,16,248,264,6.06
2012-11-12,8,Monday,Morning Rush,50,490,540,9.26
2012-11-12,9,Monday,Morning Rush,60,337,397,15.11
2012-11-12,10,Monday,Mid-Day,82,184,266,30.83
2012-11-12,11,Monday,Mid-Day,112,255,367,30.52
2012-11-12,12,Monday,Mid-Day,105,314,419,25.06
2012-11-12,13,Monday,Mid-Day,108,312,420,25.71
2012-11-12,14,Monday,Mid-Day,134,310,444,30.18
2012-11-12,15,Monday,Mid-Day,102,280,382,26.7
2012-11-12,16,Monday,Evening Rush,87,347,434,20.05
2012-11-12,17,Monday,Evening Rush,66,530,596,11.07
2012-11-12,18,Monday,Evening Rush,65,486,551,11.8
2012-11-12,19,Monday,Evening Rush,30,323,353,8.5
2012-11-12,20,Monday,Night,31,273,304,10.2
2012-11-12,21,Monday,Night,10,145,155,6.45
2012-11-12,22,Monday,Night,12,100,112,10.71
2012-11-12,23,Monday,Night,1,62,63,1.59
2012-11-13,0,Tuesday,Early Morning,5,18,23,21.74
2012-11-13,1,Tuesday,Early Morning,0,5,5,0.0
2012-11-13,2,Tuesday,Early Morning,7,4,11,63.64
2012-11-13,3,Tuesday,Early Morning,2,3,5,40.0
2012-11-13,4,Tuesday,Early Morning,0,9,9,0.0
2012-11-13,5,Tuesday,Early Morning,0,18,18,0.0
2012-11-13,6,Tuesday,Morning Rush,2,48,50,4.0
2012-11-13,7,Tuesday,Morning Rush,1,106,107,0.93
2012-11-13,8,Tuesday,Morning Rush,4,207,211,1.9
2012-11-13,9,Tuesday,Morning Rush,1,109,110,0.91
2012-11-13,10,Tuesday,Mid-Day,10,84,94,10.64
2012-11-13,11,Tuesday,Mid-Day,22,133,155,14.19
2012-11-13,12,Tuesday,Mid-Day,16,180,196,8.16
2012-11-13,13,Tuesday,Mid-Day,30,188,218,13.76
2012-11-13,14,Tuesday,Mid-Day,34,169,203,16.75
2012-11-13,15,Tuesday,Mid-Day,33,184,217,15.21
2012-11-13,16,Tuesday,Evening Rush,28,282,310,9.03
2012-11-13,17,Tuesday,Evening Rush,33,575,608,5.43
2012-11-13,18,Tuesday,Evening Rush,45,514,559,8.05
2012-11-13,19,Tuesday,Evening Rush,12,344,356,3.37
2012-11-13,20,Tuesday,Night,12,211,223,5.38
2012-11-13,21,Tuesday,Night,9,178,187,4.81
2012-11-13,22,Tuesday,Night,15,120,135,11.11
2012-11-13,23,Tuesday,Night,6,78,84,7.14
2012-11-14,0,Wednesday,Early Morning,4,20,24,16.67
2012-11-14,1,Wednesday,Early Morning,2,10,12,16.67
2012-11-14,2,Wednesday,Early Morning,0,1,1,0.0
2012-11-14,3,Wednesday,Early Morning,0,5,5,0.0
2012-11-14,4,Wednesday,Early Morning,0,6,6,0.0
2012-11-14,5,Wednesday,Early Morning,0,39,39,0.0
2012-11-14,6,Wednesday,Morning Rush,4,142,146,2.74
2012-11-14,7,Wednesday,Morning Rush,10,405,415,2.41
2012-11-14,8,Wednesday,Morning Rush,27,664,691,3.91
2012-11-14,9,Wednesday,Morning Rush,22,310,332,6.63
2012-11-14,10,Wednesday,Mid-Day,18,153,171,10.53
2012-11-14,11,Wednesday,Mid-Day,25,126,151,16.56
2012-11-14,12,Wednesday,Mid-Day,40,200,240,16.67
2012-11-14,13,Wednesday,Mid-Day,32,182,214,14.95
2012-11-14,14,Wednesday,Mid-Day,20,161,181,11.05
2012-11-14,15,Wednesday,Mid-Day,32,228,260,12.31
2012-11-14,16,Wednesday,Evening Rush,31,290,321,9.66
2012-11-14,17,Wednesday,Evening Rush,19,564,583,3.26
2012-11-14,18,Wednesday,Evening Rush,24,543,567,4.23
2012-11-14,19,Wednesday,Evening Rush,28,368,396,7.07
2012-11-14,20,Wednesday,Night,15,252,267,5.62
2012-11-14,21,Wednesday,Night,5,208,213,2.35
2012-11-14,22,Wednesday,Night,6,167,173,3.47
2012-11-14,23,Wednesday,Night,9,78,87,10.34
2012-11-15,0,Thursday,Early Morning,1,33,34,2.94
2012-11-15,1,Thursday,Early Morning,2,14,16,12.5
2012-11-15,2,Thursday,Early Morning,0,7,7,0.0
2012-11-15,3,Thursday,Early Morning,0,2,2,0.0
2012-11-15,4,Thursday,Early Morning,0,5,5,0.0
2012-11-15,5,Thursday,Early Morning,3,34,37,8.11
2012-11-15,6,Thursday,Morning Rush,1,146,147,0.68
2012-11-15,7,Thursday,Morning Rush,7,403,410,1.71
2012-11-15,8,Thursday,Morning Rush,21,625,646,3.25
2012-11-15,9,Thursday,Morning Rush,17,306,323,5.26
2012-11-15,10,Thursday,Mid-Day,11,142,153,7.19
2012-11-15,11,Thursday,Mid-Day,28,138,166,16.87
2012-11-15,12,Thursday,Mid-Day,29,184,213,13.62
2012-11-15,13,Thursday,Mid-Day,20,197,217,9.22
2012-11-15,14,Thursday,Mid-Day,27,174,201,13.43
2012-11-15,15,Thursday,Mid-Day,26,191,217,11.98
2012-11-15,16,Thursday,Evening Rush,24,318,342,7.02
2012-11-15,17,Thursday,Evening Rush,22,541,563,3.91
2012-11-15,18,Thursday,Evening Rush,10,563,573,1.75
2012-11-15,19,Thursday,Evening Rush,11,375,386,2.85
2012-11-15,20,Thursday,Night,23,262,285,8.07
2012-11-15,21,Thursday,Night,20,204,224,8.93
2012-11-15,22,Thursday,Night,10,143,153,6.54
2012-11-15,23,Thursday,Night,7,118,125,5.6
2012-11-16,0,Friday,Early Morning,7,58,65,10.77
2012-11-16,1,Friday,Early Morning,5,16,21,23.81
2012-11-16,2,Friday,Early Morning,0,9,9,0.0
2012-11-16,3,Friday,Early Morning,0,6,6,0.0
2012-11-16,4,Friday,Early Morning,0,5,5,0.0
2012-11-16,5,Friday,Early Morning,2,34,36,5.56
2012-11-16,6,Friday,Morning Rush,4,126,130,3.08
2012-11-16,7,Friday,Morning Rush,5,362,367,1.36
2012-11-16,8,Friday,Morning Rush,17,694,711,2.39
2012-11-16,9,Friday,Morning Rush,21,330,351,5.98
2012-11-16,10,Friday,Mid-Day,33,165,198,16.67
2012-11-16,11,Friday,Mid-Day,33,185,218,15.14
2012-11-16,12,Friday,Mid-Day,28,262,290,9.66
2012-11-16,13,Friday,Mid-Day,52,226,278,18.71
2012-11-16,14,Friday,Mid-Day,47,204,251,18.73
2012-11-16,15,Friday,Mid-Day,30,237,267,11.24
2012-11-16,16,Friday,Evening Rush,33,350,383,8.62
2012-11-16,17,Friday,Evening Rush,41,539,580,7.07
2012-11-16,18,Friday,Evening Rush,22,483,505,4.36
2012-11-16,19,Friday,Evening Rush,26,306,332,7.83
2012-11-16,20,Friday,Night,20,207,227,8.81
2012-11-16,21,Friday,Night,21,157,178,11.8
2012-11-16,22,Friday,Night,23,139,162,14.2
2012-11-16,23,Friday,Night,14,114,128,10.94
2012-11-17,0,Saturday,Early Morning,11,95,106,10.38
2012-11-17,1,Saturday,Early Morning,13,74,87,14.94
2012-11-17,2,Saturday,Early Morning,8,41,49,16.33
2012-11-17,3,Saturday,Early Morning,2,19,21,9.52
2012-11-17,4,Saturday,Early Morning,1,6,7,14.29
2012-11-17,5,Saturday,Early Morning,1,10,11,9.09
2012-11-17,6,Saturday,Morning Rush,0,21,21,0.0
2012-11-17,7,Saturday,Morning Rush,8,70,78,10.26
2012-11-17,8,Saturday,Morning Rush,30,138,168,17.86
2012-11-17,9,Saturday,Morning Rush,48,200,248,19.35
2012-11-17,10,Saturday,Mid-Day,62,258,320,19.38
2012-11-17,11,Saturday,Mid-Day,80,343,423,18.91
2012-11-17,12,Saturday,Mid-Day,117,359,476,24.58
2012-11-17,13,Saturday,Mid-Day,179,346,525,34.1
2012-11-17,14,Saturday,Mid-Day,175,380,555,31.53
2012-11-17,15,Saturday,Mid-Day,175,374,549,31.88
2012-11-17,16,Saturday,Evening Rush,144,325,469,30.7
2012-11-17,17,Saturday,Evening Rush,101,302,403,25.06
2012-11-17,18,Saturday,Evening Rush,34,237,271,12.55
2012-11-17,19,Saturday,Evening Rush,45,208,253,17.79
2012-11-17,20,Saturday,Night,30,142,172,17.44
2012-11-17,21,Saturday,Night,15,124,139,10.79
2012-11-17,22,Saturday,Night,15,130,145,10.34
2012-11-17,23,Saturday,Night,19,114,133,14.29
2012-11-18,0,Sunday,Early Morning,11,118,129,8.53
2012-11-18,1,Sunday,Early Morning,14,81,95,14.74
2012-11-18,2,Sunday,Early Morning,8,65,73,10.96
2012-11-18,3,Sunday,Early Morning,9,37,46,19.57
2012-11-18,4,Sunday,Early Morning,4,8,12,33.33
2012-11-18,5,Sunday,Early Morning,5,7,12,41.67
2012-11-18,6,Sunday,Morning Rush,2,13,15,13.33
2012-11-18,7,Sunday,Morning Rush,3,39,42,7.14
2012-11-18,8,Sunday,Morning Rush,19,100,119,15.97
2012-11-18,9,Sunday,Morning Rush,49,155,204,24.02
2012-11-18,10,Sunday,Mid-Day,79,250,329,24.01
2012-11-18,11,Sunday,Mid-Day,92,267,359,25.63
2012-11-18,12,Sunday,Mid-Day,101,341,442,22.85
2012-11-18,13,Sunday,Mid-Day,113,334,447,25.28
2012-11-18,14,Sunday,Mid-Day,125,303,428,29.21
2012-11-18,15,Sunday,Mid-Day,89,318,407,21.87
2012-11-18,16,Sunday,Evening Rush,59,313,372,15.86
2012-11-18,17,Sunday,Evening Rush,48,232,280,17.14
2012-11-18,18,Sunday,Evening Rush,36,240,276,13.04
2012-11-18,19,Sunday,Evening Rush,16,194,210,7.62
2012-11-18,20,Sunday,Night,9,120,129,6.98
2012-11-18,21,Sunday,Night,17,93,110,15.45
2012-11-18,22,Sunday,Night,8,66,74,10.81
2012-11-18,23,Sunday,Night,6,53,59,10.17
2012-11-19,0,Monday,Early Morning,5,22,27,18.52
2012-11-19,1,Monday,Early Morning,0,19,19,0.0
2012-11-19,2,Monday,Early Morning,0,5,5,0.0
2012-11-19,3,Monday,Early Morning,0,2,2,0.0
2012-11-19,4,Monday,Early Morning,1,11,12,8.33
2012-11-19,5,Monday,Early Morning,1,38,39,2.56
2012-11-19,6,Monday,Morning Rush,3,128,131,2.29
2012-11-19,7,Monday,Morning Rush,5,381,386,1.3
2012-11-19,8,Monday,Morning Rush,13,650,663,1.96
2012-11-19,9,Monday,Morning Rush,18,260,278,6.47
2012-11-19,10,Monday,Mid-Day,33,106,139,23.74
2012-11-19,11,Monday,Mid-Day,33,164,197,16.75
2012-11-19,12,Monday,Mid-Day,35,207,242,14.46
2012-11-19,13,Monday,Mid-Day,46,205,251,18.33
2012-11-19,14,Monday,Mid-Day,47,170,217,21.66
2012-11-19,15,Monday,Mid-Day,44,213,257,17.12
2012-11-19,16,Monday,Evening Rush,55,325,380,14.47
2012-11-19,17,Monday,Evening Rush,33,586,619,5.33
2012-11-19,18,Monday,Evening Rush,21,559,580,3.62
2012-11-19,19,Monday,Evening Rush,25,381,406,6.16
2012-11-19,20,Monday,Night,7,252,259,2.7
2012-11-19,21,Monday,Night,15,188,203,7.39
2012-11-19,22,Monday,Night,7,106,113,6.19
2012-11-19,23,Monday,Night,2,72,74,2.7
2012-11-20,0,Tuesday,Early Morning,3,26,29,10.34
2012-11-20,1,Tuesday,Early Morning,3,10,13,23.08
2012-11-20,2,Tuesday,Early Morning,0,5,5,0.0
2012-11-20,3,Tuesday,Early Morning,0,2,2,0.0
2012-11-20,4,Tuesday,Early Morning,0,6,6,0.0
2012-11-20,5,Tuesday,Early Morning,2,32,34,5.88
2012-11-20,6,Tuesday,Morning Rush,2,146,148,1.35
2012-11-20,7,Tuesday,Morning Rush,7,411,418,1.67
2012-11-20,8,Tuesday,Morning Rush,16,649,665,2.41
2012-11-20,9,Tuesday,Morning Rush,28,298,326,8.59
2012-11-20,10,Tuesday,Mid-Day,32,144,176,18.18
2012-11-20,11,Tuesday,Mid-Day,45,160,205,21.95
2012-11-20,12,Tuesday,Mid-Day,70,243,313,22.36
2012-11-20,13,Tuesday,Mid-Day,49,218,267,18.35
2012-11-20,14,Tuesday,Mid-Day,47,177,224,20.98
2012-11-20,15,Tuesday,Mid-Day,61,226,287,21.25
2012-11-20,16,Tuesday,Evening Rush,60,335,395,15.19
2012-11-20,17,Tuesday,Evening Rush,37,553,590,6.27
2012-11-20,18,Tuesday,Evening Rush,16,534,550,2.91
2012-11-20,19,Tuesday,Evening Rush,23,361,384,5.99
2012-11-20,20,Tuesday,Night,11,224,235,4.68
2012-11-20,21,Tuesday,Night,14,143,157,8.92
2012-11-20,22,Tuesday,Night,7,115,122,5.74
2012-11-20,23,Tuesday,Night,1,82,83,1.2
2012-11-21,0,Wednesday,Early Morning,1,25,26,3.85
2012-11-21,1,Wednesday,Early Morning,1,13,14,7.14
2012-11-21,2,Wednesday,Early Morning,2,6,8,25.0
2012-11-21,3,Wednesday,Early Morning,0,2,2,0.0
2012-11-21,4,Wednesday,Early Morning,0,10,10,0.0
2012-11-21,5,Wednesday,Early Morning,1,28,29,3.45
2012-11-21,6,Wednesday,Morning Rush,2,99,101,1.98
2012-11-21,7,Wednesday,Morning Rush,11,262,273,4.03
2012-11-21,8,Wednesday,Morning Rush,12,539,551,2.18
2012-11-21,9,Wednesday,Morning Rush,45,320,365,12.33
2012-11-21,10,Wednesday,Mid-Day,22,150,172,12.79
2012-11-21,11,Wednesday,Mid-Day,43,198,241,17.84
2012-11-21,12,Wednesday,Mid-Day,74,270,344,21.51
2012-11-21,13,Wednesday,Mid-Day,70,295,365,19.18
2012-11-21,14,Wednesday,Mid-Day,84,329,413,20.34
2012-11-21,15,Wednesday,Mid-Day,68,381,449,15.14
2012-11-21,16,Wednesday,Evening Rush,59,410,469,12.58
2012-11-21,17,Wednesday,Evening Rush,41,333,374,10.96
2012-11-21,18,Wednesday,Evening Rush,24,287,311,7.72
2012-11-21,19,Wednesday,Evening Rush,23,220,243,9.47
2012-11-21,20,Wednesday,Night,11,125,136,8.09
2012-11-21,21,Wednesday,Night,8,97,105,7.62
2012-11-21,22,Wednesday,Night,6,82,88,6.82
2012-11-21,23,Wednesday,Night,7,50,57,12.28
2012-11-22,0,Thursday,Early Morning,3,43,46,6.52
2012-11-22,1,Thursday,Early Morning,5,37,42,11.9
2012-11-22,2,Thursday,Early Morning,3,15,18,16.67
2012-11-22,3,Thursday,Early Morning,0,6,6,0.0
2012-11-22,4,Thursday,Early Morning,1,2,3,33.33
2012-11-22,5,Thursday,Early Morning,2,6,8,25.0
2012-11-22,6,Thursday,Morning Rush,2,15,17,11.76
2012-11-22,7,Thursday,Morning Rush,7,49,56,12.5
2012-11-22,8,Thursday,Morning Rush,20,77,97,20.62
2012-11-22,9,Thursday,Morning Rush,25,94,119,21.01
2012-11-22,10,Thursday,Mid-Day,65,154,219,29.68
2012-11-22,11,Thursday,Mid-Day,89,143,232,38.36
2012-11-22,12,Thursday,Mid-Day,117,145,262,44.66
2012-11-22,13,Thursday,Mid-Day,125,144,269,46.47
2012-11-22,14,Thursday,Mid-Day,125,95,220,56.82
2012-11-22,15,Thursday,Mid-Day,132,96,228,57.89
2012-11-22,16,Thursday,Evening Rush,101,81,182,55.49
2012-11-22,17,Thursday,Evening Rush,66,43,109,60.55
2012-11-22,18,Thursday,Evening Rush,16,54,70,22.86
2012-11-22,19,Thursday,Evening Rush,13,31,44,29.55
2012-11-22,20,Thursday,Night,15,37,52,28.85
2012-11-22,21,Thursday,Night,7,39,46,15.22
2012-11-22,22,Thursday,Night,8,36,44,18.18
2012-11-22,23,Thursday,Night,8,28,36,22.22
2012-11-23,0,Friday,Early Morning,0,32,32,0.0
2012-11-23,1,Friday,Early Morning,2,11,13,15.38
2012-11-23,2,Friday,Early Morning,1,4,5,20.0
2012-11-23,3,Friday,Early Morning,1,0,1,100.0
2012-11-23,4,Friday,Early Morning,1,3,4,25.0
2012-11-23,5,Friday,Early Morning,0,10,10,0.0
2012-11-23,6,Friday,Morning Rush,0,20,20,0.0
2012-11-23,7,Friday,Morning Rush,5,72,77,6.49
2012-11-23,8,Friday,Morning Rush,11,83,94,11.7
2012-11-23,9,Friday,Morning Rush,32,80,112,28.57
2012-11-23,10,Friday,Mid-Day,87,114,201,43.28
2012-11-23,11,Friday,Mid-Day,121,130,251,48.21
2012-11-23,12,Friday,Mid-Day,186,193,379,49.08
2012-11-23,13,Friday,Mid-Day,224,200,424,52.83
2012-11-23,14,Friday,Mid-Day,240,195,435,55.17
2012-11-23,15,Friday,Mid-Day,233,214,447,52.13
2012-11-23,16,Friday,Evening Rush,158,199,357,44.26
2012-11-23,17,Friday,Evening Rush,117,183,300,39.0
2012-11-23,18,Friday,Evening Rush,50,158,208,24.04
2012-11-23,19,Friday,Evening Rush,33,121,154,21.43
2012-11-23,20,Friday,Night,42,100,142,29.58
2012-11-23,21,Friday,Night,23,75,98,23.47
2012-11-23,22,Friday,Night,16,63,79,20.25
2012-11-23,23,Friday,Night,20,47,67,29.85
2012-11-24,0,Saturday,Early Morning,9,33,42,21.43
2012-11-24,1,Saturday,Early Morning,1,19,20,5.0
2012-11-24,2,Saturday,Early Morning,10,22,32,31.25
2012-11-24,3,Saturday,Early Morning,6,5,11,54.55
2012-11-24,4,Saturday,Early Morning,1,2,3,33.33
2012-11-24,5,Saturday,Early Morning,1,2,3,33.33
2012-11-24,6,Saturday,Morning Rush,1,9,10,10.0
2012-11-24,7,Saturday,Morning Rush,4,21,25,16.0
2012-11-24,8,Saturday,Morning Rush,7,55,62,11.29
2012-11-24,9,Saturday,Morning Rush,26,96,122,21.31
2012-11-24,10,Saturday,Mid-Day,46,96,142,32.39
2012-11-24,11,Saturday,Mid-Day,55,131,186,29.57
2012-11-24,12,Saturday,Mid-Day,53,146,199,26.63
2012-11-24,13,Saturday,Mid-Day,64,161,225,28.44
2012-11-24,14,Saturday,Mid-Day,58,149,207,28.02
2012-11-24,15,Saturday,Mid-Day,59,139,198,29.8
2012-11-24,16,Saturday,Evening Rush,43,127,170,25.29
2012-11-24,17,Saturday,Evening Rush,29,97,126,23.02
2012-11-24,18,Saturday,Evening Rush,22,123,145,15.17
2012-11-24,19,Saturday,Evening Rush,9,74,83,10.84
2012-11-24,20,Saturday,Night,3,55,58,5.17
2012-11-24,21,Saturday,Night,9,66,75,12.0
2012-11-24,22,Saturday,Night,7,69,76,9.21
2012-11-24,23,Saturday,Night,9,48,57,15.79
2012-11-25,0,Sunday,Early Morning,3,31,34,8.82
2012-11-25,1,Sunday,Early Morning,4,32,36,11.11
2012-11-25,2,Sunday,Early Morning,1,27,28,3.57
2012-11-25,3,Sunday,Early Morning,0,8,8,0.0
2012-11-25,4,Sunday,Early Morning,1,1,2,50.0
2012-11-25,5,Sunday,Early Morning,0,3,3,0.0
2012-11-25,6,Sunday,Morning Rush,1,10,11,9.09
2012-11-25,7,Sunday,Morning Rush,2,19,21,9.52
2012-11-25,8,Sunday,Morning Rush,2,32,34,5.88
2012-11-25,9,Sunday,Morning Rush,13,83,96,13.54
2012-11-25,10,Sunday,Mid-Day,15,124,139,10.79
2012-11-25,11,Sunday,Mid-Day,49,155,204,24.02
2012-11-25,12,Sunday,Mid-Day,37,165,202,18.32
2012-11-25,13,Sunday,Mid-Day,37,158,195,18.97
2012-11-25,14,Sunday,Mid-Day,33,170,203,16.26
2012-11-25,15,Sunday,Mid-Day,36,209,245,14.69
2012-11-25,16,Sunday,Evening Rush,25,203,228,10.96
2012-11-25,17,Sunday,Evening Rush,11,170,181,6.08
2012-11-25,18,Sunday,Evening Rush,9,132,141,6.38
2012-11-25,19,Sunday,Evening Rush,13,114,127,10.24
2012-11-25,20,Sunday,Night,9,110,119,7.56
2012-11-25,21,Sunday,Night,4,60,64,6.25
2012-11-25,22,Sunday,Night,3,59,62,4.84
2012-11-25,23,Sunday,Night,1,40,41,2.44
2012-11-26,0,Monday,Early Morning,4,19,23,17.39
2012-11-26,1,Monday,Early Morning,1,9,10,10.0
2012-11-26,2,Monday,Early Morning,0,5,5,0.0
2012-11-26,3,Monday,Early Morning,1,4,5,20.0
2012-11-26,4,Monday,Early Morning,0,10,10,0.0
2012-11-26,5,Monday,Early Morning,0,41,41,0.0
2012-11-26,6,Monday,Morning Rush,1,123,124,0.81
2012-11-26,7,Monday,Morning Rush,2,363,365,0.55
2012-11-26,8,Monday,Morning Rush,9,629,638,1.41
2012-11-26,9,Monday,Morning Rush,10,276,286,3.5
2012-11-26,10,Monday,Mid-Day,20,127,147,13.61
2012-11-26,11,Monday,Mid-Day,18,112,130,13.85
2012-11-26,12,Monday,Mid-Day,22,188,210,10.48
2012-11-26,13,Monday,Mid-Day,20,197,217,9.22
2012-11-26,14,Monday,Mid-Day,51,177,228,22.37
2012-11-26,15,Monday,Mid-Day,49,181,230,21.3
2012-11-26,16,Monday,Evening Rush,49,297,346,14.16
2012-11-26,17,Monday,Evening Rush,13,540,553,2.35
2012-11-26,18,Monday,Evening Rush,19,502,521,3.65
2012-11-26,19,Monday,Evening Rush,16,355,371,4.31
2012-11-26,20,Monday,Night,12,265,277,4.33
2012-11-26,21,Monday,Night,9,172,181,4.97
2012-11-26,22,Monday,Night,3,101,104,2.88
2012-11-26,23,Monday,Night,8,57,65,12.31
2012-11-27,0,Tuesday,Early Morning,2,24,26,7.69
2012-11-27,1,Tuesday,Early Morning,0,6,6,0.0
2012-11-27,2,Tuesday,Early Morning,0,5,5,0.0
2012-11-27,3,Tuesday,Early Morning,1,3,4,25.0
2012-11-27,4,Tuesday,Early Morning,0,5,5,0.0
2012-11-27,5,Tuesday,Early Morning,0,31,31,0.0
2012-11-27,6,Tuesday,Morning Rush,3,97,100,3.0
2012-11-27,7,Tuesday,Morning Rush,4,289,293,1.37
2012-11-27,8,Tuesday,Morning Rush,6,494,500,1.2
2012-11-27,9,Tuesday,Morning Rush,11,257,268,4.1
2012-11-27,10,Tuesday,Mid-Day,5,52,57,8.77
2012-11-27,11,Tuesday,Mid-Day,6,59,65,9.23
2012-11-27,12,Tuesday,Mid-Day,6,70,76,7.89
2012-11-27,13,Tuesday,Mid-Day,4,73,77,5.19
2012-11-27,14,Tuesday,Mid-Day,8,86,94,8.51
2012-11-27,15,Tuesday,Mid-Day,9,146,155,5.81
2012-11-27,16,Tuesday,Evening Rush,5,252,257,1.95
2012-11-27,17,Tuesday,Evening Rush,13,514,527,2.47
2012-11-27,18,Tuesday,Evening Rush,13,469,482,2.7
2012-11-27,19,Tuesday,Evening Rush,12,338,350,3.43
2012-11-27,20,Tuesday,Night,4,228,232,1.72
2012-11-27,21,Tuesday,Night,6,179,185,3.24
2012-11-27,22,Tuesday,Night,2,95,97,2.06
2012-11-27,23,Tuesday,Night,3,64,67,4.48
2012-11-28,0,Wednesday,Early Morning,1,22,23,4.35
2012-11-28,1,Wednesday,Early Morning,0,12,12,0.0
2012-11-28,2,Wednesday,Early Morning,0,1,1,0.0
2012-11-28,3,Wednesday,Early Morning,0,3,3,0.0
2012-11-28,4,Wednesday,Early Morning,0,4,4,0.0
2012-11-28,5,Wednesday,Early Morning,0,39,39,0.0
2012-11-28,6,Wednesday,Morning Rush,4,132,136,2.94
2012-11-28,7,Wednesday,Morning Rush,6,403,409,1.47
2012-11-28,8,Wednesday,Morning Rush,9,683,692,1.3
2012-11-28,9,Wednesday,Morning Rush,13,309,322,4.04
2012-11-28,10,Wednesday,Mid-Day,17,144,161,10.56
2012-11-28,11,Wednesday,Mid-Day,19,127,146,13.01
2012-11-28,12,Wednesday,Mid-Day,19,189,208,9.13
2012-11-28,13,Wednesday,Mid-Day,21,193,214,9.81
2012-11-28,14,Wednesday,Mid-Day,15,161,176,8.52
2012-11-28,15,Wednesday,Mid-Day,7,172,179,3.91
2012-11-28,16,Wednesday,Evening Rush,9,316,325,2.77
2012-11-28,17,Wednesday,Evening Rush,17,546,563,3.02
2012-11-28,18,Wednesday,Evening Rush,12,530,542,2.21
2012-11-28,19,Wednesday,Evening Rush,9,378,387,2.33
2012-11-28,20,Wednesday,Night,5,258,263,1.9
2012-11-28,21,Wednesday,Night,4,219,223,1.79
2012-11-28,22,Wednesday,Night,6,148,154,3.9
2012-11-28,23,Wednesday,Night,5,73,78,6.41
2012-11-29,0,Thursday,Early Morning,4,25,29,13.79
2012-11-29,1,Thursday,Early Morning,1,15,16,6.25
2012-11-29,2,Thursday,Early Morning,1,6,7,14.29
2012-11-29,4,Thursday,Early Morning,0,7,7,0.0
2012-11-29,5,Thursday,Early Morning,0,42,42,0.0
2012-11-29,6,Thursday,Morning Rush,1,120,121,0.83
2012-11-29,7,Thursday,Morning Rush,8,354,362,2.21
2012-11-29,8,Thursday,Morning Rush,15,664,679,2.21
2012-11-29,9,Thursday,Morning Rush,13,286,299,4.35
2012-11-29,10,Thursday,Mid-Day,25,153,178,14.04
2012-11-29,11,Thursday,Mid-Day,13,150,163,7.98
2012-11-29,12,Thursday,Mid-Day,11,225,236,4.66
2012-11-29,13,Thursday,Mid-Day,15,209,224,6.7
2012-11-29,14,Thursday,Mid-Day,13,174,187,6.95
2012-11-29,15,Thursday,Mid-Day,19,201,220,8.64
2012-11-29,16,Thursday,Evening Rush,24,346,370,6.49
2012-11-29,17,Thursday,Evening Rush,17,544,561,3.03
2012-11-29,18,Thursday,Evening Rush,17,520,537,3.17
2012-11-29,19,Thursday,Evening Rush,18,326,344,5.23
2012-11-29,20,Thursday,Night,11,241,252,4.37
2012-11-29,21,Thursday,Night,7,201,208,3.37
2012-11-29,22,Thursday,Night,4,147,151,2.65
2012-11-29,23,Thursday,Night,6,124,130,4.62
2012-11-30,0,Friday,Early Morning,4,48,52,7.69
2012-11-30,1,Friday,Early Morning,2,17,19,10.53
2012-11-30,2,Friday,Early Morning,2,10,12,16.67
2012-11-30,3,Friday,Early Morning,0,4,4,0.0
2012-11-30,4,Friday,Early Morning,0,3,3,0.0
2012-11-30,5,Friday,Early Morning,1,39,40,2.5
2012-11-30,6,Friday,Morning Rush,2,104,106,1.89
2012-11-30,7,Friday,Morning Rush,6,346,352,1.7
2012-11-30,8,Friday,Morning Rush,20,709,729,2.74
2012-11-30,9,Friday,Morning Rush,17,313,330,5.15
2012-11-30,10,Friday,Mid-Day,10,159,169,5.92
2012-11-30,11,Friday,Mid-Day,31,170,201,15.42
2012-11-30,12,Friday,Mid-Day,25,243,268,9.33
2012-11-30,13,Friday,Mid-Day,21,241,262,8.02
2012-11-30,14,Friday,Mid-Day,26,225,251,10.36
2012-11-30,15,Friday,Mid-Day,34,262,296,11.49
2012-11-30,16,Friday,Evening Rush,37,368,405,9.14
2012-11-30,17,Friday,Evening Rush,31,551,582,5.33
2012-11-30,18,Friday,Evening Rush,20,489,509,3.93
2012-11-30,19,Friday,Evening Rush,18,359,377,4.77
2012-11-30,20,Friday,Night,12,233,245,4.9
2012-11-30,21,Friday,Night,14,169,183,7.65
2012-11-30,22,Friday,Night,18,145,163,11.04
2012-11-30,23,Friday,Night,11,99,110,10.0
2012-12-01,0,Saturday,Early Morning,9,99,108,8.33
2012-12-01,1,Saturday,Early Morning,5,64,69,7.25
2012-12-01,2,Saturday,Early Morning,3,47,50,6.0
2012-12-01,3,Saturday,Early Morning,1,14,15,6.67
2012-12-01,4,Saturday,Early Morning,0,5,5,0.0
2012-12-01,5,Saturday,Early Morning,1,12,13,7.69
2012-12-01,6,Saturday,Morning Rush,7,20,27,25.93
2012-12-01,7,Saturday,Morning Rush,7,56,63,11.11
2012-12-01,8,Saturday,Morning Rush,11,133,144,7.64
2012-12-01,9,Saturday,Morning Rush,34,159,193,17.62
2012-12-01,10,Saturday,Mid-Day,45,211,256,17.58
2012-12-01,11,Saturday,Mid-Day,74,318,392,18.88
2012-12-01,12,Saturday,Mid-Day,119,327,446,26.68
2012-12-01,13,Saturday,Mid-Day,123,386,509,24.17
2012-12-01,14,Saturday,Mid-Day,110,369,479,22.96
2012-12-01,15,Saturday,Mid-Day,113,371,484,23.35
2012-12-01,16,Saturday,Evening Rush,89,354,443,20.09
2012-12-01,17,Saturday,Evening Rush,50,270,320,15.63
2012-12-01,18,Saturday,Evening Rush,42,255,297,14.14
2012-12-01,19,Saturday,Evening Rush,30,219,249,12.05
2012-12-01,20,Saturday,Night,28,170,198,14.14
2012-12-01,21,Saturday,Night,23,135,158,14.56
2012-12-01,22,Saturday,Night,17,130,147,11.56
2012-12-01,23,Saturday,Night,10,116,126,7.94
2012-12-02,0,Sunday,Early Morning,9,108,117,7.69
2012-12-02,1,Sunday,Early Morning,10,84,94,10.64
2012-12-02,2,Sunday,Early Morning,2,72,74,2.7
2012-12-02,3,Sunday,Early Morning,4,21,25,16.0
2012-12-02,4,Sunday,Early Morning,1,6,7,14.29
2012-12-02,5,Sunday,Early Morning,1,7,8,12.5
2012-12-02,6,Sunday,Morning Rush,1,15,16,6.25
2012-12-02,7,Sunday,Morning Rush,5,26,31,16.13
2012-12-02,8,Sunday,Morning Rush,12,81,93,12.9
2012-12-02,9,Sunday,Morning Rush,37,135,172,21.51
2012-12-02,10,Sunday,Mid-Day,63,230,293,21.5
2012-12-02,11,Sunday,Mid-Day,81,274,355,22.82
2012-12-02,12,Sunday,Mid-Day,111,409,520,21.35
2012-12-02,13,Sunday,Mid-Day,84,347,431,19.49
2012-12-02,14,Sunday,Mid-Day,142,331,473,30.02
2012-12-02,15,Sunday,Mid-Day,106,311,417,25.42
2012-12-02,16,Sunday,Evening Rush,85,358,443,19.19
2012-12-02,17,Sunday,Evening Rush,59,244,303,19.47
2012-12-02,18,Sunday,Evening Rush,25,178,203,12.32
2012-12-02,19,Sunday,Evening Rush,16,158,174,9.2
2012-12-02,20,Sunday,Night,12,142,154,7.79
2012-12-02,21,Sunday,Night,8,91,99,8.08
2012-12-02,22,Sunday,Night,11,85,96,11.46
2012-12-02,23,Sunday,Night,7,44,51,13.73
2012-12-03,0,Monday,Early Morning,3,18,21,14.29
2012-12-03,1,Monday,Early Morning,2,11,13,15.38
2012-12-03,2,Monday,Early Morning,1,9,10,10.0
2012-12-03,3,Monday,Early Morning,2,6,8,25.0
2012-12-03,4,Monday,Early Morning,1,4,5,20.0
2012-12-03,5,Monday,Early Morning,0,38,38,0.0
2012-12-03,6,Monday,Morning Rush,2,136,138,1.45
2012-12-03,7,Monday,Morning Rush,9,387,396,2.27
2012-12-03,8,Monday,Morning Rush,19,712,731,2.6
2012-12-03,9,Monday,Morning Rush,19,289,308,6.17
2012-12-03,10,Monday,Mid-Day,31,105,136,22.79
2012-12-03,11,Monday,Mid-Day,51,182,233,21.89
2012-12-03,12,Monday,Mid-Day,40,228,268,14.93
2012-12-03,13,Monday,Mid-Day,81,240,321,25.23
2012-12-03,14,Monday,Mid-Day,51,209,260,19.62
2012-12-03,15,Monday,Mid-Day,58,210,268,21.64
2012-12-03,16,Monday,Evening Rush,45,397,442,10.18
2012-12-03,17,Monday,Evening Rush,43,665,708,6.07
2012-12-03,18,Monday,Evening Rush,26,666,692,3.76
2012-12-03,19,Monday,Evening Rush,27,444,471,5.73
2012-12-03,20,Monday,Night,16,284,300,5.33
2012-12-03,21,Monday,Night,14,207,221,6.33
2012-12-03,22,Monday,Night,5,139,144,3.47
2012-12-03,23,Monday,Night,9,93,102,8.82
2012-12-04,0,Tuesday,Early Morning,6,49,55,10.91
2012-12-04,1,Tuesday,Early Morning,3,22,25,12.0
2012-12-04,2,Tuesday,Early Morning,3,5,8,37.5
2012-12-04,3,Tuesday,Early Morning,1,3,4,25.0
2012-12-04,4,Tuesday,Early Morning,0,7,7,0.0
2012-12-04,5,Tuesday,Early Morning,1,45,46,2.17
2012-12-04,6,Tuesday,Morning Rush,3,150,153,1.96
2012-12-04,7,Tuesday,Morning Rush,7,495,502,1.39
2012-12-04,8,Tuesday,Morning Rush,21,700,721,2.91
2012-12-04,9,Tuesday,Morning Rush,19,317,336,5.65
2012-12-04,10,Tuesday,Mid-Day,26,130,156,16.67
2012-12-04,11,Tuesday,Mid-Day,24,183,207,11.59
2012-12-04,12,Tuesday,Mid-Day,39,273,312,12.5
2012-12-04,13,Tuesday,Mid-Day,39,233,272,14.34
2012-12-04,14,Tuesday,Mid-Day,39,231,270,14.44
2012-12-04,15,Tuesday,Mid-Day,56,244,300,18.67
2012-12-04,16,Tuesday,Evening Rush,44,391,435,10.11
2012-12-04,17,Tuesday,Evening Rush,43,700,743,5.79
2012-12-04,18,Tuesday,Evening Rush,38,693,731,5.2
2012-12-04,19,Tuesday,Evening Rush,46,414,460,10.0
2012-12-04,20,Tuesday,Night,34,272,306,11.11
2012-12-04,21,Tuesday,Night,28,252,280,10.0
2012-12-04,22,Tuesday,Night,26,155,181,14.36
2012-12-04,23,Tuesday,Night,5,91,96,5.21
2012-12-05,0,Wednesday,Early Morning,6,31,37,16.22
2012-12-05,1,Wednesday,Early Morning,0,11,11,0.0
2012-12-05,2,Wednesday,Early Morning,2,7,9,22.22
2012-12-05,3,Wednesday,Early Morning,0,7,7,0.0
2012-12-05,4,Wednesday,Early Morning,1,9,10,10.0
2012-12-05,5,Wednesday,Early Morning,1,48,49,2.04
2012-12-05,6,Wednesday,Morning Rush,5,119,124,4.03
2012-12-05,7,Wednesday,Morning Rush,9,389,398,2.26
2012-12-05,8,Wednesday,Morning Rush,22,737,759,2.9
2012-12-05,9,Wednesday,Morning Rush,26,362,388,6.7
2012-12-05,10,Wednesday,Mid-Day,14,127,141,9.93
2012-12-05,11,Wednesday,Mid-Day,11,161,172,6.4
2012-12-05,12,Wednesday,Mid-Day,24,208,232,10.34
2012-12-05,13,Wednesday,Mid-Day,14,200,214,6.54
2012-12-05,14,Wednesday,Mid-Day,39,179,218,17.89
2012-12-05,15,Wednesday,Mid-Day,20,265,285,7.02
2012-12-05,16,Wednesday,Evening Rush,23,354,377,6.1
2012-12-05,17,Wednesday,Evening Rush,29,576,605,4.79
2012-12-05,18,Wednesday,Evening Rush,29,580,609,4.76
2012-12-05,19,Wednesday,Evening Rush,14,400,414,3.38
2012-12-05,20,Wednesday,Night,19,274,293,6.48
2012-12-05,21,Wednesday,Night,14,184,198,7.07
2012-12-05,22,Wednesday,Night,4,101,105,3.81
2012-12-05,23,Wednesday,Night,5,69,74,6.76
2012-12-06,0,Thursday,Early Morning,1,43,44,2.27
2012-12-06,1,Thursday,Early Morning,0,16,16,0.0
2012-12-06,2,Thursday,Early Morning,0,9,9,0.0
2012-12-06,3,Thursday,Early Morning,0,2,2,0.0
2012-12-06,4,Thursday,Early Morning,1,8,9,11.11
2012-12-06,5,Thursday,Early Morning,0,32,32,0.0
2012-12-06,6,Thursday,Morning Rush,2,122,124,1.61
2012-12-06,7,Thursday,Morning Rush,8,381,389,2.06
2012-12-06,8,Thursday,Morning Rush,13,646,659,1.97
2012-12-06,9,Thursday,Morning Rush,19,257,276,6.88
2012-12-06,10,Thursday,Mid-Day,23,122,145,15.86
2012-12-06,11,Thursday,Mid-Day,16,162,178,8.99
2012-12-06,12,Thursday,Mid-Day,29,206,235,12.34
2012-12-06,13,Thursday,Mid-Day,33,212,245,13.47
2012-12-06,14,Thursday,Mid-Day,37,175,212,17.45
2012-12-06,15,Thursday,Mid-Day,38,232,270,14.07
2012-12-06,16,Thursday,Evening Rush,39,292,331,11.78
2012-12-06,17,Thursday,Evening Rush,31,586,617,5.02
2012-12-06,18,Thursday,Evening Rush,23,542,565,4.07
2012-12-06,19,Thursday,Evening Rush,13,360,373,3.49
2012-12-06,20,Thursday,Night,5,222,227,2.2
2012-12-06,21,Thursday,Night,7,184,191,3.66
2012-12-06,22,Thursday,Night,2,131,133,1.5
2012-12-06,23,Thursday,Night,0,93,93,0.0
2012-12-07,0,Friday,Early Morning,3,45,48,6.25
2012-12-07,1,Friday,Early Morning,2,26,28,7.14
2012-12-07,2,Friday,Early Morning,0,11,11,0.0
2012-12-07,3,Friday,Early Morning,0,5,5,0.0
2012-12-07,4,Friday,Early Morning,0,10,10,0.0
2012-12-07,5,Friday,Early Morning,1,25,26,3.85
2012-12-07,6,Friday,Morning Rush,0,84,84,0.0
2012-12-07,7,Friday,Morning Rush,3,212,215,1.4
2012-12-07,8,Friday,Morning Rush,11,430,441,2.49
2012-12-07,9,Friday,Morning Rush,10,291,301,3.32
2012-12-07,10,Friday,Mid-Day,16,150,166,9.64
2012-12-07,11,Friday,Mid-Day,20,183,203,9.85
2012-12-07,12,Friday,Mid-Day,36,204,240,15.0
2012-12-07,13,Friday,Mid-Day,23,197,220,10.45
2012-12-07,14,Friday,Mid-Day,40,175,215,18.6
2012-12-07,15,Friday,Mid-Day,34,269,303,11.22
2012-12-07,16,Friday,Evening Rush,39,336,375,10.4
2012-12-07,17,Friday,Evening Rush,29,539,568,5.11
2012-12-07,18,Friday,Evening Rush,25,473,498,5.02
2012-12-07,19,Friday,Evening Rush,15,337,352,4.26
2012-12-07,20,Friday,Night,12,229,241,4.98
2012-12-07,21,Friday,Night,9,162,171,5.26
2012-12-07,22,Friday,Night,15,150,165,9.09
2012-12-07,23,Friday,Night,6,116,122,4.92
2012-12-08,0,Saturday,Early Morning,5,98,103,4.85
2012-12-08,1,Saturday,Early Morning,16,84,100,16.0
2012-12-08,2,Saturday,Early Morning,3,67,70,4.29
2012-12-08,3,Saturday,Early Morning,6,23,29,20.69
2012-12-08,4,Saturday,Early Morning,3,9,12,25.0
2012-12-08,5,Saturday,Early Morning,2,4,6,33.33
2012-12-08,6,Saturday,Morning Rush,1,19,20,5.0
2012-12-08,7,Saturday,Morning Rush,3,36,39,7.69
2012-12-08,8,Saturday,Morning Rush,5,106,111,4.5
2012-12-08,9,Saturday,Morning Rush,17,153,170,10.0
2012-12-08,10,Saturday,Mid-Day,43,244,287,14.98
2012-12-08,11,Saturday,Mid-Day,63,341,404,15.59
2012-12-08,12,Saturday,Mid-Day,122,364,486,25.1
2012-12-08,13,Saturday,Mid-Day,148,399,547,27.06
2012-12-08,14,Saturday,Mid-Day,164,378,542,30.26
2012-12-08,15,Saturday,Mid-Day,167,374,541,30.87
2012-12-08,16,Saturday,Evening Rush,139,368,507,27.42
2012-12-08,17,Saturday,Evening Rush,77,268,345,22.32
2012-12-08,18,Saturday,Evening Rush,40,264,304,13.16
2012-12-08,19,Saturday,Evening Rush,34,212,246,13.82
2012-12-08,20,Saturday,Night,20,162,182,10.99
2012-12-08,21,Saturday,Night,34,175,209,16.27
2012-12-08,22,Saturday,Night,23,137,160,14.37
2012-12-08,23,Saturday,Night,18,144,162,11.11
2012-12-09,0,Sunday,Early Morning,15,103,118,12.71
2012-12-09,1,Sunday,Early Morning,17,85,102,16.67
2012-12-09,2,Sunday,Early Morning,8,70,78,10.26
2012-12-09,3,Sunday,Early Morning,14,34,48,29.17
2012-12-09,4,Sunday,Early Morning,1,11,12,8.33
2012-12-09,5,Sunday,Early Morning,0,8,8,0.0
2012-12-09,6,Sunday,Morning Rush,0,6,6,0.0
2012-12-09,7,Sunday,Morning Rush,1,22,23,4.35
2012-12-09,8,Sunday,Morning Rush,1,68,69,1.45
2012-12-09,9,Sunday,Morning Rush,9,94,103,8.74
2012-12-09,10,Sunday,Mid-Day,39,180,219,17.81
2012-12-09,11,Sunday,Mid-Day,40,210,250,16.0
2012-12-09,12,Sunday,Mid-Day,60,255,315,19.05
2012-12-09,13,Sunday,Mid-Day,65,220,285,22.81
2012-12-09,14,Sunday,Mid-Day,42,190,232,18.1
2012-12-09,15,Sunday,Mid-Day,25,200,225,11.11
2012-12-09,16,Sunday,Evening Rush,33,220,253,13.04
2012-12-09,17,Sunday,Evening Rush,20,209,229,8.73
2012-12-09,18,Sunday,Evening Rush,17,181,198,8.59
2012-12-09,19,Sunday,Evening Rush,12,110,122,9.84
2012-12-09,20,Sunday,Night,6,102,108,5.56
2012-12-09,21,Sunday,Night,10,86,96,10.42
2012-12-09,22,Sunday,Night,3,75,78,3.85
2012-12-09,23,Sunday,Night,3,48,51,5.88
2012-12-10,0,Monday,Early Morning,0,20,20,0.0
2012-12-10,1,Monday,Early Morning,0,4,4,0.0
2012-12-10,2,Monday,Early Morning,2,3,5,40.0
2012-12-10,3,Monday,Early Morning,0,4,4,0.0
2012-12-10,4,Monday,Early Morning,3,9,12,25.0
2012-12-10,5,Monday,Early Morning,0,27,27,0.0
2012-12-10,6,Monday,Morning Rush,2,121,123,1.63
2012-12-10,7,Monday,Morning Rush,3,291,294,1.02
2012-12-10,8,Monday,Morning Rush,9,575,584,1.54
2012-12-10,9,Monday,Morning Rush,11,273,284,3.87
2012-12-10,10,Monday,Mid-Day,12,121,133,9.02
2012-12-10,11,Monday,Mid-Day,8,126,134,5.97
2012-12-10,12,Monday,Mid-Day,23,150,173,13.29
2012-12-10,13,Monday,Mid-Day,30,190,220,13.64
2012-12-10,14,Monday,Mid-Day,31,179,210,14.76
2012-12-10,15,Monday,Mid-Day,29,207,236,12.29
2012-12-10,16,Monday,Evening Rush,37,308,345,10.72
2012-12-10,17,Monday,Evening Rush,38,578,616,6.17
2012-12-10,18,Monday,Evening Rush,20,544,564,3.55
2012-12-10,19,Monday,Evening Rush,18,409,427,4.22
2012-12-10,20,Monday,Night,13,287,300,4.33
2012-12-10,21,Monday,Night,21,224,245,8.57
2012-12-10,22,Monday,Night,11,115,126,8.73
2012-12-10,23,Monday,Night,8,76,84,9.52
2012-12-11,0,Tuesday,Early Morning,2,29,31,6.45
2012-12-11,1,Tuesday,Early Morning,1,7,8,12.5
2012-12-11,2,Tuesday,Early Morning,0,1,1,0.0
2012-12-11,3,Tuesday,Early Morning,0,3,3,0.0
2012-12-11,4,Tuesday,Early Morning,0,8,8,0.0
2012-12-11,5,Tuesday,Early Morning,1,40,41,2.44
2012-12-11,6,Tuesday,Morning Rush,0,118,118,0.0
2012-12-11,7,Tuesday,Morning Rush,8,372,380,2.11
2012-12-11,8,Tuesday,Morning Rush,16,708,724,2.21
2012-12-11,9,Tuesday,Morning Rush,12,322,334,3.59
2012-12-11,10,Tuesday,Mid-Day,12,142,154,7.79
2012-12-11,11,Tuesday,Mid-Day,28,145,173,16.18
2012-12-11,12,Tuesday,Mid-Day,13,213,226,5.75
2012-12-11,13,Tuesday,Mid-Day,28,226,254,11.02
2012-12-11,14,Tuesday,Mid-Day,19,185,204,9.31
2012-12-11,15,Tuesday,Mid-Day,20,250,270,7.41
2012-12-11,16,Tuesday,Evening Rush,24,334,358,6.7
2012-12-11,17,Tuesday,Evening Rush,21,580,601,3.49
2012-12-11,18,Tuesday,Evening Rush,23,523,546,4.21
2012-12-11,19,Tuesday,Evening Rush,21,412,433,4.85
2012-12-11,20,Tuesday,Night,9,248,257,3.5
2012-12-11,21,Tuesday,Night,14,193,207,6.76
2012-12-11,22,Tuesday,Night,6,100,106,5.66
2012-12-11,23,Tuesday,Night,4,60,64,6.25
2012-12-12,0,Wednesday,Early Morning,1,33,34,2.94
2012-12-12,1,Wednesday,Early Morning,3,18,21,14.29
2012-12-12,2,Wednesday,Early Morning,5,4,9,55.56
2012-12-12,3,Wednesday,Early Morning,3,7,10,30.0
2012-12-12,4,Wednesday,Early Morning,0,4,4,0.0
2012-12-12,5,Wednesday,Early Morning,0,37,37,0.0
2012-12-12,6,Wednesday,Morning Rush,2,126,128,1.56
2012-12-12,7,Wednesday,Morning Rush,3,366,369,0.81
2012-12-12,8,Wednesday,Morning Rush,18,670,688,2.62
2012-12-12,9,Wednesday,Morning Rush,13,272,285,4.56
2012-12-12,10,Wednesday,Mid-Day,20,116,136,14.71
2012-12-12,11,Wednesday,Mid-Day,24,148,172,13.95
2012-12-12,12,Wednesday,Mid-Day,14,218,232,6.03
2012-12-12,13,Wednesday,Mid-Day,18,220,238,7.56
2012-12-12,14,Wednesday,Mid-Day,34,191,225,15.11
2012-12-12,15,Wednesday,Mid-Day,21,207,228,9.21
2012-12-12,16,Wednesday,Evening Rush,19,310,329,5.78
2012-12-12,17,Wednesday,Evening Rush,21,540,561,3.74
2012-12-12,18,Wednesday,Evening Rush,25,515,540,4.63
2012-12-12,19,Wednesday,Evening Rush,18,384,402,4.48
2012-12-12,20,Wednesday,Night,25,243,268,9.33
2012-12-12,21,Wednesday,Night,16,186,202,7.92
2012-12-12,22,Wednesday,Night,4,118,122,3.28
2012-12-12,23,Wednesday,Night,3,76,79,3.8
2012-12-13,0,Thursday,Early Morning,1,31,32,3.13
2012-12-13,1,Thursday,Early Morning,4,19,23,17.39
2012-12-13,2,Thursday,Early Morning,3,5,8,37.5
2012-12-13,3,Thursday,Early Morning,0,2,2,0.0
2012-12-13,4,Thursday,Early Morning,0,8,8,0.0
2012-12-13,5,Thursday,Early Morning,2,31,33,6.06
2012-12-13,6,Thursday,Morning Rush,2,112,114,1.75
2012-12-13,7,Thursday,Morning Rush,5,380,385,1.3
2012-12-13,8,Thursday,Morning Rush,24,655,679,3.53
2012-12-13,9,Thursday,Morning Rush,25,300,325,7.69
2012-12-13,10,Thursday,Mid-Day,28,139,167,16.77
2012-12-13,11,Thursday,Mid-Day,25,164,189,13.23
2012-12-13,12,Thursday,Mid-Day,30,252,282,10.64
2012-12-13,13,Thursday,Mid-Day,41,230,271,15.13
2012-12-13,14,Thursday,Mid-Day,31,211,242,12.81
2012-12-13,15,Thursday,Mid-Day,40,240,280,14.29
2012-12-13,16,Thursday,Evening Rush,50,356,406,12.32
2012-12-13,17,Thursday,Evening Rush,43,507,550,7.82
2012-12-13,18,Thursday,Evening Rush,20,446,466,4.29
2012-12-13,19,Thursday,Evening Rush,20,328,348,5.75
2012-12-13,20,Thursday,Night,6,235,241,2.49
2012-12-13,21,Thursday,Night,13,200,213,6.1
2012-12-13,22,Thursday,Night,7,141,148,4.73
2012-12-13,23,Thursday,Night,5,115,120,4.17
2012-12-14,0,Friday,Early Morning,4,43,47,8.51
2012-12-14,1,Friday,Early Morning,0,26,26,0.0
2012-12-14,2,Friday,Early Morning,3,6,9,33.33
2012-12-14,3,Friday,Early Morning,0,12,12,0.0
2012-12-14,4,Friday,Early Morning,1,9,10,10.0
2012-12-14,5,Friday,Early Morning,0,34,34,0.0
2012-12-14,6,Friday,Morning Rush,1,112,113,0.88
2012-12-14,7,Friday,Morning Rush,3,305,308,0.97
2012-12-14,8,Friday,Morning Rush,13,623,636,2.04
2012-12-14,9,Friday,Morning Rush,13,330,343,3.79
2012-12-14,10,Friday,Mid-Day,28,162,190,14.74
2012-12-14,11,Friday,Mid-Day,31,180,211,14.69
2012-12-14,12,Friday,Mid-Day,29,244,273,10.62
2012-12-14,13,Friday,Mid-Day,39,274,313,12.46
2012-12-14,14,Friday,Mid-Day,48,251,299,16.05
2012-12-14,15,Friday,Mid-Day,57,252,309,18.45
2012-12-14,16,Friday,Evening Rush,45,372,417,10.79
2012-12-14,17,Friday,Evening Rush,40,582,622,6.43
2012-12-14,18,Friday,Evening Rush,23,432,455,5.05
2012-12-14,19,Friday,Evening Rush,17,302,319,5.33
2012-12-14,20,Friday,Night,12,209,221,5.43
2012-12-14,21,Friday,Night,7,165,172,4.07
2012-12-14,22,Friday,Night,4,134,138,2.9
2012-12-14,23,Friday,Night,11,123,134,8.21
2012-12-15,0,Saturday,Early Morning,4,90,94,4.26
2012-12-15,1,Saturday,Early Morning,9,86,95,9.47
2012-12-15,2,Saturday,Early Morning,6,63,69,8.7
2012-12-15,3,Saturday,Early Morning,5,18,23,21.74
2012-12-15,4,Saturday,Early Morning,1,5,6,16.67
2012-12-15,5,Saturday,Early Morning,0,3,3,0.0
2012-12-15,6,Saturday,Morning Rush,0,11,11,0.0
2012-12-15,7,Saturday,Morning Rush,1,47,48,2.08
2012-12-15,8,Saturday,Morning Rush,8,111,119,6.72
2012-12-15,9,Saturday,Morning Rush,17,203,220,7.73
2012-12-15,10,Saturday,Mid-Day,23,250,273,8.42
2012-12-15,11,Saturday,Mid-Day,66,327,393,16.79
2012-12-15,12,Saturday,Mid-Day,89,364,453,19.65
2012-12-15,13,Saturday,Mid-Day,88,368,456,19.3
2012-12-15,14,Saturday,Mid-Day,92,334,426,21.6
2012-12-15,15,Saturday,Mid-Day,95,352,447,21.25
2012-12-15,16,Saturday,Evening Rush,85,328,413,20.58
2012-12-15,17,Saturday,Evening Rush,35,274,309,11.33
2012-12-15,18,Saturday,Evening Rush,40,232,272,14.71
2012-12-15,19,Saturday,Evening Rush,32,225,257,12.45
2012-12-15,20,Saturday,Night,23,178,201,11.44
2012-12-15,21,Saturday,Night,15,169,184,8.15
2012-12-15,22,Saturday,Night,22,134,156,14.1
2012-12-15,23,Saturday,Night,11,108,119,9.24
2012-12-16,0,Sunday,Early Morning,8,102,110,7.27
2012-12-16,1,Sunday,Early Morning,14,82,96,14.58
2012-12-16,2,Sunday,Early Morning,8,79,87,9.2
2012-12-16,3,Sunday,Early Morning,1,37,38,2.63
2012-12-16,4,Sunday,Early Morning,1,10,11,9.09
2012-12-16,5,Sunday,Early Morning,0,9,9,0.0
2012-12-16,6,Sunday,Morning Rush,0,6,6,0.0
2012-12-16,7,Sunday,Morning Rush,5,22,27,18.52
2012-12-16,8,Sunday,Morning Rush,12,76,88,13.64
2012-12-16,9,Sunday,Morning Rush,19,113,132,14.39
2012-12-16,10,Sunday,Mid-Day,42,215,257,16.34
2012-12-16,11,Sunday,Mid-Day,47,248,295,15.93
2012-12-16,12,Sunday,Mid-Day,67,350,417,16.07
2012-12-16,13,Sunday,Mid-Day,67,289,356,18.82
2012-12-16,14,Sunday,Mid-Day,50,260,310,16.13
2012-12-16,15,Sunday,Mid-Day,46,292,338,13.61
2012-12-16,16,Sunday,Evening Rush,66,334,400,16.5
2012-12-16,17,Sunday,Evening Rush,29,214,243,11.93
2012-12-16,18,Sunday,Evening Rush,8,99,107,7.48
2012-12-16,19,Sunday,Evening Rush,10,99,109,9.17
2012-12-16,20,Sunday,Night,14,108,122,11.48
2012-12-16,21,Sunday,Night,14,92,106,13.21
2012-12-16,22,Sunday,Night,6,83,89,6.74
2012-12-16,23,Sunday,Night,4,29,33,12.12
2012-12-17,0,Monday,Early Morning,2,26,28,7.14
2012-12-17,1,Monday,Early Morning,1,14,15,6.67
2012-12-17,2,Monday,Early Morning,1,4,5,20.0
2012-12-17,3,Monday,Early Morning,0,3,3,0.0
2012-12-17,4,Monday,Early Morning,2,3,5,40.0
2012-12-17,5,Monday,Early Morning,0,24,24,0.0
2012-12-17,6,Monday,Morning Rush,1,107,108,0.93
2012-12-17,7,Monday,Morning Rush,5,314,319,1.57
2012-12-17,8,Monday,Morning Rush,10,582,592,1.69
2012-12-17,9,Monday,Morning Rush,11,271,282,3.9
2012-12-17,10,Monday,Mid-Day,15,120,135,11.11
2012-12-17,11,Monday,Mid-Day,22,148,170,12.94
2012-12-17,12,Monday,Mid-Day,21,211,232,9.05
2012-12-17,13,Monday,Mid-Day,16,194,210,7.62
2012-12-17,14,Monday,Mid-Day,12,169,181,6.63
2012-12-17,15,Monday,Mid-Day,15,196,211,7.11
2012-12-17,16,Monday,Evening Rush,15,287,302,4.97
2012-12-17,17,Monday,Evening Rush,17,478,495,3.43
2012-12-17,18,Monday,Evening Rush,14,493,507,2.76
2012-12-17,19,Monday,Evening Rush,7,333,340,2.06
2012-12-17,20,Monday,Night,8,192,200,4.0
2012-12-17,21,Monday,Night,6,114,120,5.0
2012-12-17,22,Monday,Night,5,49,54,9.26
2012-12-17,23,Monday,Night,6,41,47,12.77
2012-12-18,0,Tuesday,Early Morning,0,18,18,0.0
2012-12-18,1,Tuesday,Early Morning,0,15,15,0.0
2012-12-18,2,Tuesday,Early Morning,2,5,7,28.57
2012-12-18,3,Tuesday,Early Morning,0,5,5,0.0
2012-12-18,4,Tuesday,Early Morning,3,5,8,37.5
2012-12-18,5,Tuesday,Early Morning,0,36,36,0.0
2012-12-18,6,Tuesday,Morning Rush,1,117,118,0.85
2012-12-18,7,Tuesday,Morning Rush,4,351,355,1.13
2012-12-18,8,Tuesday,Morning Rush,10,652,662,1.51
2012-12-18,9,Tuesday,Morning Rush,19,307,326,5.83
2012-12-18,10,Tuesday,Mid-Day,22,162,184,11.96
2012-12-18,11,Tuesday,Mid-Day,58,211,269,21.56
2012-12-18,12,Tuesday,Mid-Day,49,264,313,15.65
2012-12-18,13,Tuesday,Mid-Day,51,235,286,17.83
2012-12-18,14,Tuesday,Mid-Day,56,191,247,22.67
2012-12-18,15,Tuesday,Mid-Day,28,218,246,11.38
2012-12-18,16,Tuesday,Evening Rush,40,323,363,11.02
2012-12-18,17,Tuesday,Evening Rush,39,533,572,6.82
2012-12-18,18,Tuesday,Evening Rush,13,512,525,2.48
2012-12-18,19,Tuesday,Evening Rush,19,334,353,5.38
2012-12-18,20,Tuesday,Night,4,264,268,1.49
2012-12-18,21,Tuesday,Night,9,159,168,5.36
2012-12-18,22,Tuesday,Night,5,127,132,3.79
2012-12-18,23,Tuesday,Night,1,80,81,1.23
2012-12-19,0,Wednesday,Early Morning,6,35,41,14.63
2012-12-19,1,Wednesday,Early Morning,1,14,15,6.67
2012-12-19,2,Wednesday,Early Morning,1,2,3,33.33
2012-12-19,3,Wednesday,Early Morning,0,5,5,0.0
2012-12-19,4,Wednesday,Early Morning,1,6,7,14.29
2012-12-19,5,Wednesday,Early Morning,2,29,31,6.45
2012-12-19,6,Wednesday,Morning Rush,3,109,112,2.68
2012-12-19,7,Wednesday,Morning Rush,3,360,363,0.83
2012-12-19,8,Wednesday,Morning Rush,13,665,678,1.92
2012-12-19,9,Wednesday,Morning Rush,8,309,317,2.52
2012-12-19,10,Wednesday,Mid-Day,17,147,164,10.37
2012-12-19,11,Wednesday,Mid-Day,31,169,200,15.5
2012-12-19,12,Wednesday,Mid-Day,33,203,236,13.98
2012-12-19,13,Wednesday,Mid-Day,30,183,213,14.08
2012-12-19,14,Wednesday,Mid-Day,33,185,218,15.14
2012-12-19,15,Wednesday,Mid-Day,28,209,237,11.81
2012-12-19,16,Wednesday,Evening Rush,37,297,334,11.08
2012-12-19,17,Wednesday,Evening Rush,26,536,562,4.63
2012-12-19,18,Wednesday,Evening Rush,23,546,569,4.04
2012-12-19,19,Wednesday,Evening Rush,7,329,336,2.08
2012-12-19,20,Wednesday,Night,10,231,241,4.15
2012-12-19,21,Wednesday,Night,4,164,168,2.38
2012-12-19,22,Wednesday,Night,12,117,129,9.3
2012-12-19,23,Wednesday,Night,4,84,88,4.55
2012-12-20,0,Thursday,Early Morning,2,40,42,4.76
2012-12-20,1,Thursday,Early Morning,1,19,20,5.0
2012-12-20,2,Thursday,Early Morning,2,6,8,25.0
2012-12-20,3,Thursday,Early Morning,1,3,4,25.0
2012-12-20,4,Thursday,Early Morning,0,6,6,0.0
2012-12-20,5,Thursday,Early Morning,0,35,35,0.0
2012-12-20,6,Thursday,Morning Rush,4,114,118,3.39
2012-12-20,7,Thursday,Morning Rush,4,346,350,1.14
2012-12-20,8,Thursday,Morning Rush,14,585,599,2.34
2012-12-20,9,Thursday,Morning Rush,14,303,317,4.42
2012-12-20,10,Thursday,Mid-Day,23,138,161,14.29
2012-12-20,11,Thursday,Mid-Day,22,168,190,11.58
2012-12-20,12,Thursday,Mid-Day,31,181,212,14.62
2012-12-20,13,Thursday,Mid-Day,46,171,217,21.2
2012-12-20,14,Thursday,Mid-Day,43,171,214,20.09
2012-12-20,15,Thursday,Mid-Day,33,216,249,13.25
2012-12-20,16,Thursday,Evening Rush,21,281,302,6.95
2012-12-20,17,Thursday,Evening Rush,25,450,475,5.26
2012-12-20,18,Thursday,Evening Rush,22,359,381,5.77
2012-12-20,19,Thursday,Evening Rush,3,115,118,2.54
2012-12-20,20,Thursday,Night,1,49,50,2.0
2012-12-20,21,Thursday,Night,1,25,26,3.85
2012-12-20,22,Thursday,Night,1,20,21,4.76
2012-12-20,23,Thursday,Night,0,13,13,0.0
2012-12-21,0,Friday,Early Morning,0,17,17,0.0
2012-12-21,1,Friday,Early Morning,2,7,9,22.22
2012-12-21,2,Friday,Early Morning,0,3,3,0.0
2012-12-21,3,Friday,Early Morning,0,3,3,0.0
2012-12-21,4,Friday,Early Morning,1,5,6,16.67
2012-12-21,5,Friday,Early Morning,0,13,13,0.0
2012-12-21,6,Friday,Morning Rush,4,76,80,5.0
2012-12-21,7,Friday,Morning Rush,3,205,208,1.44
2012-12-21,8,Friday,Morning Rush,8,464,472,1.69
2012-12-21,9,Friday,Morning Rush,2,265,267,0.75
2012-12-21,10,Friday,Mid-Day,8,146,154,5.19
2012-12-21,11,Friday,Mid-Day,12,150,162,7.41
2012-12-21,12,Friday,Mid-Day,25,199,224,11.16
2012-12-21,13,Friday,Mid-Day,26,214,240,10.83
2012-12-21,14,Friday,Mid-Day,20,199,219,9.13
2012-12-21,15,Friday,Mid-Day,29,234,263,11.03
2012-12-21,16,Friday,Evening Rush,28,253,281,9.96
2012-12-21,17,Friday,Evening Rush,24,297,321,7.48
2012-12-21,18,Friday,Evening Rush,7,236,243,2.88
2012-12-21,19,Friday,Evening Rush,5,148,153,3.27
2012-12-21,20,Friday,Night,8,104,112,7.14
2012-12-21,21,Friday,Night,2,68,70,2.86
2012-12-21,22,Friday,Night,6,57,63,9.52
2012-12-21,23,Friday,Night,1,39,40,2.5
2012-12-22,0,Saturday,Early Morning,1,30,31,3.23
2012-12-22,1,Saturday,Early Morning,1,34,35,2.86
2012-12-22,2,Saturday,Early Morning,0,23,23,0.0
2012-12-22,3,Saturday,Early Morning,0,7,7,0.0
2012-12-22,4,Saturday,Early Morning,3,2,5,60.0
2012-12-22,5,Saturday,Early Morning,0,5,5,0.0
2012-12-22,6,Saturday,Morning Rush,0,13,13,0.0
2012-12-22,7,Saturday,Morning Rush,2,18,20,10.0
2012-12-22,8,Saturday,Morning Rush,0,29,29,0.0
2012-12-22,9,Saturday,Morning Rush,13,77,90,14.44
2012-12-22,10,Saturday,Mid-Day,13,105,118,11.02
2012-12-22,11,Saturday,Mid-Day,29,130,159,18.24
2012-12-22,12,Saturday,Mid-Day,18,128,146,12.33
2012-12-22,13,Saturday,Mid-Day,23,135,158,14.56
2012-12-22,14,Saturday,Mid-Day,20,141,161,12.42
2012-12-22,15,Saturday,Mid-Day,14,139,153,9.15
2012-12-22,16,Saturday,Evening Rush,23,124,147,15.65
2012-12-22,17,Saturday,Evening Rush,15,99,114,13.16
2012-12-22,18,Saturday,Evening Rush,7,75,82,8.54
2012-12-22,19,Saturday,Evening Rush,9,51,60,15.0
2012-12-22,20,Saturday,Night,6,55,61,9.84
2012-12-22,21,Saturday,Night,4,49,53,7.55
2012-12-22,22,Saturday,Night,1,38,39,2.56
2012-12-22,23,Saturday,Night,3,37,40,7.5
2012-12-23,0,Sunday,Early Morning,3,24,27,11.11
2012-12-23,1,Sunday,Early Morning,1,19,20,5.0
2012-12-23,2,Sunday,Early Morning,1,17,18,5.56
2012-12-23,3,Sunday,Early Morning,0,9,9,0.0
2012-12-23,4,Sunday,Early Morning,1,3,4,25.0
2012-12-23,5,Sunday,Early Morning,0,6,6,0.0
2012-12-23,6,Sunday,Morning Rush,4,5,9,44.44
2012-12-23,7,Sunday,Morning Rush,3,16,19,15.79
2012-12-23,8,Sunday,Morning Rush,5,43,48,10.42
2012-12-23,9,Sunday,Morning Rush,7,49,56,12.5
2012-12-23,10,Sunday,Mid-Day,26,67,93,27.96
2012-12-23,11,Sunday,Mid-Day,48,104,152,31.58
2012-12-23,12,Sunday,Mid-Day,52,144,196,26.53
2012-12-23,13,Sunday,Mid-Day,63,123,186,33.87
2012-12-23,14,Sunday,Mid-Day,57,118,175,32.57
2012-12-23,15,Sunday,Mid-Day,39,98,137,28.47
2012-12-23,16,Sunday,Evening Rush,53,137,190,27.89
2012-12-23,17,Sunday,Evening Rush,21,93,114,18.42
2012-12-23,18,Sunday,Evening Rush,8,85,93,8.6
2012-12-23,19,Sunday,Evening Rush,4,54,58,6.9
2012-12-23,20,Sunday,Night,0,52,52,0.0
2012-12-23,21,Sunday,Night,4,38,42,9.52
2012-12-23,22,Sunday,Night,5,53,58,8.62
2012-12-23,23,Sunday,Night,3,22,25,12.0
2012-12-24,0,Monday,Early Morning,0,12,12,0.0
2012-12-24,1,Monday,Early Morning,0,11,11,0.0
2012-12-24,2,Monday,Early Morning,0,5,5,0.0
2012-12-24,3,Monday,Early Morning,1,2,3,33.33
2012-12-24,5,Monday,Early Morning,0,9,9,0.0
2012-12-24,6,Monday,Morning Rush,1,16,17,5.88
2012-12-24,7,Monday,Morning Rush,3,27,30,10.0
2012-12-24,8,Monday,Morning Rush,4,62,66,6.06
2012-12-24,9,Monday,Morning Rush,17,68,85,20.0
2012-12-24,10,Monday,Mid-Day,21,82,103,20.39
2012-12-24,11,Monday,Mid-Day,20,104,124,16.13
2012-12-24,12,Monday,Mid-Day,22,113,135,16.3
2012-12-24,13,Monday,Mid-Day,16,54,70,22.86
2012-12-24,14,Monday,Mid-Day,13,33,46,28.26
2012-12-24,15,Monday,Mid-Day,6,27,33,18.18
2012-12-24,16,Monday,Evening Rush,6,27,33,18.18
2012-12-24,17,Monday,Evening Rush,7,19,26,26.92
2012-12-24,18,Monday,Evening Rush,6,20,26,23.08
2012-12-24,19,Monday,Evening Rush,4,14,18,22.22
2012-12-24,20,Monday,Night,6,17,23,26.09
2012-12-24,21,Monday,Night,13,9,22,59.09
2012-12-24,22,Monday,Night,7,5,12,58.33
2012-12-24,23,Monday,Night,1,10,11,9.09
2012-12-25,0,Tuesday,Early Morning,3,10,13,23.08
2012-12-25,1,Tuesday,Early Morning,0,13,13,0.0
2012-12-25,2,Tuesday,Early Morning,0,7,7,0.0
2012-12-25,4,Tuesday,Early Morning,0,1,1,0.0
2012-12-25,5,Tuesday,Early Morning,2,1,3,66.67
2012-12-25,6,Tuesday,Morning Rush,1,6,7,14.29
2012-12-25,7,Tuesday,Morning Rush,0,6,6,0.0
2012-12-25,8,Tuesday,Morning Rush,1,10,11,9.09
2012-12-25,9,Tuesday,Morning Rush,7,21,28,25.0
2012-12-25,10,Tuesday,Mid-Day,11,21,32,34.38
2012-12-25,11,Tuesday,Mid-Day,43,43,86,50.0
2012-12-25,12,Tuesday,Mid-Day,62,52,114,54.39
2012-12-25,13,Tuesday,Mid-Day,75,46,121,61.98
2012-12-25,14,Tuesday,Mid-Day,58,68,126,46.03
2012-12-25,15,Tuesday,Mid-Day,51,56,107,47.66
2012-12-25,16,Tuesday,Evening Rush,48,38,86,55.81
2012-12-25,17,Tuesday,Evening Rush,16,34,50,32.0
2012-12-25,18,Tuesday,Evening Rush,20,23,43,46.51
2012-12-25,19,Tuesday,Evening Rush,16,20,36,44.44
2012-12-25,20,Tuesday,Night,11,29,40,27.5
2012-12-25,21,Tuesday,Night,8,26,34,23.53
2012-12-25,22,Tuesday,Night,3,16,19,15.79
2012-12-25,23,Tuesday,Night,4,26,30,13.33
2012-12-26,0,Wednesday,Early Morning,1,8,9,11.11
2012-12-26,1,Wednesday,Early Morning,0,7,7,0.0
2012-12-26,2,Wednesday,Early Morning,0,1,1,0.0
2012-12-26,3,Wednesday,Early Morning,0,2,2,0.0
2012-12-26,4,Wednesday,Early Morning,0,2,2,0.0
2012-12-26,5,Wednesday,Early Morning,0,11,11,0.0
2012-12-26,6,Wednesday,Morning Rush,0,36,36,0.0
2012-12-26,7,Wednesday,Morning Rush,0,26,26,0.0
2012-12-26,8,Wednesday,Morning Rush,0,31,31,0.0
2012-12-26,9,Wednesday,Morning Rush,1,22,23,4.35
2012-12-26,10,Wednesday,Mid-Day,0,8,8,0.0
2012-12-26,11,Wednesday,Mid-Day,0,10,10,0.0
2012-12-26,12,Wednesday,Mid-Day,0,10,10,0.0
2012-12-26,13,Wednesday,Mid-Day,0,15,15,0.0
2012-12-26,14,Wednesday,Mid-Day,0,20,20,0.0
2012-12-26,15,Wednesday,Mid-Day,0,13,13,0.0
2012-12-26,16,Wednesday,Evening Rush,0,13,13,0.0
2012-12-26,17,Wednesday,Evening Rush,2,51,53,3.77
2012-12-26,18,Wednesday,Evening Rush,1,42,43,2.33
2012-12-26,19,Wednesday,Evening Rush,2,33,35,5.71
2012-12-26,20,Wednesday,Night,0,32,32,0.0
2012-12-26,21,Wednesday,Night,0,20,20,0.0
2012-12-26,22,Wednesday,Night,0,11,11,0.0
2012-12-26,23,Wednesday,Night,2,8,10,20.0
2012-12-27,0,Thursday,Early Morning,0,3,3,0.0
2012-12-27,1,Thursday,Early Morning,0,5,5,0.0
2012-12-27,2,Thursday,Early Morning,0,2,2,0.0
2012-12-27,3,Thursday,Early Morning,0,1,1,0.0
2012-12-27,4,Thursday,Early Morning,0,3,3,0.0
2012-12-27,5,Thursday,Early Morning,1,10,11,9.09
2012-12-27,6,Thursday,Morning Rush,0,45,45,0.0
2012-12-27,7,Thursday,Morning Rush,0,90,90,0.0
2012-12-27,8,Thursday,Morning Rush,2,206,208,0.96
2012-12-27,9,Thursday,Morning Rush,6,127,133,4.51
2012-12-27,10,Thursday,Mid-Day,8,67,75,10.67
2012-12-27,11,Thursday,Mid-Day,23,80,103,22.33
2012-12-27,12,Thursday,Mid-Day,22,87,109,20.18
2012-12-27,13,Thursday,Mid-Day,19,99,118,16.1
2012-12-27,14,Thursday,Mid-Day,25,94,119,21.01
2012-12-27,15,Thursday,Mid-Day,31,89,120,25.83
2012-12-27,16,Thursday,Evening Rush,23,151,174,13.22
2012-12-27,17,Thursday,Evening Rush,30,227,257,11.67
2012-12-27,18,Thursday,Evening Rush,9,188,197,4.57
2012-12-27,19,Thursday,Evening Rush,11,106,117,9.4
2012-12-27,20,Thursday,Night,12,79,91,13.19
2012-12-27,21,Thursday,Night,12,51,63,19.05
2012-12-27,22,Thursday,Night,11,33,44,25.0
2012-12-27,23,Thursday,Night,2,24,26,7.69
2012-12-28,0,Friday,Early Morning,3,22,25,12.0
2012-12-28,1,Friday,Early Morning,0,9,9,0.0
2012-12-28,2,Friday,Early Morning,0,5,5,0.0
2012-12-28,3,Friday,Early Morning,0,2,2,0.0
2012-12-28,4,Friday,Early Morning,0,4,4,0.0
2012-12-28,5,Friday,Early Morning,0,15,15,0.0
2012-12-28,6,Friday,Morning Rush,2,49,51,3.92
2012-12-28,7,Friday,Morning Rush,1,111,112,0.89
2012-12-28,8,Friday,Morning Rush,1,238,239,0.42
2012-12-28,9,Friday,Morning Rush,18,173,191,9.42
2012-12-28,10,Friday,Mid-Day,77,85,162,47.53
2012-12-28,11,Friday,Mid-Day,71,107,178,39.89
2012-12-28,12,Friday,Mid-Day,72,150,222,32.43
2012-12-28,13,Friday,Mid-Day,76,146,222,34.23
2012-12-28,14,Friday,Mid-Day,84,177,261,32.18
2012-12-28,15,Friday,Mid-Day,74,151,225,32.89
2012-12-28,16,Friday,Evening Rush,42,208,250,16.8
2012-12-28,17,Friday,Evening Rush,43,228,271,15.87
2012-12-28,18,Friday,Evening Rush,16,197,213,7.51
2012-12-28,19,Friday,Evening Rush,15,113,128,11.72
2012-12-28,20,Friday,Night,14,83,97,14.43
2012-12-28,21,Friday,Night,17,75,92,18.48
2012-12-28,22,Friday,Night,13,49,62,20.97
2012-12-28,23,Friday,Night,5,54,59,8.47
2012-12-29,0,Saturday,Early Morning,1,25,26,3.85
2012-12-29,1,Saturday,Early Morning,6,31,37,16.22
2012-12-29,2,Saturday,Early Morning,1,18,19,5.26
2012-12-29,3,Saturday,Early Morning,1,5,6,16.67
2012-12-29,4,Saturday,Early Morning,0,3,3,0.0
2012-12-29,5,Saturday,Early Morning,0,3,3,0.0
2012-12-29,6,Saturday,Morning Rush,0,7,7,0.0
2012-12-29,7,Saturday,Morning Rush,1,17,18,5.56
2012-12-29,8,Saturday,Morning Rush,9,35,44,20.45
2012-12-29,9,Saturday,Morning Rush,16,33,49,32.65
2012-12-29,10,Saturday,Mid-Day,6,35,41,14.63
2012-12-29,11,Saturday,Mid-Day,7,38,45,15.56
2012-12-29,12,Saturday,Mid-Day,5,43,48,10.42
2012-12-29,13,Saturday,Mid-Day,13,71,84,15.48
2012-12-29,14,Saturday,Mid-Day,10,88,98,10.2
2012-12-29,15,Saturday,Mid-Day,19,110,129,14.73
2012-12-29,16,Saturday,Evening Rush,22,125,147,14.97
2012-12-29,17,Saturday,Evening Rush,18,100,118,15.25
2012-12-29,18,Saturday,Evening Rush,8,102,110,7.27
2012-12-29,19,Saturday,Evening Rush,7,90,97,7.22
2012-12-29,20,Saturday,Night,2,64,66,3.03
2012-12-29,21,Saturday,Night,4,56,60,6.67
2012-12-29,22,Saturday,Night,3,51,54,5.56
2012-12-29,23,Saturday,Night,0,32,32,0.0
2012-12-30,0,Sunday,Early Morning,0,41,41,0.0
2012-12-30,1,Sunday,Early Morning,1,27,28,3.57
2012-12-30,2,Sunday,Early Morning,0,19,19,0.0
2012-12-30,3,Sunday,Early Morning,1,14,15,6.67
2012-12-30,4,Sunday,Early Morning,0,7,7,0.0
2012-12-30,5,Sunday,Early Morning,0,2,2,0.0
2012-12-30,6,Sunday,Morning Rush,1,7,8,12.5
2012-12-30,7,Sunday,Morning Rush,0,13,13,0.0
2012-12-30,8,Sunday,Morning Rush,1,32,33,3.03
2012-12-30,9,Sunday,Morning Rush,9,65,74,12.16
2012-12-30,10,Sunday,Mid-Day,31,91,122,25.41
2012-12-30,11,Sunday,Mid-Day,33,103,136,24.26
2012-12-30,12,Sunday,Mid-Day,47,97,144,32.64
2012-12-30,13,Sunday,Mid-Day,49,120,169,28.99
2012-12-30,14,Sunday,Mid-Day,39,121,160,24.38
2012-12-30,15,Sunday,Mid-Day,37,101,138,26.81
2012-12-30,16,Sunday,Evening Rush,31,102,133,23.31
2012-12-30,17,Sunday,Evening Rush,26,97,123,21.14
2012-12-30,18,Sunday,Evening Rush,12,113,125,9.6
2012-12-30,19,Sunday,Evening Rush,16,86,102,15.69
2012-12-30,20,Sunday,Night,9,63,72,12.5
2012-12-30,21,Sunday,Night,5,42,47,10.64
2012-12-30,22,Sunday,Night,6,30,36,16.67
2012-12-30,23,Sunday,Night,10,39,49,20.41
2012-12-31,0,Monday,Early Morning,4,30,34,11.76
2012-12-31,1,Monday,Early Morning,6,13,19,31.58
2012-12-31,2,Monday,Early Morning,3,8,11,27.27
2012-12-31,3,Monday,Early Morning,0,1,1,0.0
2012-12-31,4,Monday,Early Morning,0,3,3,0.0
2012-12-31,5,Monday,Early Morning,0,9,9,0.0
2012-12-31,6,Monday,Morning Rush,0,40,40,0.0
2012-12-31,7,Monday,Morning Rush,2,83,85,2.35
2012-12-31,8,Monday,Morning Rush,9,187,196,4.59
2012-12-31,9,Monday,Morning Rush,13,144,157,8.28
2012-12-31,10,Monday,Mid-Day,33,87,120,27.5
2012-12-31,11,Monday,Mid-Day,43,114,157,27.39
2012-12-31,12,Monday,Mid-Day,52,172,224,23.21
2012-12-31,13,Monday,Mid-Day,38,165,203,18.72
2012-12-31,14,Monday,Mid-Day,62,185,247,25.1
2012-12-31,15,Monday,Mid-Day,69,246,315,21.9
2012-12-31,16,Monday,Evening Rush,30,184,214,14.02
2012-12-31,17,Monday,Evening Rush,14,150,164,8.54
2012-12-31,18,Monday,Evening Rush,10,112,122,8.2
2012-12-31,19,Monday,Evening Rush,11,108,119,9.24
2012-12-31,20,Monday,Night,8,81,89,8.99
2012-12-31,21,Monday,Night,7,83,90,7.78
2012-12-31,22,Monday,Night,13,48,61,21.31
2012-12-31,23,Monday,Night,12,37,49,24.49
